-----------------------------------------------------------------------------------------------------------------------------------------------------------------------------------------------------------
-----------------------------------------------------------------------------------------------------------------------------------------------------------------------------------------------------------
-----------------------------------------------------------------------------------------------------------------------------------------------------------------------------------------------------------
S-----SSSSSSSSS-------------------------------------------------------------------------------------------------------------------SSSSSSSSSSSSSSSSSSSSSSSSSSS----------SSSSSSSS----------------------------
S-----------------------------------------------------------------------------o---------------------------------------------------SSSSSSSSSSSSSSSSSS-------------------------------------------------------
S---------------------------------------------------------------------------------------------------------------------------------SSSSSSSSSSSSSCSSSS-------------------------------------------------------
S--------------------------------------------------------oo---%%%%----------------------------------------------------------------SSSSSSSSSSSSSSSSSS--QQ------------CSS------------------------------------
S-----------------------------------------------SSS------SS----||------------------------------------------------------------------------------------------------------------------------------------------
S--------------------------------------------------------------||------------------oo--------------------------------------------------------------------------SSS--2--------------------------------------
S--------------------------------------------------------------||----------------------------------------------------------------------ooooo---ggg-----------------2-2-------------------------------------
S-----------------------------------------------------------SS-||%%%%%--------------------------------------------------------------SSSSSS?-SSSSSSSS--QQ--QQQ---------2------------------------------------
S--------------------------------------------------------------||-|||---------------------------------------------------------------SSSSS---SSSSSSSS-------------------------------------------------------
S----------------------------------o---------------------------||-|||---------------------------------------------------------------SSSSS---SSSSSSSS--------------------------------------------------F----
S-M---------ggg-k----------------oo----------------------------||-|||--------------------------------------------------------------------oooSSSSSSSS-------------------kk--------kkk------------------X----
XXXXXXXXXXXXXXXXXXX--------------------------%%%%----%%%%-----%%%%|||----------------------------------------------XXXXXXX-----X---XXXXXXXXXXXXXXXXXXXXXXXXXX------XXXXXXXXXXXXXXXXXXXXXXXXXXXXXXXXXXXXXXXX
XXXXXXXXXXXXXXXXXXX--------------------------|||------||-------||-|||----------------------------------------------XXXXXXX-----X---XXXXXXXXXXXXXXXXXXXXXXXXXX------XXXXXXXXXXXXXXXXXXXXXXXXXXXXXXXXXXXXXXXX
