-----------------------------------------------------------------------------------------------------------------------------------------------------------------------------------------------------
-----------------------------------------------------------------------------------------------------------------------------------------------------------------------------------------------------
-----------------------------------------------------------------------------------------------------------------------------------------------------------------------------------------------------
-----------------------------------------------------------------------------------------------------------------------------------------------------------------------------------------------------
-----------------------------------------------------------------------------------------------------------------------------------------------------------------------------------------------------
-----------------------------------------------------------------------------------------------------------------------------------------------------------------------------------------------------
---------------------LSSS---------------------QQQQQ-----------USSS--------SSCSS------SSSS-----------------------------------------------------------------------------------------USSS---------------
-----------------------------------------------------------------------------------------------------------------------------------------------------------------------------------------------------
-----------------g-----------------------------------------------------------------------------------------------------------------------------------------------------------------------------------
-----------------#------------------------------k-----------------------------------------------------------------------------------------------------------g-------------------E------TT------------
--------SUS-----##---2-----#-----------TT-----?QQQQ----------S-----TT---QQQQ--QQQ------------------------------------------------C-------------------C------TT-----------------TT------TT------------
---------------###---------#-----------TT--------------------------TT-----------------------------------------------------#-------------------#-------------TT----------g------TT--tt--TT------------
--------------####---------##----------TT--------------------------TT-------------------------------------------------K---#---------------K---#-------------TT----------TT-----TT--tt--TT--------F---
--M----------#####----kk---##---gg-----TT------------gg----k-ggg---TT------------ggg-----------k---------k----------------#-----gg------------#-----gg------TT----------TT--g--TT--tt--TT--------X---
XXXXXXXXXXXXXXXXXXXXXXXXXXXXXXXXXXXXXXXXXXXXXXXXXXXXXXXXXXXXXXXXXXXXXXXXXXXXXXXXXXXXX----XXXXXXXX---XXXXXXX---XXXXXXXXXX--XXXXXXXXXXXXXXXXXX--XXXXXXXXXXXXXXXXX---XXXXXXXXXXXXXXXXXXXXXXXXXXXXXXXXXXX
XXXXXXXXXXXXXXXXXXXXXXXXXXXXXXXXXXXXXXXXXXXXXXXXXXXXXXXXXXXXXXXXXXXXXXXXXXXXXXXXXXXXX----XXXXXXXX---XXXXXXX---XXXXXXXXXX--XXXXXXXXXXXXXXXXXX--XXXXXXXXXXXXXXXXX---XXXXXXXXXXXXXXXXXXXXXXXXXXXXXXXXXXX
