--------------------------------------------------------------------------------------------------------------------------------------------------------------------------------
--------------------------------------------------------------------------------------------------------------------------------------------------------------------------------
--------------------------------------------------------------------------------------------------------------------------------------------------------------------------------
----------------------------------------------------------------------------------------------------------------------------U---------------------------------------------------
--------------------------------------------------------------------------------------------------------------------------------------------------------------------------------
----------------------------------------------------------------------------------------------------------------------------------------------k---------------------------------
--------------------------------------------------USS-----------------------------------------------------------------------------------------##--------------------------------
------------------------------------------------------------------------------------------------------------------------------SS-------------###--------------------------------
-----------------------------------------------------------------------------------------------------------------------------------#--------####--------------------------------
--------------------------------------------------------------------------------------------------------------------------SS------##-------#####--------------------------------
--------------------------------------------------------------QQQQ---------------------------------------------------------------###------######--------------------------------
----------K---B-----K---B-----K---B------------K---B---------------K-B-----K---B-----K---B-----K---B-----K---B-----K---B--------####-----#######------K---B-----K---B-----------
--------------b---------b---------b-------B--------b-------B---------b---------b---------b---------b---------b---------b-------#####----########----------b---------b-------F---
-M------------B---------B---------B-------b--------B-------b---------b---------B---------B---------B---------B---------B------######---#########----------B---------B-------#---
XXXXXXXXXXXXXXXXXXXXXXXXXXXXXXXXXXXXXXXXXXXXXXXXXXXXXXXXXXXXXXXXXXXXXXXXXXXXXXXXXXXXXXXXXXXXXXXXXXXXXXXXXXXXXXXXXXXXXXXXXXXXX-XXXXXXXXXXXXXXXXXXXXXXXXXXXXXXXXXXXXXXXXXXXXXXXXXX
XXXXXXXXXXXXXXXXXXXXXXXXXXXXXXXXXXXXXXXXXXXXXXXXXXXXXXXXXXXXXXXXXXXXXXXXXXXXXXXXXXXXXXXXXXXXXXXXXXXXXXXXXXXXXXXXXXXXXXXXXXXXX-XXXXXXXXXXXXXXXXXXXXXXXXXXXXXXXXXXXXXXXXXXXXXXXXXX
