------------------------------------------------------------------------------------------------------------------------------------------------------------------------------------------------------------------------------
------------------------------------------------------------------------------------------------------------------------------------------------------------------------------------------------------------------------------
------------------------------------------------------------------------------------------------------------------------------------------------------------------------------------------------------------------------------
------------------------------------------------------------------------------------------------------------------------------------------------------------------------------------------------------------------------------
------------------------------------------------------------------------------------------------------------------------------------------------------------------------------------------------------------------------------
----------------------------------------------------------------------------------------------------------------------------------------------------------------------------------------------------------------y-------------
----------------------------------------------------------------------------------------------------------------------------------------------------------------------------------------------------------------##------------
------------------oooo------------------------------------------------------------------------------------------------oooo------------------------------------------------------------------------------------y###------------
--------------------------------------------------------------------------------------------------------------------------------------------------------------------------------------------------------------####------------
-------------------------------------------------------------------------------------------------------------------------------------------------------------------------------------------------------------#####------------
---------------TT--------------------------------------------------------------------------------------------------TT---------------------------------------------------------------------------------------######---C--------
---------------TT--------------------------------------------------------------------------------------------------TT--------------------------------------------------------------------------------------#######------------
---------------TT------------------------TT--------TT--------------------------------------------------------------TT-------------------------------------------------------------------------------------########--------F---
-M---------y---TT------------------------TT--------TT--------y---------y----------y--------y----------y--------y---TT---------y---------y---------y---------y----------y--------y----------y--y----------#########--------#---
XXXXXXXXXXXXXXXXXXXXXXXXXXX---XXX--XXXXXXXXXXXXXXXXXXXXXXXXXXXXXXXXXXXXXXXXXXXXXXXXXXXXXXXXXXXXXXXXXXXXXXXXXXXXXXXXXXXXXXXXXXXXXXXXXXXXXXXXXXXXXXXXXXXXXXXXXXXXXXXXXXXXXXXXXXXXXXXXXXXXXXXXXXXXXXXXXXXXXXXXXXXXXXXXXXXXXXXXXXX
XXXXXXXXXXXXXXXXXXXXXXXXXXX---XXX--XXXXXXXXXXXXXXXXXXXXXXXXXXXXXXXXXXXXXXXXXXXXXXXXXXXXXXXXXXXXXXXXXXXXXXXXXXXXXXXXXXXXXXXXXXXXXXXXXXXXXXXXXXXXXXXXXXXXXXXXXXXXXXXXXXXXXXXXXXXXXXXXXXXXXXXXXXXXXXXXXXXXXXXXXXXXXXXXXXXXXXXXXXX
