------------------------------------------------------------------------------------------------------------------------------------------------------------------------------------------------------
------------------------------------------------------------------------------------------------------------------------------------------------------------------------------------------------------
------------------------------------------------------------------------------------------------------------------------------------------------------------------------------------------------------
------------------------------------------------------------------------------------------------------------------------------------------------------------------------------------------------------
------------------------------------------------------------------------------------------------------------------------------------------------------------------------------------------------------
------------------------------------------------------------------------------------------------------------------------------------------------------------------------------------------------------
----------------------------------------------------------------------------------------------------------------------------------------------------------------------------------------##------------
----------------------------------------------------------------------------------------------------------------------------------------------------------------------------------------##------------
----------------------------------------------------------------------------------------------------------------------------------------TT----------------------------------------------##------------
----------------------------------------------------------------------------------------------------------------------------------------TT---------------------------------------K---#--##------------
-------------------------------------------------------------------------------------------------------------------------------#LSS-----##------------------------------------------##--##------------
-------------------TT-----TT----K-------------------------------------------------------------TT-----TT----K-------------------#---------------------------------------------------###--##------------
-------------------TT-----TT------------------------------------------------------------------TT-----TT------------------------#-----------*---TT--------------------*------------####------------F---
-M---------------kkTT-----TT-----------ggg----------------------------k---ggg---------------kkTT-----TT-----------ggg--------kk#-----------*---TT----------ggg-------*-----K-----#####------------#---
XXXXXXXXXXXXXXXXXXXXXXXX--XXXXXXXXXXXXXXXXXXXXXXXXXXXXXXXXXXXXXXXXXXXXXXXXXXXXXXXXXXXXXXXXXXXXXXXXX--XXXXXXXXXXXXXXXXXXXXXXXXXXXXXXX---XXXXXXXXXXXXXXXXXXXXXXXXXXXXXXXXXXXXXXXXXXXXXXXXXXXXXXXXXXXXXXX
XXXXXXXXXXXXXXXXXXXXXXXX--XXXXXXXXXXXXXXXXXXXXXXXXXXXXXXXXXXXXXXXXXXXXXXXXXXXXXXXXXXXXXXXXXXXXXXXXX--XXXXXXXXXXXXXXXXXXXXXXXXXXXXXXX---XXXXXXXXXXXXXXXXXXXXXXXXXXXXXXXXXXXXXXXXXXXXXXXXXXXXXXXXXXXXXXX
