------------------------------------------------------------------------------------------------------------------------------------------------------------------------------------------------------------------------------
------------------------------------------------------------------------------------------------------------------------------------------------------------------------------------------------------------------------------
------------------------------------------------------------------------------------------------------------------------------------------------------------------------------------------------------------------------------
------------------------------------------------------------------------------------------------------------------------------------------------------------------------------------------------------------------------------
------------------------------------------------------------------------------------------------------------------------------------------------------------------------------------------------------------------------------
----------------------------------------------------------------------------------------------------------------------------------------------------------------------------------------------------------------y-------------
-----------------------------------------QQQQ-------------------------------------------------------------------------------------------------------------------------------------------------------------------##------------
--------------------------------------------------------------------------------------------------------------------------------------------------------------------------------------------------------------y###------------
--------------------------------------------------------------------------------------------------------------------------------------------------------------------------------------------------------------####------------
-------------------------------------------y-----------------------------------------------------------------------------------------------------------------------------------------------------------------#####------------
---------------------------------------QQ?SSQQQ-------------------------------------------------------------------------------------------------------------------------------------------------------------######---C--------
---------------------------------------------------------------------------------------------------------------------------------------------------------------------------------#-------------------------#######------------
------------------------------------------------------------------TT-------------------------------------------------------------------------------------------------------------#-------------TT---------########--------F---
-M---------y---------------------------------------------y--------TT--------y---------y---------y----------y---------y---------y---------y--------y---------y---------y----------#----y--------TT--------#########--------#---
XXXXXXXXXXXXXXXXXXXXXX---XXX--XXXXXXXXXXXX--XXXXXXXXXXXXXXXXXXXXXXXXXXXXXXXXXXXXXXXXXXXXXXXXXXXXXXXXXXXXXXXXXXXXXXXXXXXXXXXXXXXXXXXXXXXXXXXXXXXXXXXXXXXXXXXXXXXXXXXXXXXXXXXXXXXXXX--XXXXXXXXXXXXXXXXXXXXXXXXXXXXXXXXXXXXXXXXXX
XXXXXXXXXXXXXXXXXXXXXX---XXX--XXXXXXXXXXXX--XXXXXXXXXXXXXXXXXXXXXXXXXXXXXXXXXXXXXXXXXXXXXXXXXXXXXXXXXXXXXXXXXXXXXXXXXXXXXXXXXXXXXXXXXXXXXXXXXXXXXXXXXXXXXXXXXXXXXXXXXXXXXXXXXXXXXX--XXXXXXXXXXXXXXXXXXXXXXXXXXXXXXXXXXXXXXXXXX
