----------------------------------------------------------------------------------------------------------------------------------------------------------------------------------------------------------------------
----------------------------------------------------------------------------------------------------------------------------------------------------------------------------------------------------------------------
----------------------------------------------------------------------------------------------------------------------------------------------------------------------------------------------------------------------
----------------------------------------------------------------------------------------------------------------------------------------------------------------------------------------------------------------------
----------------------------------------------------------------------------------------------------------------------------------------------------------------------------------------------------------------------
--------------------------------------------------------------------------------------------------------------------------g-------------------------------------------------------------------------------------------
-----SSS------------------------------------------US---SS-------------SSS---------------SCS-------------------------------SSSSS-----SSSSS----------------------------US---SS--------------------------SCS-------------
------------TT---------------------------------------------------------------TT------------------TT------------------------------------------------------------------------------------------------------------TT-----
------------TT---------------------------------------------------------------TT------------------TT------------------TT-----------------------TT---------------------------------------------------------------TT-----
------------TT----------------------------------SS---------------------------TT------------------XX------------TT----TT-----------------------TT-------------------SS------------------------------------------XX-----
-----SSS----XX-----TT-------TT------------tt----------SSS---------#---SSS----XX-----TT---2---TT----------------TT----XX------------------2----TT-------------tt----------SSS---------#---SSS------TT---2---TT---------
-------------------TT-----TTTT----TT------tt-----------------#-TT-#-----------------TT-------TT-------------K--TT----------------------TT-----TT-----TT------tt-----------------#-TT-#------------TT-------TT---------
-------------------TT---TTTTTT----TT------tt-TT-------------##-TT-##----------------TT-------TT-----TTTT-------TT---------TT-----tt----TT--TT-TT-----TT------tt-TT-------------##-TT-##-----------TT-------TT------F--
---M--------k------TT---TTTTTT----TT------tt-TT------------###-TT-##---------k------TT----k--TT-----TTTT-------TT---------TT-----tt----TT--TT-TT---k-TT------tt-TT------------###-TT-##-----------TT----k--TT------#--
XXXXXXXXXXXXXXXXXXXXXXXXXXXXXXXXXXXXXXXXXXXXXXXXXXX-X-XXXXXXXX-XXXXXXXXXXXXXXXXXXXXXXXXXXXXXXXXXXXXXXXXXXXXXXXXXXXXXXXXXXXXXXXXXXXXXXXXXXXXXXXXXXXXXXXXXXXXXXXXXXXXXXX-X-XXXXXXXX-XXXXXXXXXXXXXXXXXXXXXXXXXXXXXXXXXXXX
XXXXXXXXXXXXXXXXXXXXXXXXXXXXXXXXXXXXXXXXXXXXXXXXXXX-X-XXXXXXXX-XXXXXXXXXXXXXXXXXXXXXXXXXXXXXXXXXXXXXXXXXXXXXXXXXXXXXXXXXXXXXXXXXXXXXXXXXXXXXXXXXXXXXXXXXXXXXXXXXXXXXXX-X-XXXXXXXX-XXXXXXXXXXXXXXXXXXXXXXXXXXXXXXXXXXXX
