-------------------------------------------------------------------------------------------------------------------------------------------------------------------------------------------------------------------------------------------------------------------------------------------------------------------------------------------------------------------------------------
-------------------------------------------------------------------------------------------------------------------------------------------------------------------------------------------------------------------------------------------------------------------------------------------------------------------------------------------------------------------------------------
-------------------------------------------------------------------------------------------------------------------------------------------------------------------------------------------------------------------------------------------------------------------------------------------------------------------------------------------------------------------------------------
-------------------------------------------------------------------------------------------------------------------------------------------------------------------------------------------------------------------------------------------------------------------------------------------------------------------------------------------------------------------------------------
-------------------------------------------------------------------------------------------------------------------------------------------------------------------------------------------------------------------------------------------------------------------------------------------------------------------------------------------------------------------------------------
-------------------------------------------------------------------------------------------------------------------------------------------------------------------------------------------------------------------------------------------------------------------------------------------------------------------------------------------------------------------------------------
-----------------------------------------------------------------------------------------------------------------------------------------------------------------------------------------------------------------------------------------------------------------------------------------------------------------------------------------------------------------------##------------
-----------------------------------------------------------------------------------------------------------------------------------------------------------------------------------------------------------------------------------------------------------------------------------------------------------------------------------------------------------------------##------------
---------------------------------------------------------------------------------------------------------------------------------------------------------------------------------------------------------------------------------------------------------------------------------------------------------------------------------------------------------------------#-##------------
---------------------------SSUSSSSS-----------------------------------------oo-----------------------------------------------------------------------------------------------1---------------------------------------------------------------------------------------------------------------------------------------------------------------------------------------#-##------------
------------------------------------------------------------------------------------------------------------------------------------TT-----------------------------------TT----------------------------------------------------------------------------------------------------------------------------------------------------------------------------------------#-#-##------------
-------------------------------------------------------------------------------------------------------TT---------------------------TT-----------------------------------TT----TT--------------------------------------------------------------------------------------TT------------------------------------------------------------------------------------------#-#-##------------
-------------------------------------------------------------------------------------------------------TT---------------------------TT-----------------------------------TT----TT---------------------#----------------------------------------------------------------TT-----------------------------------------------------------------------------------TT---#-#-#-##--------F---
-M-----------------------------------ggg---------------------------------------------------------------TT-------------------k-------TT----------------------------ggg----TT---kTT----------ggg------kk#-------------------------------------------------------k--------TT-----------------------------------------------------------------------------------TT---#-#-#-##--------#---
XXXXXXXXXXXXXX-----------XXXXXXXXXXXXXXXXXXXXXXXX----------------------------------------------XXXXXXXXXXXXXXXXXXXXXXXXXXXXXXXXXXXXXXXXXXXXXXXXXXXXXXXXXXXXXXXXXXXXXXXXXXXXXXXXXXXXXXXXXXXXXXXXXXXXXXXXXXXXXXXXXX-------------------------------XXXXXXXXXXXXXXXXXXXXXXXXXXXXXXXXXX------------------------------------------------------------------XXXXXXXXXXXX-X-X-X-XXXXXXXXXXXXXX
XXXXXXXXXXXXXX-----------XXXXXXXXXXXXXXXXXXXXXXXX----------------------------------------------XXXXXXXXXXXXXXXXXXXXXXXXXXXXXXXXXXXXXXXXXXXXXXXXXXXXXXXXXXXXXXXXXXXXXXXXXXXXXXXXXXXXXXXXXXXXXXXXXXXXXXXXXXXXXXXXXX-------------------------------XXXXXXXXXXXXXXXXXXXXXXXXXXXXXXXXXX------------------------------------------------------------------XXXXXXXXXXXX-X-X-X-XXXXXXXXXXXXXX
