-------------------------------------------------------------------------------------------------------------------------------------------------------------------------------------------------------------
-------------------------------------------------------------------------------------------------------------------------------------------------------------------------------------------------------------
-------------------------------------------------------------------------------------------------------------------------------------------------------------------------------------------------------------
-------------------------------------------------------------------------------------------------------------------------------------------------------------------------------------------------------------
-------------------------------------------------------------------------------------------------------------------------------------------------------------------------------------------------------------
----------------------------------------------------------------------------------------------------------------------------------------------ooor---------%%%%%%%-------------------------------------------
---------------------------------------------------------------------------------------------------------------------------------------------%%%%%----------|||||--------------------------------------------
----------------------------------------------------------------------------------------------------------------------------------------------|||-----------|||||------ooo-----------------------------------
----------------------------------------------------------------------------------------------------------------------------------------------|||-----------|||||--------------------------------------------
------------------------------------------------------oo---o----------------------------------------------------------------------------------|||-----%%%%%-|||||--------------------------------------------
------------------------------------------------------SS-----------------r-r-----------------oo--------------------------------------------%%%%%%%%----|||--|||||--------------------------------------------
---------------------------------------------------------------------%%%%%%%----------------------------------------------------------------||||||-----|||--|||||--------------SSS---------------------------
----------------------------------------------------------%%%%--------|||||-----------------------------------------------------------------||||||--o--|||--|||||------------------------------------------F-
-M---------------------------------------------------------||---------|||||----------------------------------------------------ggg---%%%%---||||||-%%%-|||--|||||------------------------------------------X-
XXXXXXXXXXXXXXXXXXX----------------------------------------||-----%%%-|||||--------------------------------------------------XXXXXX---||----||||||--|--|||--|||||------------------------XXXXXXXXXXXXXXXXXXXX
XXXXXXXXXXXXXXXXXXX----------------------------------------||------|--|||||--------------------------------------------------XXXXXX---||----||||||--|--|||--|||||------------------------XXXXXXXXXXXXXXXXXXXX
