------------------------------------------------------------------------------------------------------------------------------------------------------------------------------------------------------------------------------
------------------------------------------------------------------------------------------------------------------------------------------------------------------------------------------------------------------------------
------------------------------------------------------------------------------------------------------------------------------------------------------------------------------------------------------------------------------
------------------------------------------------------------------------------------------------------------------------------------------------------------------------------------------------------------------------------
------------------------------------------------------------------------------------------------------------------------------------------------------------------------------------------------------------------------------
----------------------------------------------------------------------------------------------------------------------------------------------------------------------------------------------------------------y-------------
----------------------------------------------------Q-Q--------------------------------------------------------------------------------------------------------------------QQQQ---------------------------------##------------
----------------------------------------------------------------------------------------------------------------------oooo------------------------------------------------------------------------------------y###------------
--------------------------------------------------------------------------------------------------------------------------------------------------------------------------------------------------------------####------------
--------------------oo-------------------------------------------------------------------------------------------------------------------------------------------------------y-------------------------------#####------------
-------------------o--o-----------------------------Q-Q------------------------------------------------------------TT----------------------------------------------------QQ?SSQQQ---------------------------######---C--------
-------------------------------------------------------------------------------------------------------------------TT--------------------------------------------------------------------------------------#######------------
------------------------------------------------------------------TT-----------------------------------------------TT-----------------------------TT--------TT--------------------------------------------########--------F---
-M------------------------------y---------y-------------y---------TT------------------y------------------------y---TT----------y--------y---------TT--------TT-------------------------------------------#########--------#---
XXXXXXXXXX--XXXXXXXXXXXXXXXXXXXXXXXXXXXXXXXXXXXXXXXXXXXXXXXXXXXXXXXXXXXXXXXX----XXXXXXXXXXXXXXXXX---XXX--XXXXXXXXXXXXXXXXXXXXXXXXXXXXXXXXXXXXXXXXXXXXXXXXXXXXXXXXXXXXXXXXXXX--XXXXXXXXXXXXX---XXX--XXXXXXXXXXXXXXXXXXXXXXXXXXX
XXXXXXXXXX--XXXXXXXXXXXXXXXXXXXXXXXXXXXXXXXXXXXXXXXXXXXXXXXXXXXXXXXXXXXXXXXX----XXXXXXXXXXXXXXXXX---XXX--XXXXXXXXXXXXXXXXXXXXXXXXXXXXXXXXXXXXXXXXXXXXXXXXXXXXXXXXXXXXXXXXXXX--XXXXXXXXXXXXX---XXX--XXXXXXXXXXXXXXXXXXXXXXXXXXX
