----------------------------------------------------------------------------------------------------------------------------------------------------------------------------------------------------
----------------------------------------------------------------------------------------------------------------------------------------------------------------------------------------------------
----------------------------------------------------------------------------------------------------------------------------------------------------------------------------------------------------
----------------------------------------------------------------------------------------------------------------------------------------------------------------------------------------------------
----------------------------------------------------------------------------------------------------------------------------------------------------------------------------------------------------
--------------------------------------------k----------------------------------k----------------------------------k-----------------------------k---------------------------------------k-----------
-------------------------------------------##-------SSC-----------------------##---------------------------------##-------SSC------------------SQS--SQS--------------------------------##-----------
------------------------------------------###--------------------------------###--------------------------------###-------------------------------------------------------------------###-----------
----------------------------g#----------k####------------------g#----------k####------------------g#----------k####------------------g#---------------------------------#-----------k####-----------
---------------------------g##----------#####-------SSS-------g##----------#####-----------------g##----------#####-------SSS-------g##---------------------------k-----#-----------#####-----------
---------Q-----------------###---------######-----------------###---------######-----------------###---------######-----------------###--------SQS--S?S--------SCSSS----#----------######-----------
--------------------------####--------#######----------------####--------#######----------------####--------#######----------------####--------------------------K-----##---------#######-----------
-------------------------#####-------########---------------#####-------########---------------#####-------########---------------#####--------------------------------##--------########--------F--
-M----------------------######------#########--------------######------#########--------------######------#########--------------######------k------ggg--------K---K---##-------#########--------#--
XXXXXXXXXXXXXXXX----XXXXXXXXXX--XXXXXXXXXXXXXXXXXXX----XXXXXXXXXX--XXXXXXXXXXXXXXXXXXX----XXXXXXXXXX--XXXXXXXXXXXXXXXXXXX----XXXXXXXXXX--XXXXXXXXXXXXXXXXXXXXXXXXXXXXXXXX---XXXXXXXXXXXXXXXXXXXXXXXX
XXXXXXXXXXXXXXXX----XXXXXXXXXX--XXXXXXXXXXXXXXXXXXX----XXXXXXXXXX--XXXXXXXXXXXXXXXXXXX----XXXXXXXXXX--XXXXXXXXXXXXXXXXXXX----XXXXXXXXXX--XXXXXXXXXXXXXXXXXXXXXXXXXXXXXXXX---XXXXXXXXXXXXXXXXXXXXXXXX
