-------------------------------------------------------------------------------------------------------------------------------------------------------------------------------------------------------------
-------------------------------------------------------------------------------------------------------------------------------------------------------------------------------------------------------------
-------------------------------------------------------------------------------------------------------------------------------------------------------------------------------------------------------------
-------------------------------------------------------------------------------------------------------------------------------------------------SSSSSSSSSSSSSSSSSSSSSSSSSSSSSSSS----------SSSSSSSS----------
--------------------------------------------------------------------------o----------------------------------------------------------------------SSSSSSSSSSSSSSSSSSSSSSS-------------------------------------
-------------------R-----------------------------R-----------------------------------------------------------------------------------------------SSSSSSSSSSSSSSSSSSCSSSS-------------------------------------
-------------------------------------------------------------------------------------------------------------------------------------------------SSSSSSSSSSSSSSSSSSSSSSS--QQ------------CSS------------------
-------------------------------------------------------------------------------------------------------------------------------------------------------------------------------------------------------------
-----------------------------------------------------------------------------------------------------------------------------------------------------------------------------------SSS--2--------------------
-------------------------------------------------------------------------------------------------------------------------------------------------------------------ggg-----------------2-2-------------------
---------------------------------------------------------------------------------------------------------------------------------------------------SSSSSS?-SSSSSSSSSSSSS--QQ--QQQ---------2-----#------------
---------------------------------------------------------------------------------------------------------------------------------------------------SSSSS---SSSSSSSSSSSSS------------------------#------------
-----------------------------------oo--------------------------------------------------------------------------------------------------------------SSSSS---SSSSSSSSSSSSS------------------------##---------F-
-M-------g----g--gg------------------------------------------------------------------------------------------------------------------g------------------oooSSSSSSSSSSSSS------------------------##-gg------X-
XXXXXXXXXXXXXXXXXXXXXXXXXXXXX-----------------------------------------------------------------------------------------------------XXXXXXX-----X---XXXXXXXXXXXXXXXXXXXXXXXXXXXXXXX------XXXXXXXXXXXXXXXXXXXXXX
XXXXXXXXXXXXXXXXXXXXXXXXXXXXX-----------------------------------------------------------------------------------------------------XXXXXXX-----X---XXXXXXXXXXXXXXXXXXXXXXXXXXXXXXX------XXXXXXXXXXXXXXXXXXXXXX
