----------------------------------------------------------------------------------------------------------------------------------------------------------------------------------------------------------
----------------------------------------------------------------------------------------------------------------------------------------------------------------------------------------------------------
----------------------------------------------------------------------------------------------------------------------------------------------------------------------------------------------------------
----------------------------------------------------------------------------------------------------------------------------------------------------------------------------------------------------------
----------------------------------------------------------------------------------------------------------------------------------------------------------------------------------------------------------
--------------------------------------------------------------g-------------------------------------------------------------------------------------------------------------------------------------------
------------------------------------------------------------SSSSSSSS---SSS!--------------@-----------SSS----S!!S------------------------------------------------------------------------------------------
----------------------------------------------------------------------------------------------------------------------------------------------------------------------------------------------------------
-----------------------------------------------------------g----------------------------------------------------------------------------------------------------------------------------------------------
----------------------------------------------------------------------------------------------------------------------------------------------------------------------------------------------------------
---------------------tt---------tt-----------------------S@S--------------C-----SU----!--!--!-----S----------SS------#--#-------------------------tt---------tt-------------------------------------------
-------------tt------tt---------tt----------------------------------------------------------------------------------##--##----------------tt------tt---------tt-------------------------------------------
-------------tt------tt---------tt---------------------------------------------------------------------------------###--###-----tt--------tt------tt---------tt---------------------------------------F---
---M---------tt-g----tt-----g-g-tt-----------------------------------------g-g--------k-----------------gg-g-g----####--####----tt--------tt-g----tt-----g-g-tt---------------------------------------#---
XXXXXXXXXXXXXXXXXXXXXXXXXXXXXXXXXXXXXXXXXXXXXXXXX--XXXXXXXXXXXXXXX---XXXXXXXXXXXXXXXXXXXXXXXXXXXXXXXXXXXXXXXXXXXXXXXXXXXXXXXXXXXXXXXXXXXXXXXXXXXXXXXXXXXXXXXXXXXXXXXXXXXXXXXXXXXXXXXXXXXXXXXXXXXXXXXXXXXXX
XXXXXXXXXXXXXXXXXXXXXXXXXXXXXXXXXXXXXXXXXXXXXXXXX--XXXXXXXXXXXXXXX---XXXXXXXXXXXXXXXXXXXXXXXXXXXXXXXXXXXXXXXXXXXXXXXXXXXXXXXXXXXXXXXXXXXXXXXXXXXXXXXXXXXXXXXXXXXXXXXXXXXXXXXXXXXXXXXXXXXXXXXXXXXXXXXXXXXXX
