------------------------------------------------------------------------------------------------------------------------------------------------------------------------------------------------------------------------------
------------------------------------------------------------------------------------------------------------------------------------------------------------------------------------------------------------------------------
------------------------------------------------------------------------------------------------------------------------------------------------------------------------------------------------------------------------------
------------------------------------------------------------------------------------------------------------------------------------------------------------------------------------------------------------------------------
------------------------------------------------------------------------------------------------------------------------------------------------------------------------------------------------------------------------------
----------------------------------------------------------------------------------------------------------------------------------------------------------------------------------------------------------------y-------------
----------------------------------------------------------------------------------------------------------------------------------------------------------------------------------------------------------------##------------
--------------------------------------------------------------------------------------------------------------------------------------------------------------------------------------------------------------y###------------
--------------------------------------------------------------------------------------------------------------------------------------------------------------------------------------------------------------####------------
-------------------------------------------------------------------------------------------------------------------------------------------------------------------------------------------------------------#####------------
------------------------------------------------------------------------------------------------------------------------------------------------------------------------------------------------------------######---C--------
-----------------------------------------------------------------------------------------------------------------------------------------------------------------------------------------------------------#######------------
-------------------------------------------------------------TT------------------TT-----------------------------------------------------------------------------------------------------------------------########--------F---
-M---------y----------y---------y---------y---------y--------TT---------y--------TT---------y---------y--------y---------y---------y---------y---------y----------y---------y--------y---------y---------#########--------#---
XXXXXXXXXXXXXXXXXXXXXXXXXXXXXXXXXXXXXXXXXXXXXXXXXXXXXXXXXXXXXXXXXXXXXXXXXXXXXXXXXXXXXXXXXXXXXXXXXXXXXXXXXXXXXXXXXXXXXXXXXXXXXXXXXXXXXXXXXXXXXXXXXXXXXXXXXXXXXXXXXXXXXXXXXXXXXXXXXXXXXXXXXXXXXXXXXXXXXXXXXXXXXXXXXXXXXXXXXXXXXX
XXXXXXXXXXXXXXXXXXXXXXXXXXXXXXXXXXXXXXXXXXXXXXXXXXXXXXXXXXXXXXXXXXXXXXXXXXXXXXXXXXXXXXXXXXXXXXXXXXXXXXXXXXXXXXXXXXXXXXXXXXXXXXXXXXXXXXXXXXXXXXXXXXXXXXXXXXXXXXXXXXXXXXXXXXXXXXXXXXXXXXXXXXXXXXXXXXXXXXXXXXXXXXXXXXXXXXXXXXXXXX
