---------------------------------------------------------------------------------------------------------------------------------------------------------------------
---------------------------------------------------------------------------------------------------------------------------------------------------------------------
---------------------------------------------------------------------------------------------------------------------------------------------------------------------
-----------------------oo-----------------------------------------------------oo-------------------------------------------------------------------------------------
--------------------------------------------------?------------------------------------------------------?-----------------------------------------------------------
--------------------------------------ooooooo------------------------------------------------ooooooo-----------------------------------------------------------------
----------------------SSSS---------SSSS--------------------------------------SSSS---------SSSS-----------------------------------------------------------------------
------------------------------------------------SSSS---------------------------------------------------SSSS----------------------------------------------------------
-----------------------------------------SSSS---------------------------------------------------SSSS-----------------------------------------------------------------
-----------------------------------------------------------------------------------------------------------------------------%%%%------------------------------------
----------------%%%%------%%%%%----------------------------------------%%%%------%%%%%-------------------------------------------------------------------------------
---------------------------------------------------------------------------------------------------------------------------------------------------------------------
--------------------------------------------%%%%%--------------------------------------------------%%%%%-----------------------------------------------------------F-
-M-----------------------------------------------------------------------------------------------------------------------------------------------------------------X-
XXXXXXXXXXX--%%%%--%%%%---------%%%%--%%%%------------------XXXXXX--%%%%--%%%%---------%%%%--%%%%----------------------------------------------------------XXXXXXXXXX
XXXXXXXXXXX-------------------------------------------------XXXXXX-----------------------------------------------------------------------------------------XXXXXXXXXX
