-------------------------------------------------------------------------------------------------------------------------------------------------------------------------------------------------------------------------------------------------------------------------------------------------------------------------------------------------------------------------------------
-------------------------------------------------------------------------------------------------------------------------------------------------------------------------------------------------------------------------------------------------------------------------------------------------------------------------------------------------------------------------------------
-------------------------------------------------------------------------------------------------------------------------------------------------------------------------------------------------------------------------------------------------------------------------------------------------------------------------------------------------------------------------------------
-------------------------------------------------------------------------------------------------------------------------------------------------------------------------------------------------------------------------------------------------------------------------------------------------------------------------------------------------------------------------------------
-------------------------------------------------------------------------------------------------------------------------------------------------------------------------------------------------------------------------------------------------------------------------------------------------------------------------------------------------------------------------------------
-------------------------------------------------------------------------------------------------------------------------------------------------------------------------------------------------------------------------------------------------------------------------------------------------------------------------------------------------------------------------------------
---------------------------------------------------------------------------------------------------------------------------------------------------------------------------------------------------------------SSSSCSSS------------------------------------------------------------------------------------------------------------------------------------------------##------------
-----------------------------------------------------------------------------------------------------------------------------------------------------------------------------------------------------------------------------------------------------------------------------------------------------------------------------------------------------------------------##------------
---------------------------------------------------------------------------------------------------------------------------------------------------------------------------------------------------------------------------------------------------------------------------------------------------------------------------------------------------------------------#-##------------
-------------------------------------------------------------------------------------------------------------------------------------------------------------------------------------oo-------------o----------------------------------------------------------------------------------------------------------------------------------------------------------------#-##------------
------------TT------------------------------------------------------------------------------------------------------------------------------------------------------------------------------------------------#----2----#-------------------------------------------------------------TT------------------------------------------TT-------------------------------#-#-##------------
------------TT------------------------------------------------------------------------------------------------------------------------------------------------------------------------------------------------#------K--#-------K-----------------------------------------------------TT------------------------------------------TT-------------------------------#-#-##------------
------------TT------------------------------------------------------------------------------------------------------------------------------------------------------------------------------------------------#---------#-----------K-------------------------------------------------TT------------------------------------------TT------------------------TT---#-#-#-##--------F---
-M----------TT-------------------------------------------------------------------------------------------------------------------------------------------------------------------------------------------ggg--#---------#--------------------k--------kkk---kkk-----------ggg-----ggg-TT----k---------k-------ggg-----------------TT---ggg------------------TT---#-#-#-##--------#---
XXXXXXXXXXXXXXXXXXXXXXXX---------------------------------------------------------------------------------------------------------------------------------------------------------------------------XXXXXXXXXXXXXXXXXXXXXXXXXXX-X-XX-X-XX-XX-XXXXXXXXXXXXXXXXXXXXXXXXXXXXXXXXXXXXXXXXXXXXXXXXXXXXXXXXXXXXXXXXXXXXXXXXXXXXXXXXXXXXXXXXXXXXXXXXXXXXXXXXXXXXXXXXXXXX-X-X-X-XXXXXXXXXXXXXX
XXXXXXXXXXXXXXXXXXXXXXXX---------------------------------------------------------------------------------------------------------------------------------------------------------------------------XXXXXXXXXXXXXXXXXXXXXXXXXXX-X-XX-X-XX-XX-XXXXXXXXXXXXXXXXXXXXXXXXXXXXXXXXXXXXXXXXXXXXXXXXXXXXXXXXXXXXXXXXXXXXXXXXXXXXXXXXXXXXXXXXXXXXXXXXXXXXXXXXXXXXXXXXXXXX-X-X-X-XXXXXXXXXXXXXX
