-----------------------------------------------------------------------------------------------------------------------------------------------------------------------------------------------------
-----------------------------------------------------------------------------------------------------------------------------------------------------------------------------------------------------
-----------------------------------------------------------------------------------------------------------------------------------------------------------------------------------------------------
-----------------------------------------------------------------------------------------------------------------------------------------------------------------------------------------------------
----------------------------------------------------------------------------------------------------------------------------------------------------XX-----------------------------------------------
----------------------------------------------------------------------------------------------------------------------------------------------------XX-----------------------------------------------
---------------------LSSS---------------------QQQQQ-----------USSS--------SSCSS------SSSS---------------------------------SSSSS---?-------------C---XX----------------------------USSS---------------
----------------------------------------------------------------------------------------------------------------------------------------------------XX-----------------------------------------------
-----------------g----------------------------------------------------------------------------------------------------------------------------------XX-----------------------------------------------
-----------------#------------------------------k---------------------------------------------------------------------------------------------------XX------g-------------------E------TT------------
--------SUS-----##---2-----#-----------TT-----?QQQQ----------S-----TT---QQQQ--QQQ-----------------------------------------------Q--------------SS---XX------TT-----------------TT------TT------------
---------------###---------#-----------TT--------------------------TT-----------------------------------------------------------------TT------------XX------TT----------g------TT--tt--TT------------
--------------####---------##----------TT--------------------------TT-----------------------------------------------------------------TT------------XX------TT----------TT-----TT--tt--TT--------F---
--M----------#####----kk---##---gg-----TT------------gg----k-ggg---TT------------ggg-----------k---------k---------k-----------K-K----TT--------k---XX------TT----------TT--g--TT--tt--TT--------X---
XXXXXXXXXXXXXXXXXXXXXXXXXXXXXXXXXXXXXXXXXXXXXXXXXXXXXXXXXXXXXXXXXXXXXXXXXXXXXXXXXXXXX----XXXXXXXX---XXXXXXX---XXXXXXX---XXXXXXXXXXXXXXXXXXXXXXXXXXXXXXXXXXXXXXX---XXXXXXXXXXXXXXXXXXXXXXXXXXXXXXXXXXX
XXXXXXXXXXXXXXXXXXXXXXXXXXXXXXXXXXXXXXXXXXXXXXXXXXXXXXXXXXXXXXXXXXXXXXXXXXXXXXXXXXXXX----XXXXXXXX---XXXXXXX---XXXXXXX---XXXXXXXXXXXXXXXXXXXXXXXXXXXXXXXXXXXXXXX---XXXXXXXXXXXXXXXXXXXXXXXXXXXXXXXXXXX
