-------------------------------------------------------------------------------------------------------------------------------------------------------------------------------------------------------------------------------------------------------------------------------------------------------------------------------------------------------------------------------------
-------------------------------------------------------------------------------------------------------------------------------------------------------------------------------------------------------------------------------------------------------------------------------------------------------------------------------------------------------------------------------------
-------------------------------------------------------------------------------------------------------------------------------------------------------------------------------------------------------------------------------------------------------------------------------------------------------------------------------------------------------------------------------------
-------------------------------------------------------------------------------------------------------------------------------------------------------------------------------------------------------------------------------------------------------------------------------------------------------------------------------------------------------------------------------------
-------------------------------------------------------------------------------------------------------------------------------------------------------------------------------------------------------------------------------------------------------------------------------------------------------------------------------------------------------------------------------------
-------------------------------------------------------------------------------------------------------------------------------------------------------------------------------------------------------------------------------------------------------------------------------------------------------------------------------------------------------------------------------------
--------------------------------------------------------------------------------------------------------------------------SSSSCSSS-------------------------------------------------------------------------------------------------------------------------------------------------------------------------------------------------------------------------------------##------------
-----------------------------------------------------------------------------------------------------------------------------------------------------------------------------------------------------------------------------------------------------------------------------------------------------------------------------------------------------------------------##------------
---------------------------------------------------------------------------------------------------------------------------------------------------------------------------------------------------------------------------------------------------------------------------------------------------------------------------------------------------------------------#-##------------
---------------------------SSUSSSSS----------------oo--------------------------------------oo-------------------o-------------------------------------------------------------------------------SSUSSSSS------------o---------------------------------o---------------------------------------------------------------------o----------------------------------------#-##------------
-------------------------------------------------------------------------------------------------------------------------#----2----#-------------------------------------------------------------------------------------------------------------------------------------------------------------------------------------------------------------------------------#-#-##------------
-------------------------------------------------------------------------------------------------------------------------#------K--#-------K-----------------------------------------------------------------------------------------------------------------------------------------------------------------------------------------------------------------------#-#-##------------
-------------------------------------------------------------------------------------------------------------------------#---------#-----------K------------------------------------------------------------------------------------------------------------------------------------------------------------------------------------------------------------TT---#-#-#-##--------F---
-M-------------------------------------k----------------------------------------------------------------------------ggg--#---------#-----------------------------kkk---kkk-------------------k--------------k------------ggg-----------------ggg------------------------------------------------------------------------------------k-----------------------TT---#-#-#-##--------#---
XXXXXXXXXXXXXX-----------XXXXXXXXXXXXXXXXXXXXXXXX-------------------------------------------------------------XXXXXXXXXXXXXXXXXXXXXXXXXXX-X-XX-X-XX-XXXXXXXXXXXXXXXXXXXXXXXXXXXXXXXXXXXXXXXXXXXXXXXXXXXXXXXXXXXXXXXXXXXXXXXXXXXXXXXXXXXXXXXXXXXXXXXXXXXXXXXXXXXXXXX--------------------------------------------------------XXXXXXXXXXXXXXXXXXX------XXXXXXXXXXXX-X-X-X-XXXXXXXXXXXXXX
XXXXXXXXXXXXXX-----------XXXXXXXXXXXXXXXXXXXXXXXX-------------------------------------------------------------XXXXXXXXXXXXXXXXXXXXXXXXXXX-X-XX-X-XX-XXXXXXXXXXXXXXXXXXXXXXXXXXXXXXXXXXXXXXXXXXXXXXXXXXXXXXXXXXXXXXXXXXXXXXXXXXXXXXXXXXXXXXXXXXXXXXXXXXXXXXXXXXXXXXX--------------------------------------------------------XXXXXXXXXXXXXXXXXXX------XXXXXXXXXXXX-X-X-X-XXXXXXXXXXXXXX
