----------------------------------------------------------------------------------------------------------------------------------------------------------------------------------------------------------
----------------------------------------------------------------------------------------------------------------------------------------------------------------------------------------------------------
----------------------------------------------------------------------------------------------------------------------------------------------------------------------------------------------------------
----------------------------------------------------------------------------------------------------------------------------------------------------------------------------------------------------------
----------------------------------------------------------------------------------------------------------------------------------------------------------------------------------------------------------
----------------------------------------------------------------------------------------------------------------g-----------------------------------------------------------------------------------------
--------------------------------------------------------------------------------------------------------------SSSSSSSS---SSS!--------------@-----------SSS----S!!S----------------------------------------
----------------------------------------------------------------------------------------------------------------------------------------------------------------------------------------------------------
-------------------------------------------------------------------------------------------------------------g--------------------------------------------------------------------------------------------
-----------------------------------------------------------1----------------------------------------------------------------------------------------------------------------------------------------------
-----------------------------------------------------------------------tt---------tt-----------------------S@S--------------C-----SU----!--!--!-----S----------SS------#--#-------------------------------
---------------------------------------------------------------tt------tt---------tt----------------------------------------------------------------------------------##--##------------------------------
---------------------------------------------------------------tt------tt---------tt---------------------------------------------------------------------------------###--###-----tt------------------F---
---M-----------------------------------------------------------tt-g----tt-----g-g-tt-----------------------------------------g-g--------k-----------------gg-g-g----####--####----tt------------------#---
XXXXXXXXXXXXXXXXXXXXXXXXXXXXXXXXXXXXXXXXXXXXXXXXXXXXXXXXXXXXXXXXXXXXXXXXXXXXXXXXXXXXXXXXXXXXXXXXXXX--XXXXXXXXXXXXXXX---XXXXXXXXXXXXXXXXXXXXXXXXXXXXXXXXXXXXXXXXXXXXXXXXXXXXXXXXXXXXXXXXXXXXXXXXXXXXXXXXXXX
XXXXXXXXXXXXXXXXXXXXXXXXXXXXXXXXXXXXXXXXXXXXXXXXXXXXXXXXXXXXXXXXXXXXXXXXXXXXXXXXXXXXXXXXXXXXXXXXXXX--XXXXXXXXXXXXXXX---XXXXXXXXXXXXXXXXXXXXXXXXXXXXXXXXXXXXXXXXXXXXXXXXXXXXXXXXXXXXXXXXXXXXXXXXXXXXXXXXXXX
