----------------------------------------------------------------------------------------------------------------------------------------------------------------------------------------------------------
----------------------------------------------------------------------------------------------------------------------------------------------------------------------------------------------------------
----------------------------------------------------------------------------------------------------------------------------------------------------------------------------------------------------------
S-----SSSSSSSSS---------------------------------------------------------------------------------------------------------------------------------------------------------------------SSSSSSSSSSSSSSSSSSSS--
S-----------------------------------------------------------------------------------------o-----------------------------------------------------------------------------------------SSSSSSSSSSS-----------
S-----------------------------------------------------------------------------------------------------------------------------------------------------------------------------------SSSSSSSSSSS-----------
S-----------------------------------------------------------------------------------------------------------------------------------------------------------------------------------SSSSSSSSSSS-----------
S--------------------------------------------------------------------------------------------------------------------------------------------------------------------------------------------------TT-----
S--------------------------------------------------------------------------------------------------------------------------------------------------------------------------------------------------TT-----
S-------------------------------o------------------------------------------------------------------------------------------------------------------K-------------------------------------ooooo-----TT-----
S----------------------------------------------------------------------------------------------------------------------------------------------------------------------------------SSSSSSSS----#---TT----F
S---------------------------------------------------------------------------------------------------------------------------------------------------------------------------------------------##---TT---SS
S------------K-------------------------------------------------------------------------------------------------------------------------------------------------------------------------------###---TT---SS
S-M-------------k----------------------------------------------------------------------------------------------k-----------------------------------------------------------kkk--------------####--kTT---SS
XXXXXXXXXXXXXXXXXXX--------------------------------------------------------------------------------------XXXXXXXXX--------------------------------------------------------XXXXXXXXXXXXXXXXXXXXXXXXXXXX--XX
XXXXXXXXXXXXXXXXXXX--------------------------------------------------------------------------------------XXXXXXXXX--------------------------------------------------------XXXXXXXXXXXXXXXXXXXXXXXXXXXX--XX
