----------------------------------------------------------------------------------------------------------------------------------------------------------------------------------------------------------
----------------------------------------------------------------------------------------------------------------------------------------------------------------------------------------------------------
----------------------------------------------------------------------------------------------------------------------------------------------------------------------------------------------------------
---------------------------------------------------------------------------------------------------------------------------------------SSSSSSSSSSSSSSSSSSSSSSSSSSS----------SSSSSSSS----------------------
------------------------------------K--------------------------------------------------------------------------------------------------SSSSSSSSSSSSSSSSSS-------------------------------------------------
---------------------------------------------------------------------------------------------------------------------------------------SSSSSSSSSSSSSCSSSS-------------------------------------------------
---------------------------------------------------------------------------------------------------------------------------------------SSSSSSSSSSSSSSSSSS--QQ------------CSS------------------------------
----------------------------------------------------------------------------------------------------------------------------------------------------------------------------------------------------------
--------------------------------------------------------------------------------------------------------------------------------------------------------------------SSS--2--------------------------------
---------------------------------------------------------g-g--g-g-------------------------------------------------o---------------------------------ggg-----------------2-2-------------------------------
-----------------------------------------------------------SSS----------------r-r--------------------------------------------------------SSSSSS?-SSSSSSSS--QQ--QQQ---------2------------------------------
-----------------------------------------------------------------g--------%%%%%%%--------------------------------------------------------SSSSS---SSSSSSSS-------------------------------------------------
---------------------------------------------------------------%%%%--------|||||---------------------------------------------------------SSSSS---SSSSSSSS--------------------------------------------F----
-M--------------k-----------------------------------------------||---------|||||----------------------------------------gg--------------------oooSSSSSSSS-------------------kk--k-----------k--------#----
XXXXXXXXXXXXXXXXXXX---------------------------------------------||-----%%%-|||||----------------------------------------XXXXXXX-----X---XXXXXXXXXXXXXXXXXXXXXXXXXX------XXXXXXXXXXXXXX---XXXXXXXXXXXXXXXXX
XXXXXXXXXXXXXXXXXXX---------------------------------------------||------|--|||||----------------------------------------XXXXXXX-----X---XXXXXXXXXXXXXXXXXXXXXXXXXX------XXXXXXXXXXXXXX---XXXXXXXXXXXXXXXXX
