--------------------------------------------------------------------------------------------------------------------------------------------------------------------------------
--------------------------------------------------------------------------------------------------------------------------------------------------------------------------------
--------------------------------------------------------------------------------------------------------------------------------------------------------------------------------
-----------------------------------------------------------------------------------------U--------------------------------------------------------------------------------------
--------------------------------------------------------------------------------------------------------------------------------------------------------------------------------
-----------------------------------------------------------------------------------------------------------k--------------------------------------------------------------------
-----------------------------------------------------------------------------------------------------------##----------------USS------------------------------------------------
-------------------------------------------------------------------------------------------SS-------------###-------------------------------------------------------------------
------------------------------------------------------------------------------------------------#--------####-------------------------------------------------------------------
---------------------------------------------------------------------------------------SS------##-------#####-------------------------------------------------------------------
----------------------------------------------------------------------------------------------###------######----------------------------QQQQ-----------------------------------
----------K---B------------TT-----------K---B-----K---B-----K---B-----K---B-----K---B--------####-----#######-------------K---B---------------K-B-----K---B-----K---B-----------
--------------b-------B----TT----TT---------b---------b---------b---------b---------b-------#####----########--------B--------b-------B---------b---------b---------b-------F---
-M------------B-------b----TT-k--TT---------B---------B---------B---------B---------B------######---#########--------b--------B-------b---------b---------B---------B-------#---
XXXXXXXXXXXXXXXXXXXXXXXXXXXXXXXXXXXXXXXXXXXXXXXXXXXXXXXXXXXXXXXXXXXXXXXXXXXXXXXXXXXXXXXXXX-XXXXXXXXXXXXXXXXXXXXXXXXXXXXXXXXXXXXXXXXXXXXXXXXXXXXXXXXXXXXXXXXXXXXXXXXXXXXXXXXXXXXX
XXXXXXXXXXXXXXXXXXXXXXXXXXXXXXXXXXXXXXXXXXXXXXXXXXXXXXXXXXXXXXXXXXXXXXXXXXXXXXXXXXXXXXXXXX-XXXXXXXXXXXXXXXXXXXXXXXXXXXXXXXXXXXXXXXXXXXXXXXXXXXXXXXXXXXXXXXXXXXXXXXXXXXXXXXXXXXXX
