------------------------------------------------------------------------------------------------------------------------------------------------------------------------------------------------------------------------------
------------------------------------------------------------------------------------------------------------------------------------------------------------------------------------------------------------------------------
------------------------------------------------------------------------------------------------------------------------------------------------------------------------------------------------------------------------------
------------------------------------------------------------------------------------------------------------------------------------------------------------------------------------------------------------------------------
------------------------------------------------------------------------------------------------------------------------------------------------------------------------------------------------------------------------------
----------------------------------------------------------------------------------------------------------------------------------------------------------------------------------------------------------------y-------------
----------------------------------------------------------------------------------------------------------------------------------------------------------------------------------------------------------------##------------
---------------------------------oooo-----------------------------------------------------------------------------------------------------oooo----------------------------------------------------------------y###------------
--------------------------------------------------------------------------------------------------------------------------------------------------------------------------------------------------------------####------------
-------------------------------------------------------------------------------------------------------------------------------------------------------------------------------------------------------------#####------------
------------------------------------------------------------------------------------------------------------------------------------------------------------------------------------------------------------######---C--------
-------------------------------#--------------------------------------------------------------------------------------------------------#----------------------------------------#-------------------------#######------------
-------------------------------#----------------------------------TT----------------------------TT--------------------------------------#---------TT--------TT-------------------#------------------------########--------F---
-M----------y---------y--------#----------y---------y--y----------TT--------y----------y--------TT---------y--------y-------------------#---------TT--------TT---------y---------#----y--------y---------#########--------#---
XXXXXXXXXXXXXXXXXXXXXXXXXXXXXXXXXXXXXXXXXXXXXXXXXXXXXXXXXXXXXXXXXXXXXXXXXXXXXXXXXXXXXXXXXXXXXXXXXXXXXXXXXXXXXXXXXXXXXXXXXXXXXX----XXXXXXXXXXXXXXXXXXXXXXXXXXXXXXXXXXXXXXXXXXXXXXXX--XXXXXXXXXXXXXXXXXXXXXXXXXXXXXXXXXXXXXXXXXX
XXXXXXXXXXXXXXXXXXXXXXXXXXXXXXXXXXXXXXXXXXXXXXXXXXXXXXXXXXXXXXXXXXXXXXXXXXXXXXXXXXXXXXXXXXXXXXXXXXXXXXXXXXXXXXXXXXXXXXXXXXXXXX----XXXXXXXXXXXXXXXXXXXXXXXXXXXXXXXXXXXXXXXXXXXXXXXX--XXXXXXXXXXXXXXXXXXXXXXXXXXXXXXXXXXXXXXXXXX
