----------------------------------------------------------------------------------------------------------------------------------------------------------------------------------------------------
-------------------------------------------#-----------------#--#--#----------------------#--S------------#-------------------#---------------#---------------#----##-------------------------------
-------------#------#----------------------#----------#--------#-----------------------------------#------------------------------------#-------------?------#---------#----S-----------------------
----------------------------#-----------------------------#------------------#------#-----------------------#--------------------------------S-----S---------------------#------------S-------------
-------------------------#-----------#---------------------------------Q---SC--------------------------------------------------------#-------------------------------------------------S------------
--------------S-----------------------------SC--#----#--#-------------#-#----------------#-----------------------QS------------#---------------------------------#---#------------------------------
-----S---S---------------------#----------------------#-------------#-------------------------S---------------------------------------------------------------------S-#---K-------------------#-----
----#--S------------------------#----#------------S--------------------#-------------------------#-------------------------S----------#-----S-------------------------#-----------------------------
-------------------#--------------##---K-#------------#---------------------------------------------------------------------------------#-##--------#--------------S----------------------#---------
-------------------------------------------------Q-----#---------------K-------------------------------K----#--#-------#---------#-----------------------------#-----S---------------------------#--
--------#----------S--US-------------#---------------K----------#--#-------------------------------------------------------#-----------------#-#-----------------#------------------Q---------------
---S-----------------------S-----#------?--S--S----------------------------------------#--?--------#-----------------------------------#----------------------------S--#----#-------------------S---
----------#--------------------------------------------------------------------#----#--------#---------------------#------------------------------------------#--#---------------------#--#------F--
-M----------K-----------------------#-----#--------S---------------------------------------------------#---------#-----------------K-------------#--------------------------Q--SC-----#----------#--
-X-----------------------S-----------------------------------------------------------#---------------------------------#-----------------#-----------------#--S---#----------------#-#------------S-
-X--X---------------X-----------X---------X--X------X--X--------XXX-X-X---X-----X----------X---X-----------X--------X-------------------------------------------X-X---------------------------X-----
