--------------------------------------------------------------------------------------------------------------------------------------------------------------
------------S------------------S-------------oSS------------S------------S-S------------S----------------------S----C--S---S---------S----S---o----------S-@Q-
-----S----S-----o-------S--------S------------S-----S--------o--S--------S----------S-------------S-S-------------------S-S-----S---------------------o-------
-----S--S-------------o--S---S-S----------------S---------o-------S----------SS------------S-----------------------------------------So------S----S-S-S---SS--
--------S-U--S----------------S--S--S------S------S--------S---S-o-----S-----------------S--S-S------------S--S-S-------------SS------------S----S--S--S------
-------S--S-S-------S-@Q----S-------------S---------S--S---S--S-S-------S---S---S-----------------S-------S--S-------------------------------S----------------
---S-----------------------------S---S--------S--------------------o-------S-------------S------S-----S-----------------S------------------------o--S---------
-S--S-S---------------S----SS-@Q------o--S--------------S--------------------------------------S-----------S----S----o--S------SU--------SSS-----SS--------SS-
------S--S----S----S---------------S--S-------------S--S----------S---S---------S--S---------------S-----S---S------S--S---------So---------------------S-----
S-----------S----U---------------------S-------SS---------------S-----------------S-S--S-S-S--S-----S---------------S----------------------------------SS-----
S-S--S-------------S---------S-------------S-----------o-----S----------------S-----------SS-----S-S---------------------S----------S---SSS--S----------------
S-------S-----S----S--------S--------------------S--S-------S-----S----SS--------------------S----------@Q--oS-----------------o-----------------S------------
----o-----S-S--S-S---@Q-S----S-S-----S-----------S------S-----------S-----S---------S---S----S---------S--S-S---------------SSS-------SS---S---------S--------
---M--S---------------------------SSS-------------S-------SSS-----------C----S--------S----S-----S-----------------------------SS-----SS---S--------o-------F-
---X-SS-SS----X------X-S---------------S------------------S----------------S----S---S-------X---S----------S------X---X----S------------SSSS--S------S---S--X-
---X-XX-------X------X------X-------------------X--X---X---X---------------X----------------X------------X-X------X---X--X------X--X----------X--X-----X--X-X-
