----------------------------------------------------------------------------------------------------------------------------------------------------------------------------------------------------------------------
---T-X-----------X--------X--S--X---------X--XXX--XX-----X------------XXX-------------X-X------X-------X-------X-----------X--X------X--------------------------X-----X-XX-X-S-S-------------X----------SX----------X-
---X----------X--------X------SX------X----X--------XX----X-X-----XX---XX--------SS-----X-S--------------X--X--------------------X-------------X------X----XX-X----X----X--------XX-----X-S---X--X-X--X------X------X-
---------X-X-----------X---X-----X--------------K----X-------------X--X------X--S--------X-------X---------X---X-----X----X--------SX------------------------X--------------X---------------X-----X-----------X-------
-----S-----X------XX------XX-------------------X-------X----X---T---S---X---X-----------K-------------T-----X----------X---------X--X-X---X-XX----X-XX-X---------------X-----XX-X----------X-------------------X------
---T----------X--------X--------X-----X-----X-------------------X--X---------X--X---------------------X-X-X--X------------T--------X-------X-----------X---------X----X-X----X---------X--K-------------------X-------
---X----------------------X----X-----X-----------XX-X---------S---XX---S-----------------------X--#-----X----------2------X----------XSX-X----------X-----------X---X-----------X-----------X--------------------XS-X-
-----------------X--X-----------X--X------X-X-U-X-----------------------SX-------T------XX-#-XX---X--------X------X-XX---#--------XX--------X-----XXX----X-XS-----------X---XS-------X-----------XX-----X-------------
-----------X-----X-----------X---------------X------X---X---------------------X--X------X--X-X---------X------------X-X--X-X----------X-------------------SX---X----X--------------t------------S---------K---X-------
--X------X---X---------X------XXX-----X-------------X------X---X-------X--------T--S--X--X---X--S---X---------XSX----------X--X-------X----X-X--T---X-X--------------S-X-----------XX---X--------X-----X---------X----
--------X---X--X--X------X--------SS--------X-----X-------------X--X------------T----XX--X----------------T-X-X---XXSX--X----X-------------X----X----X-----------S------------X--X-----T---------------------X------X-
-----------X-X---X--X---X-------------X--X--------------------------------------X------------------X-X-XX-X----XX----X-----S---X---------X--X-----X----------X-XS-------X-X------------X-----X---X-----------X---X----
--X-----------XX--X-X----------X----------S--K----------------X------------------XXX--------X-S----------------X--X----X-----------------X---------X----X-----X---X-----XX----XX----#----X-X------T-S---------XX---F--
X--M-X-------XX--------X---------------X----------X--------T--X-XX---X----X-----X-X------------X-----X---------X---------------S----X---X--X-----X---X---X-----------X-------X-XX-X-X------------XX-----X----S-----#--
---X--X------X-----X------X----------------------X--XS--X--XX-----X----------------------X--XX--X-X-------S---X-X------X------X------------X--X-----------X-S-------X----X------X------------X-X-------------------X--
--X--------------------X---XX------------------------------X-X------X---X-----X------X--------XX-----X-X--------X-------X--X--X----XX-----------------X---------X-X----X-------X------------X-----X----XXX-----X------
