--------------------------------------------------------------------------------------------------------------------------------------------------------------
----------------S------g---------oS-SS----------S---------------------o--------S-------S--------S---o----S----S------------o---------------------------S------
---------S--SSS----S---S--------S--------o-S---------S--S-S-----------S---------------S--------------S---------------S-SS------S-o--S-------------------------
-------S-----------S-----S-----S-----S----------------S-----S----SS-o---------S-------------S--------------SS--S-------S--S-S-SS----------SS------S--------o--
S----S-------S-S--------------S-----------S-----S----------S------S---U-----S---S------SS-------S----S-S------S--S-----S---S--S---S---------------S-----S-----
S---S-S---------------------S---------SSSS---S--------------------S------------S-S-S-----------------------S-----------S---------S----S-------------S-S-S-----
-----------------S-----------S-S--------------oo----------SS------------------------S---------S----S----S--------S-------S------------------U-----S-----------
----S------------------S--------S----------------------------S--------S------SSS----S-----------------------------S--------SS------------------S------------S-
-------------S-----S--S------S---------------------------S-----------S------------------SSS--------S-SS--S----------------S--------------oSo--S-S-------------
S-------------------------S---S--------S-S---S--------------SS--------SS--------------S-----SS-S----------------------SS-S--------S----------S-------S--------
-S--S---------------S----S--S-S---------S---S---S-----------------S---S--------------S-S----S------o----S-----S-SS---S-----------U----S-----------------------
-----------S--o-SS-S-------------------S------S---------------SS-------S-----------------S-S-S------S--o-S-S------------SS----------------------------S---S-S-
-S----o---------S-------------S----------S-S----------S---SS---SSS-------S---------S---------------SSS------S---S--S---S--S------------S---------------S------
---M---------------g--S---S-S------------S-----------------S-S---S------------------------S----------------------------S--------S-----S---S----S------------F-
---X-S-S-----S-----S-S-------S--S----S-So------o-------S-S--S--------S--------SS----S----------S--S-------------------S---S--S------oS----S----------S------X-
X--X--X---------X---X---------------X-X-----------------------X----------X---X--X-X---X----X----------------------------------X--X--------X--X-----------X--X-
