----------------------------------------------------------------------------------------------------------------------------------------------------------------------------------------
----------#----------#--------------#------------##---------#------------#---SC----------2------Q-----------------------------------------------------------S------------------------#--
-----------#--------------------------?Q----#---#--#-----#--------#-------------#---2----------#--------------------------------------------------------------------#-------------------
---#------------------o--------------------------------------#----#---------------------Q--#-------------------#------------------------------------------------------------------------
------#------------------------------------------------#-------------------------------#--#---------#----------#----------------------------------#---------S--------#------------------
--#-------------------------------------------------------------------SC-------S--#-----##------S--#------------------------------------------------------------------Q----------#------
-----------------------#--------------------S-------------#-------#------------------------------------------------------------------#----------------S-----------S----#----------------
----------------#-----------------------------------------------------------------------#--------------------------o------S-------------------#----------##---#-----------------------#-
---------------#-----------------------------#--------------#-----------S--------------------------#----#-----------S----------------------------------------------o-----------------#--
--#----#------#--#------##-------------------------------------S-----------------------S---------------------------------------------------------#----------------------#--------#------
------##-----------o-------------#-------------------------------S---------S--#------------##---#----S---------------------#---------#---S---------##-----------------------------------
-------#---------------------------------#--------------------------o-----------------#----------------------------------------------------------o---------------------------#-----#----
--------------------------#------------------#---#-----------------------------#--#-------------------#---------#----#------------------------#------------------#-------------SC---F---
--S-M------------------------------#----------------#--------------------#------#-#-#------------------------S------------------------#----------#----------------#---------------S-#---
X---X---X---------------#--------------#-#--------------SC----------#--------?Q-#--------------#--------#--#-----------#--S--------------------------------------##-----X----------S----
X---X---X----------------------------------------X-----X-----------------------------------------------------------X------------X---------------X--------------------X--X------XX----X--
