----------------------------------------------------------------------------------------------------------------------------------------------------------------------------------------------------------------------
-X-----------T-------X----------X-----X----------------------X--X--X-XX-------------X---X---XX----X----S-------------S----X-------S---X--X---SX---------X--T-X-X--------X----#--S-X------------X---X----X-------XX----
X-X-X--T-X---X-XX----X---------------#----X-S----XX------X--X--X--XX-------X---X------X-XX------X--------XX-------XX--------S---X--------------------------X--X------X-------X---X-----------------------X-----T--X---
-X-----X-----------XS----------X--t--X------------X-X-----X----------------X----X-----X----X--X-XXX------------X---------X------------X----------------X----------------------X----------------------XS----X---X-S--S-
-----X---S--------X------X--------X-X--X-----------X----S----X--X-------------X-------------------X-X------S-SX--------------X--X------------------X--X--X----------X-----------------------X-S--------X--------X-----
----------X-----S------X---X-------X-----X-----XX-----------X-XX-------X-----X---X------------X--XX-------------X----X--------X-------------------------S-----X-------XX-------------------X-------X-X-X------X-------
-XX-X--XX----------X--X--------------X-----X-------SX--X------X-X---------X------------S--X-X-----X---X---SX-X--X-S--X----X-------X---X---------X--X------X-SX--X----X---------------X---X----X----X------XX-------X--
--XX---X-----X--X-T-X--X----X----X----------SX--XX-----X------X---------X------S------------------------S--------X--X---X--------------------X--X----------------------XX-X--X-------------X---------X-------X--T---X-
X---X-----XX-X----X---S-------X-X------------X------X--X---------S---X--X----------------2------X--------------XX-X----X----------S--X-----------X-------XX------------X---------S-X------------S-X--X----------X---XX
------------------X-X-----------------X--X----X-T--------------XX-------XX-------------------------------------------T--X----X-X----------------X-X-X-X-X------X-------X-------XX-------X--------------XXX--S-----X---
--------S-----XS--------------------------------T-----X-----X-------X-X------XX--X--------X---X-------X---------XX---X--------------X---------X-------------------X-X------------X--X------X-------X-X-X-----X--------
--X------X------X-------------------X------S----X---XX-X----------------------X---X-----------------X-----------------X---------X---X------X----------------X------------#-----XX-X----------------------X------------
-------X----X----XXX---XSXX--X-----------------------XS-------X----XX---------X-------XXS---XX-------S----XX----XX---T----X-------------------T----------------------X-X-X---------XX-----X-X--X--X-X-X------------F--
-X-M-------X---X-X----------SX-----T--------X----S-X-----------------X-----X-----------X------XX---------------------X-----X--X---X-----------X--------------------X---------K--------X---------X----X---#---------#T-
---X--X---------X---------X---X----X--------X---X---XSXX------------X-------XSX-----------------S-----------------X-------S--X-X----------------X----X------X------------------S-------------XX-X-X------X--------XXX-
---X-X-X-----------X---X-----------X-------X-----------------------X-X------X---------X-------X--X-----X-------------X---X--X--------------X---------X-X--------X-X---X------------X--XX--X-X----X---------X------X---
