---------------------------------------------------------------------------------------------------------------------------------------------------------------------
----o------------------%-o-S----------%------%%-S--------------------%--------------?------------------------o---------------------------------------%----%---%------
-------%----S-----------------o--%-------------%---S------%---%-----------------o-o--%---------------------%-S---------%-------------------S-------------------------
------S---%----------S--------------------------%-----------S-------------------------%--%-----------S--------%----------------------------------%--------------S--%-
-------%--------------------o--------------o---%--------------------S---------------------------------%-------|----S---------%----%--------------|----------------%--
-----------------------S-----%-----%-S-----------------------------------------%---------o----S--o------%-----%-----------------------------o----%--------------%----
----S-----%-------------o---------%----S-%---------------S---------------------------------------%-----%------------------------------------S-----%------------%--%--
----------------o----------------%--%----------------------------S-------------------------------|---%---------%--------------------%-----------%---%------%---------
----%--%---------%---------------------------------------------%-------%-%----------o----%-------%---------%------S---------------S-----------------|----------------
------------------------S----%-------------------------%-----------%--S--------%------------------S-%-----%---------------------------S--o----------%%-%-----%-------
----------%--%---%----o----S----------------------------------%-S-----------S----------------%------------------------------------------------%------------%---------
---SS---------------------%-o-----S------------%-----S---------------------------------------------%-S---------------%-%-----------------------%---------------------
-----------%--------------------------%-----%---%---------o-------------------------------------%----------%------------------------------------%---o--------------F-
-M-----------------------S----------------------------------%-------%%-------------%------------------------------------o-%----------------------------------------X-
-X-------%%--%------%----------------------------%--------------------------------------%---%----%-----%--------------------o---------------------%-----------S----X-
-X------------------|-----------------X----------|--X-----------------------------------|---|----|-----|------------------------------------------|----------------XX
