------------------------------------------------------------------------------------------------------------------------------------------------------
-----%----------------o--------------------%--------%--------------o--o----------U------------S------------%---%-----------------------------%--------
----%----------------------------------------o-------------------------------%--------------------o--------------------------------%-------------%----
---------------o------------------------------%-------------------U------------%-%-----%---------%-------r-----%-----------%--------------------------
--------------------------------------------------------%---------------------------------------------g--%----------------------S-----------o---------
--------%------S--------------------------%---------------------------------%---------------------S---%------%----------------S-----------------------
-----------------------------------------%--%------o------------%-------%--S--------------------------------%-----------------------------------------
---------o-------------o----o----------%----------------S--------%---------------------------------------g------------o--------%----------S-----------
----------%--------------------o-------------------------------------o------------------------%----------%--------------------------------------------
---------------%--------------------------------------------------%---------%----------------%--------%----------------------------%------------------
-----%---------------%-------------------------o-%------------------------------------------%------------%---------%-------o--------%-----------------
-------------------%------------------------o--------------------------R----------o------------------o----o-----U----------------S-------------U------
--------------------------%-------------%-----%--------%--------------%-g----S--------------%----------%--------------------%----------------------F--
-M--------------------------------o------------------------------------%%-------%%-------------------------------%-------o-------------------------##-
-XX-------%------%---%-----------%----%------%-%---%---------%-------------%---------o-----------------%-----%--------------------------%-%--------XX-
-XX-------|--X-------|-X---------|----|------|-|-X-|---------|--------X--------------------------------|-----|----------------------X---|----------XX-
