----------------------------------------------------------------------------------------------------------------------------------------------------------------------------------------------------------
------X--S------S-X--X----#-------X-----X----------------X----------X-X------X-X-------X--X--X----#--------------X-S-X--%---------------X--XXX----------X----------------X-------S-------X---X--X-X-----X-
--#--X---------X----------X------#--------X--#--#-X-----------------X-------------X----X--------------------X-------------------------X------------------X-----o--X------XXS-------X--o--------X-----X----
------------%---------------#--XX-----------------X---g-------------X---X-------#----%----X---S---------------X---XSX-----Q-----%--XX--X--X----X--X------------X----X----------X-----Q---X-S---X---X-----X
X---%---X-X----S-----X---------------%--------------XX----%-----S--X--------X----X-X-----X---XS-----S-X------------S--X-------X-----X-------------X------S--X------------X-----------------X-----------X--
------------Q-------------X-------X-X----------------X-----X---XS------S--------X---%------X----------------------X--X-------X--------S-----X------%----X---------S--X--------------S---X-------X---------
---X-----#---X--S-------------%-S----------X---X-----X--X-----X---X---X-----------X----S-----%----X----X---------S-----------X-------X--%---------o|------------------------------2-----XX------------K---
-------X----X-X-----g---X-------------S---#--------XX---X-------XX-------X----------------------------X---X--------------------S---------------X---%------#---XSX-X---#----X---#----X-X--X--X------S--X---
X----S#---------X---------X------S------#------#--------------X------X-X------X--------X------------#---#--X-o-XXX-----------SX----X----------------------X--------X-S-------------g--------XX-XS------X--
---S--X--X----S-------%---X--X---------------%---------------S--------X--------------X-----X-----------------------X---g#---X----X--X---X----XX--------------k-S--X----XX---%-XS-------%----------#-----%-
-XX-----------X---------X---S-Q------------%--X----------SX-----------X---X----------------XX--------XS-------S-----XXX--------X--X-------X---XX-------------X---------------S--XX-------X---%--------X--X
X---X----X-X--XX---#--X------------o--------%-----X-o---------S------X--------------------------X-Q-------X--S-X-X---------------------X-X--S------X------------%----XX----#----X--S--#-----X------X------
-----X----S--SXX-----------------------------X--#--Q-----X------X----------------XX--X--------S--------S----X-----S----X--X-X--X---X--------------------------XX-X--------#-----X-------------#-------F---
---M--#--X-----------X------------U-------------X----------XXS------X---------X-XX-X--------XX-XX-X------------X-2---XX----X--------X----#-----g---------S-------X--T--X-------X--------------X--S----X-%-
---X----------X--#-------%---#--X--------X-------o------------X-----------------X------%---------%----------SX-XS------%-------------------%----X----------------XX-X-----X-----SX---------%--X-----------
-----X---------X---------|---X--X------------------------------X--------X----X---------|---------|---X-----------------|-------------------|-------------X---X----------------XX-X--X------|-----X--------
