----------------------------------------------------------------------------------------------------------------------------------------------------------------------------------------
---------------#--------------#-----S-----------------------------------------------------------#-----------#-----------------------------------------#---------------------#-----------
----#------#----------------o---------------Q---------S----#-----------------#--------------------------------------------S-----------#----------------------#--------------------------
-----------------------#---------------------------#------#-S---------#S----------------------------------------S---------------------------#---S-#-----------#-------#------------S----
--------------------------------S-#-------#------------#---#----------#--o----------#--S-----#------------#---------#----------------S-------------#---------#--S-----------------------
---#------S---S---------S---------------------------------#-#------------------------#--------------------------------S-----------#----#--------------------S---------------o-----------
--------------------------#---------------#---------------###-------------------#-----#-#-------------------o-----------------------------S------------------#--------------------------
----------------------#---#------------------S------------------------------------#------------------o----------------#------------------------------?Q-------------#-------------------
-------#S--------?Q----------#S--------------------#----------------------------#--#---#-#-----------------------#---------------------------------------------------------#----------#-
---------------#----------------#---------------------S----#----------------#---#-#-#---------------o-----------Q------#---#-#-------#--------------------------------------------------
-------------------------------------#--------------------------#-#-------------#----S--------------------------------------2-------------------------S-----XS--S-#---------------------
---y--#-----------------#--------------------------------------#-#------------#-#-#-----------#----------##--#------------------2---------------------------X---------------------------
---S--#--------------#----------#--------------------------#------#---#--------------------------------------#------------------------------------#---------X-----------------------F---
----M------#---------------------------------------------------------------#--------#---------------------------------------#---------------------------#---X----------#------------#---
----X--------#-----------------#--#-----------------------------#---------------SS---#---------------------#--------------#-----------------------S---------X---------------#----#------
---XX--X-------X------------------X-------X-----X---------XX-----------------------------------------------X-X-------------X--------------------------------X-----------------X----XXX--
