---------------------------------------------------------------------------------------------------------------------------------------------------------------------
---%--------------------------------------------o------%------------------S-------------%-----------------S---------------%----------------%------%------S-----------
---------------------------S--------------------S---S------%--S-----------------------------------------S------%--%------S------------%-----------|------------------
-S--------%----------------------%-------------------%----------%-----------------------------------o---------------------------------------------%------------------
----------------------%--------%-----------------------------%-%-o----------%--------------------%----------------------------------%---%-----------S----------------
---------%-----------------------------------------------%-----------%------|------------------------------------------o--------------------------%-----------S---o--
------S-------%-----------%-----S------------------S------------------------%------------------------------%---------------%---------------------------------------%-
-----------------------------%--------------%------------%----------------------------------o-------------%------S-----S----S-------%-------------S---%-----------%--
-------S-----S-------------S------%---------|--------%------------------------------------%------S-----------------------------o-------%--------------------o--------
---------------%--S--%----------------------|-----%-------------------------------------%-|-------------------------------------------o-S-----------------%----S-----
------------------------------%----------S-%%-------------%------%-%-------%--%-------o-|-%-----------------------------------------------%-------S------%-%-%--%----
--S-%-----------------------------------------%--%------------%--|--S---S---------------%---------------------------o-------%----------------------------------%-----
------------------------------------------o---------%------------%-%-----%---------------------------------------------------------------------%%%-----------------F-
-M----------------------------------%--S-------------------------------%--%-------o-------%-----%-------S--------%-------%------------------------%----------o-----X-
-X----%------%---o------%----%-%-%---%----%--%--%-%---------%--S--%%---|----------------%--------%-%---%--%-------%----------S-S------%------%-%--------%--%-----%-X-
-X---------------------------|-|----------------|-|---------|-----||---|----------------------X--|-|--X-----------|---------------X---|------|----------|--------|-X-
