------------------------------------------------------------------------------------------------------------------------------------------------------
--o-----------------------S--o--------------%---%------------------------------------------------------------%---------------S------------------------
----------------%--------%-----------------o---------------o-----------------%-----%----------%-%-%---o---------S---%---%------------%----S-----------
-----S--%--------------------------------------------------------------------------------------------------%--------------------%-----------%---------
-------------------%---------------------------%----------------S------------------%----------------------------------------------------------------S-
-------------------------%-------%--o----U-----------------------------------S-------------------%-------------------------%--------------------------
--------------%-------o-------------------------------------%--------------------------------------------------------oo-------------------------------
---------%-------o--%----%--------%------------------------%----%--------------------%%---------%---------------------------%-----%-------%-----------
-------------------%-------------------------%--------o--------------------%-------------------------------%----------------------------------o-------
--------------------%---------S--------------------------%---------%--R-----o-%--------------o--------------------------------%%--------------------%-
-----%-------%--------------------S-----------------o--------------------------------------%---%-----------------------------------o------------------
-------o----%-----%----------------------------------------------------------%-----------%------------------------%--------o---%-----------%-%--o-----
--%----------------------%-----------%-----%-----%-o----S---------------------------------------%-------------------%-------%------%----------o----F--
-M--S-%---------------------o----------------o------------------------------------------R--------------S------%---o------------%----%--------------#--
-X-----%-----%---------%-------------%----%-%-----%------%--%----------%-%--------%--%-------%--------------%---------%-----%----%-----%-%-----o-%-X--
-X---X-|---X-|---------|---X---------|----|-|-----|---------|----------|-|--------|--|-------|--------------|---------|-----|----|-----|-|---------X--
