------------------------------------------------------------------------------------------------------------------------------------------------------
---S-----------------%--------%------------------%-------------------%------------%-------------%-----------------o-%--------------------%------------
-----------------------------%-----------o------------------------------------------------------------------------------%-----------------------------
---------%-------------------------------------%----------------------------------------%-------%---------%----------------%--------%-----------------
---------------------------%%--------%-------%--------------------------------o--------S---------%--------------------------------------------%-------
----%-------------------------------%-o----------o----------------------%-o----------------------------------S-%------------------------R-------------
-----------S-------------------------------------------%-----------------%-------------------------------------------S---------%-------------o--------
------------------%-------------------%-----------------------%------------------o--------%----%--------------o-------------------%----------%--------
---%------o-------------------------------------------------------------------%%------%--%-----------%--S----------S---o-------------------o----------
--%--S-------------------%----------S--%--------------%--------------------------------S-|--------------------------------------------------o---------
-------o-----------------------%%-----------------%--------------------------------%-----%--o-------------------------%-----------%-------------o-%-S-
--------------S-----------------|------------%--------------------------%--------------o----------------------%------------------%--------------------
--------------------------------%---------------o-------o-------------------S--%-----%------%%---------%---%----------------------------o--------o-F--
--M--------%------------------%----%%-----%--S-%-----------------------------------%-----%--------------------%--------------------------o---------#--
--X---------%-------%----%--------%-----------------------X--%------------------%-%-%-----%---------------%---------------o---------%----------o---X--
--X--X------|------X--X--|--------|---X-----------X-------X--|-----------X--------|-|-----|---------------|----------------------X--|------X-------X-X
