-------------------------------------------------------------------------------------------------------------------------------------------------------------------------------------------
---S-S----------S------------------SS-----SS-------------S------------------------S-----S--SS-----------S--S-----------S-2----SS--SS------S--S-----S-----S--SSS--SS-SS-S-------------S-----
------S--------------------S----S-----SS--SS-------------S--S------S---------------------------------------------------S-------------------S----------S---------S---SS-S--S----------------
----------S------------------------S----S---------SS------S--S----S------Q--S------S--S-----------------------S-------S--S-S------------SS--S---S--S-----SS---S----S---S-S---------------S-
-----------------S------S-----S-----------------------S-S-----S-S----S--S----S---------S--S-----S-----S---SSS------S-S--SS-----S---S-----S---S---------U------S-----S-------S--S-S-SS---S--
S-S----S----S------------------S----S------S--S?----S--------S------SS-S-S--S----S--S-S------S---------------S----S------SS---------S----------------------S---------------S---------S-----
--------S--o---------S--S-SS------S-----S----------S-----S---SS--------S--S---------------------S---S-S---S-S---S---S-----S--S--------S-S---------o----S-------S---------------------------
--S--S----SS-S-S---S-S--SS--S----------S---S---S--Q------------------------S---S----SS--------------------------------------S-------S-------S-----S------S----S-------SSS------------------
S---S---------------SS---------Q----SS-S--------S--------S-----S----S---S----S----------S----------S--S----S-----S--S----S----SS---------------S---------S---------------------------------
S------S----------------S----S--S---S-----S------S------SS-S----S--------------------SSS-------------S-------S--g------------------S--S-S-S--S----SS----S------------S-----------------S---
------Q---S--S-----------S---------SS----------SS--S--------------S--S------S--------S---------S-------------SS-SSS--------S--SS----S---------S-----S-S---------------S-S-S-----------S---F
-----------------S------S----S-SSS---S-S-S--S-S-----------------S-------S---------S-S--------------------S------X--S----------S----S-----S------S---------------S-------S-----------------S
--------S------------S-----S-SS--S-----S----------SSS-S---S-------S-2------------S-X-----S---S--------S---------X-----S----S-S-------------S-S---SSS------------------------S-S---S-------S
--M-S-----SS-----S---S--S------S------SS----------------CSS----------S-------------X--------------------U----S--X-----S--------S-----S-S---S---------SS------S----SS-S---------S---S-S---S-
--X----S--S-------S--S-----S----SS-------S---S------S-------S-S---S-------X--------X-S---S--S----S-----S--------X----S-X-----S--S--S---------SS---S-S-------S-----S--SS--SS-------S-S--Q--S
--X------X-------XX------X-----X-------------------X----------------------X--X--X--XX---------------------------X-----XX----------------X------------------------X--X-------X--------X---X-
