----------------------------------------------------------------------------------------------------------------------------------------------------------------------------------------
----------#-------------S-------------S----------------#--------------#--------#--------------------------------------------------------------S------------------------#---------#--#---
---------------------------------------#--------#------#--------------------------------------------------S------------#----#--------------------------------------#---------#----------
--o------------------#------------------------------#---------------------------------#-----------------------#-##-------------------#-#---------------------------------S-#------------
------#----------------#---#-----------------------#--#--------------------------#------------##----------------#--------------------------------S---------o----------#-----------------
-#--------------------#---------#-#S-----------#------------------------------------Q-#-----------------------------------#----#S-#--------#--------------------------------------------
----------#-----##--#-----------------------Q------------------------------#---#---#----#------#-------------------#---------------#---------------------SS------------------#----------
-----------#--S--------------------------S----------S----------------#---------------------------------#-------------------S------------------------------------------------------------
--#----------------#---------------------------------------------------------------S----2------------------------#-----#-----------------------------S------------#---------------------
----------------#------------#---#-------------------#-----#--#---------------------------#---#--------------------------------------------------------##------#--------------S---------
--#--------------------o--------#--#--S----------------------------------------------------#-------------------------------------------#----------------------#-------------#-----------
---#-------------#-----------------------------------------------#----------------------------#--------#-----------X----#-------------------#-------------#----------------------#------
----------#-----------------#------#------------------------------------------------#---S-----------------S--------XS---------#------------------#-------------#----#---------------F---
----M-----#--------------------------------Q-----------------------------------------#-----------------------------X-------------------------------------------------------#--------#---
----X------#-------#-------------------------------------#-----#-----#----------------------------S----------------X--------#----------------###----#-----#------------------X----------
----X--------X-------X----X-----------X-----X-X---X------XX-------------------------------X---X--X-----------------X-----------X------X----X-----X---------------------------X----------
