--------------------------------------------------------------------------------------------------------------------------------------------------------------------------------
----#---#-----#-------------------------U---S-----1---------S-----------------S---S-------------------#----------------#---------S----K---------#------------------U--#-S-------
----------------------------------------------------Q-----------------------#-------------------S-----------------------------------#-----------------------------#-------------
-#-----K----------#----S---------------------#-------S----------------------------------Q---------#------------S-------------------------------------------------------K--------
--S----------------------#----#------------------------#------------#-----------K-----------#-----------------------##-S-------------------------#----#---------------------#---
-------------------------------S-----------------------------##------------#-Q---------------S---#-#-------#----------B------S--------#-----------------S--S--------------------
---------------------S-----#--------K-----------S----------------------------------------S----------S---#-------------b------------------------K----#------------S--------#-----
----------S-----------------------------#---------------------------------------------#-------------------S-----------#-----------------------------------------#---------------
---SS--------------------------------------------------------------------#-------#-------------------S--------------------------------------------------------------------------
---------------#-----------------K--------------#-----------------------------#------------------------------S---------#-------------------------#------------------------------
----------------#----S-#-------------------------------------------------#---------#---S--#-------------------------------------#----------#---------------------------------#--
-----------------S----------------------------------S---------------------------------------------S--S---------------------------#----#--------------------------------------#--
--------QQ-------------------------B--------#---------------------------------------------#---------------------------------S-----------------------#-----------------------F---
-M---------------------------------b---------------------------------------K-------S------------------------------------S--------------#-------------------#-SS-------------#---
-X-----------#---------------------X-X-----------#-------X-----X--------------------T---S--------------------S-----------------------------------#-------X----------------------
-X-----X---X---------------------X-XXX------XX--XX-------X-----X----------------X---X--X-----------------------------X---X-----------------X--------X-X--X------------X-----X---
