----------------------------------------------------------------------------------------------------------------------------------------------------------------------------------------------------
-------------#-#-------------------Q------------------------------#-----------------------------------------------------------------#-----S--g----K--------------------------------------#-----#----
----S------#-------------#-------------S----------#----------------------------#------#----##-----------------------------------S------------##-#-----#---##-----------------#-----#-------------#--
--------S---------------------------S-----------------------------------------#--------------------S--#---SC----------------S--------------------------S---X------------S-----------#----#----------
------------#----#---------------------------------S-----------------------------#----------------------K----------###-------------------------S-----------X--------------S-----S-#---S-------------
--------------#------------------------------------------------US-------------------------------#-----------------#-------------------------#----US--------X-----------S----------------------------
-----------------------------#-------------------------------------------------S---------------------------------------#-----------------#-----------------X-------#-----------------------------#--
-------#------------------------S--------#-#-------------------------#----#-----S----S--------------------------SC-#-------------------#-------------------X------#------------------------#-----#--
---#-----------------------S--------------#-------------#------------#-#----------#-----------------------------K-------------------#------------Q---------X---K---#--------------------------------
-------------------S------------------------------------------------#---------------#----------------S--------------------------#--S------------S----------X-----------S----------------------------
-----#--------#----------------------------S--------------------------------------------#---#-----------S---------------#----S------------#----#-----------X-----------------#-----------#----------
-------#--------------------------------------S-#--------#----#-----------#-----------------------------------#-----------------#------#----------------K--X------#---------#-----------------------
---------#-------------------------------------#------#------------------S--------------------------------------S--------------#--------Q------------------X----------#--------------------------F--
-M-------------------------------------------------------------S-------S-----------------S---#--#----S--------------------------S----------------------#---X-----S-----#----------------------#--#--
-X-#-----------#---##--------------##-------------#-----------------------#-----------?-X----------------------------#------------------#------------------X--------------X-#------------#---------X
-X---X-----------------------X----------X----------X-XX----------------------XXX-X-----XX--------X------------X-----X-----------X-X------------------------X-------X------X---X---X-----X-------X--X
