----------------------------------------------------------------------------------------------------------------------------------------------------------------------------------------------------
--S--------------------#--Q-----------------------------------S------#--#------------1--------------------------S----------Q-------------#---------------#------------------------------#-----------
---------#-----------#-------------------#---------------------------------------S-------------Q-------------?---------------S------------------------#-------------------------------?--#----------
-----------------#------------#-----------------------------------?-----------------------------------#--------------------------------#-------K------------------------------------------#---------
----------------------#---?----S-------------S------S-------------------------------------S--------------------Q---------------K------------------S---S--S-----#---------#-#-----#--#---------------
---------------K-----------------#--------------------------------#-------#---#-----------------------#-----#---------------------------#------S-------------------#------------#--#--K-------#-----
----------#---------S------------------#---------------------#-------------------#-----------------S-----------------#----S-------------------------------------------------------#-----------------
------------------------------#--------------------------#---#-S-----------S---------#----#--?----#------------------------------------S----------------S-------------------------------------------
----------Q--------------S-------------------------#----#-------------------------#-----#-------------#-------------------------#----Q--S-K-----#-------------------#-----S------#------------------
-#-------------SS---#--------#----#---#--------------------#-------#-------#-------------#------------------------#-----------------------------------------S--#---#---------------#--------S-------
---#--------------------US--------------------------------#------------#-------------------------------------------------------?-##-------------#-----------------------------#----------#----------
---------#-------------------#-----#--#--#------------#--------------------S------------------------------------------##----------#-----S---S-----------------S--S----------------------------------
----------------------#-------------S------------------------K---k------------------#------------------------------------------------Q-----#----------S---------#----#-QS---------?-------#------F--
-M---#-------S-----------------------------------------#---------S-----#---------------------------------------------S---------------------------------------------------#---------#----#--------#-X
XX-----------------------------------------------------------##------K----#------------X--#--#-#-------Q-----SC---#-----------S-----#---------------------------------#------------#----#----------X
XX-X----------X----X-------X-------X-----X-X--X-----X-X---X-------X------------X-------X-X--------------XX-------------X-X------X-------XX-------------------X----X-----X--X---X------X------------X
