----------------------------------------------------------------------------------------------------------------------------------------------------------------------------------------
---------------------#---------------------------------#----------------------------------------------------------------------------#1-----------#-------------------#------------------
-------#---#--------------------#-----#---------------------------------##--------------------#----------o-S----------------------------#-----------------------------------------------
------------------------#-#--------------------------------------------------------------------------------------#----------------S---#-------------------------------#-----------------
-Q-------#-------------------#--------S------o--#---------------------------------#-------#-----------------------------------------------------------------#------------------y--#-----
---------------------------#-----------------------------------------------#--#----------------------------#---------------------------#-----------------#---------------------#-----#--
---------------------S--------------#--------#---------------##------------------#-S------S-----------#-----------#-------#---------------#-------#------------------#------------------
-----------------------------------------------------------#--#--------------#-----------------S-----------------##-----------------------#-------#---#-------S--#1-------#-------#-----
---------#-----------------#----------#-------------------------------#--#------#----------------------#---------#----------#---------------Q-------------------------------------------
---#---#----------------#---------------------#--------#----------------------------------------------------#-#-------------------------------S--------------------S----------S-2-------
---------------------------------#---#--------#----------#-----------------S-#-#-----S-#----------------#--------------------------------------------------#----------------------------
---------------------#-#--------#--------------------------------#--------------#--------S-#--------------------------------------------S----------#---#----#-S--y#--------#------#-----
---#-------#-----------#--------------Q-#-#-------------------------------#------------------------------------------------#-------------------------------------#-------------o----F---
----M------#---#-----------------#----------S-----------#-------#------------#-------------------Q-------------------?Q---------------------------------------Q------------------#--#---
---XX-------------------------S-------------------------------------------X---------#--------#-------------------------------------------------------X-----o----------------------------
---XX--------------X-XXX--X----X----X---------X---------XX---------X------X-X--X-X--X---X---X----------------------X-------XX----X------------XX-----XX--X------X-----------X-----------
