--------------------------------------------------------------------------------------------------------------------------------------------------------------
--------S---------------SS-----S---S----------S----SSS----S-S---S--------S------------------S------S---S-----SS---------------C-S------S-----o----S--SS-----S-
S----------S--------------S-----------S----o--------S----------SS-------S-----------------------S-------------------S-----------------g-----------S---S-------
-----------------------------S-------------S--S-------------S----------------S--S----------S--------S---S---------S--S--S-------------S----S-----------S------
-----------S---------S-SS----S----S-S-------------------------------------SS-------S--S--S-----S--------------S-------S--o--o---------S---S-------o--o----S---
----------------SS----S--------S-S--S--S-------C-------------------S--S-----S----S------------------------S---S---------S------S----------------S--------S----
SS----S---S----S----S-------S----SS-----S------------------------S----------------------S-------S--------S-S-S--S-------------S---------S----------------S----
------------So----S----S---S-----------------S------S--S-S-S---S-SS-------S--S-------SS-SS-----------S---C-----S-----------S-------o---S---------SS-----S-----
-S-------S-S---S---S---SS---S-------S--SSS--------------------------------------S---S--------S----S-S--S--------S----S--------------------S-------------------
----S---------U-----SS----S---------S---S----S-----------S----------S--------S-S-----S--------------S------S-------------S-S-SS---------------S-S-o-------S---
S--------S-----------S-----S--S----S-S--------S--------o-S--S--SS------S----S-------------o-S---------S----S---------------S---------S---------S-g------------
---S-S-------------------S-----S-S----------S-----S---S--------------S-------S--------------S----S--------S-----o----S-------o--S-S--------------S----S-------
--------S---SS---U----S-------------------S--------------S--S----o-------SS-----------------S-----------S-S--------o--o--S-----------------S---S-S------------
---M-S----S-C------S--S----------SS-------SS-S--------SS----------S----------S-------S----o-S--------S--S--------S---S-S------------o------S----S-----------F-
-S-X-S----------------------------------S--------------------------S--S-------------------S-SSS----X---S---------S---S-------S-------o------SSS---------S---X-
---X----------------X-------X----X--------X-X---XX-X----X-------------------------X----X--X-------XX----------------------X-X------X----X-X-----------X--X-XX-
