----------------------------------------------------------------------------------------------------------------------------------------------------------------------------------------------------------------------
----SX-------------X-----------X---X-----------------X-------X---X-----X--X-------X-----X------X-X--------X-------------------#-------------X----X-T----XX--X---------------X-----X--X------------------------------X-
--X---------------X--------T---------------------------------X-X-X----X---X-----S-----------------XSXX--X----------XX---------X-U------X-----------X----XX------------------X---------------X-----------S------X---XX-
--------------------X-----XXXX----X---#------------------------X----X-------XX--------------------X--------------X-XX---------XX--#---X-------------XX-X---------------X-----X--X-X-----X--------------------k----SX--
--------X-------X----X--------------X-X----------X-------X---------------S-----XXX---X-X------X-T----XX-----------------S---------XX--------------------X-------X--------------------X----X----------X-------XS--X----
---X------X--XX------------X----XX--------#-------------------X-----X---X---------------X-----X-XX--------XX---X----X----XS--XS-T-----X------X---------T----XXX------X-X---XX--------X------X-----X---X--------X-----X
------S---X------X-S----X------------XX--XX------------X----------------X------X-X-XS-X--#---------------SX---X-----X--XS----X--X-----X--X-------------X-----------XX-----SX------X----------X---------------T----X--X
X---XS---------------------XX----------X------------S----2----------------------X--------X-------------X---------X------------#-----X-X----X------X------X-X--X-----X----X----X----X-------------------------X--------
----X----X---------X--S---X--XX-X-----X----------X-X--X-X-----X----X-X--X----------XX---X--X-----X------X--XX-X--X----X-------X-SX--X---U-----T---X------X-XX-------------XX-----X------XX--U-XX-------X-----------X--
---X-X---------------------------X-----X--X----X-X-----------------------------X-X-------------------------X-----------X---------X-X---X-----XX-X-------------X-T--X-----XXXX----XXX-------X---X----X--X----------X---
------------------------X------X------T---X---T-----X-X------X--------T----X-----X-------------------------------X--------------------X----2---------#----X-----X---------X-XX-X----X---X----S--------X-XX--------XX--
-------X----------------X-X-X---X-----X----X-XX------XX--XX-----------X----X-#---X-X--X---------X---X-#----X---X--X-------X-----------XX-------------X---X----------------XX-----X--------------------X-X------------X
-----X---------X--------X---X--X----------XX-----X-------X------------X--X---X----S------X---X--X-----X----X----XX-X-----------------------------X-X--X---X---X-T---XX--XX-------X-------------X---X--X---X--------F--
---M------S---------------------XX---XX------X------X----------------XX-X------------X-----------------------------XX-----X-X---X-----------K-----------T-XSX---X--XX----XX----------X-----XX------------X-X----X--#--
X--X----XX--------X---X------X----XX--X------X-----X----------X---X----------X-----------S-----SX-----X-----X--------X------------X-------------X-------X---------X----------X------X------X-----X--X--------X---X-X--
-----------------X------X---X---------------------X---X--X----X------------------X--XXXX---------X---X---------X----X----------X------------X----------------------------X-------X-------X---------X---------X-----X--
