----------------------------------------------------------------------------------------------------------------------------------------------------------------------------------------------------------
X-------K----X-------X-S-%-------X--------X---S----o------X---X-XX------X-X-----#---------X-----#----X-------X---------------X--X--X------S------------------X-------#---#----------X-----X--X------X---X-
X------#--------X-S---#-------S----S-----U-----S-XX--XX----X-#-------------S-X---XS--------S-------X-------1---------X-------X-----------X---------X-----XX------X----X---X--X-X-------------------X--S-XX
-XX--?--X---X--------#--------------------X--#---------X-------------#--------X---S-------#-------#-----X--------XX--------X---------X------X------------X-XS-----------S-------S--------X-----X----------
---X--X--X-#-------------XS-%--------XX--X------X--X-----TS----------X-------#--XX-----S-------------X-X-------XSXX-SX------X--#-----------C--X-S--So----X------X--?------X----------X-----X------X--#----
----------o----X-----#--X-----------#--X----X------X-----X---X-#--X------------X---X----------XX---o------#---------X---------------------------X--X-------U-X-----------S------------X--X------------X---
-------X------#----X------------------------------------X--------#-------------X-X-----X-XS------%---------%--------------#------------S---X-------------X---XXX-----X---X--X--S-------------X-------S--X-
-----X---2--X-X--------------X-#------X--------X--T-X--XX---------X-----XX-----------X---X----------------------X---#T------T---X-----X--------------X-----------g-X--XX------X--S-----------X---X--------
------------X-X-----------g-----------------------XX--S---#------#--------------%---XX---X------X----S-----X---SX----X------X-----------X--#--------%----------X-----X--------X---------S-X----XX-X-----XX
---g--------X---X--------------------XX-----------------------------%--X----C---------X-------U----S----X---X-----XX-X-X---X-X-------#---X------?----#-----------------X------X---X--S--------------------
----o-----X----X----------------XX-----X-----------X-X--X----------g---X-X----------X-----X---SSX-S----%-S-------X-------------------------------S----------------X-------X---------------#---X-----------
--------------X-------------g-------XXX---X-------XX---------------X-----------X--------#-----X----------------------------------------------------X--------------X--Q------XX----X--------K-X--X--X------
-----S---#-X--------------------XX-------g-----X-S--X--X----#-SX---X----X--XX-g--X---g---------------------SX----#--------%-X---#---------------------XX----X---X-------X-------------------T-----S---F---
X--M---X----------------------------X----S---X-----------X-X--SX------X---------X---X-------X--------------------------X--|----X---X------X---X----------X---X---X----X-----X----------XX---X-X-------X--S
---XX--------X-----------------------X-X---S--X-------X-----------X--------------------%------XX--------------X-#--o-X-X--|----------------------------X---T--------%----------X---#S----%----------------
--------------------------X----X------------------X---X--------X---------------------X-|----------------------------------|----X---------------X-----------X--------|----------X-----------------------X--
