----------------------------------------------------------------------------------------------------------------------------------------------------------------------------------------------------------------------
---X------S-XX-------X----X------S----X------X-------------------------------X---------X----XX--------------X------X--X---------S------X-----S---------X---X-X----X---------X------------XX------------------XX-----X-
----------------------------X---X---X---X----------#---X---------X-X-------X---------X------X-----------------------X------X-X-------------X------------X--X----X-----X------------T------------X----X-----X--X-X--X--
------XX-----XX------------X---X---------X---------X------X-------XX--------X-X---------X-X----------S-X--------X-----------X-----X-------------XX----X---------------X------------X-U----X-------------------X-------
--X--------------XX--X--XX--------X---K--XX--------X---------------------------SX----XX--------XX-------X--X--------X--X---X-----X--X-------X-X-----------X--X-----X-X---X---XX---XX--X------X---X-----------------X--
----X-------X----X---------S---X---------X--X--------------XX-XX-X---X------SX-----------X--X--X----XX--X------X-------------------X-----------------X---XXXX--------X------X-X-------X-----X--------------X---2-----X
--XS---S------------X--X----------------XX-T-------X---------------X------X------------------------X----------------X-X-SX-XX-----X--T------------X-----------XX-----XX----------------XXX------X--XX--X--X-------S---
--X---X--------X------------X----S---------X-----------------------X----XX-------XX--X-X---XSX----X------XX-------X---------X--------X-X---X--XX---------XX--------X------SX---------------X----X----X----------X-----
--------X-X---------X--X--------X----XXX--------XX---------X---X-SS-------X---------X----------------X------------X----XX-----------X-X-X---X---XX--X------X--------------------X-X---X-XXX---------------X-----X-----
-----X----------S--------------S-X------X----X-X-------S-----X------X---XX--X--------X--X------------------------X----T---------X--------X----#--X------------------------T-----X-------------------------------------
--X---X-X-X---------------X------X--X---------------X----X------------X------XX-----------XX---X------------X-----X-X-X---X-X----SS-------X---X------X-XS-----------------X--------X--X-X-------------------XX--------
---------X------------------------------------X--X-------------X-------X--X---XX--------X--------------X---T-T--X------------------X---------X--X--X-------X-------XXX---XX----------------------X-----X--------------
----------X------#--------X---------------------------X--X---------t-------S-----------X-------------------X-X-X---T-------X-----X-XX-------------X-------X--------------X----XX----X-----X-----X----X----X--------F--
---M-------S-X---X-----X---S-----------X----------------------X----X---------X-----X--X----------X-----------------X--XX-2------X------X----S--------X-----------X-----------------X---------------X------X--------#--
-S-X------X---------------T-X--X-----XX--X--X--X----------------S--------X------K----X--X--2----X---S----XX------------XX-------X------------------------------S-------------------X-----X--------X----------------X--
X----X----X-X---X-X--XX---X-----------X------X-----------------X-------X---X--X-----X------------------X----X--------X--------XX-------X--XX----X--XX--------------------X-----------------------X-----------------X--
