---------------------------------------------------------------------------------------------------------------------------------------------------------------------
-------%-S------%-----%-----------o--%----------------------------------------------------%--------------%---%----------%------------S--------------o--------------o-
----------------------------------------%-------------------------------------------S---------------------------------o-------------S--------------------------o-----
------------%-----------------------------------o---------o-S----------%%------------------%--------------------------%--------%-------------------------------------
------------------------------S----------------------------------------------------------------------S--------------------------------------S----------------%---S---
--------%--------------------------------------------------%-----------------%---%----------------------%-----------S-------%--------------------------%-%-----------
--%---%------%--S-------------------------------------------------------%---------------------%--S----------------------------------o-----------------------------%--
-------------------------%----------%-------------%-----------------------------%-%-----------------S-----------------------------------%---------%--------o---------
------%----%-----S-----------------%--%---%---%--S----%-------------------%----------------S-----------------------%----------%--------------------------%-----------
------------------------------------------------------|-------------o--------S----%--%-------------%-------------------%-------%---%--S--------------%---------------
--%-----------%%-------------------------------------%%---------------%-------%---------------------------%------------------S------%--------------------------------
-----%--%---S---%------------------%-----o-------------o---------------------------------------------------o------------------%--------------------------------------
---%---------------------------------------S--------S----------------------%-------------------%--------------%---------------------------%--------------S---------F-
-M-----------------%--------------------------------------------%----------------------%--------------------%------S-----%--------------S--%------S------------%---X-
-X--%---%-------------%-%--%---%------%----%-----%----------%-----------S---%%---%---%--------%%---%-%-----------------------%---%--%---------------%--------------X-
-X--|-------------------|------------------|-----|--------------------------||---|-X-|--------||---|-|--X------------------------|--|-----X----X-------------------X-
