------------------------------------------------------------------------------------------------------------------------------------------------------
----%-r-----------S-------------------------------------------------o-----------------------------------------------------------------R---------------
------%---------------------------------------------------------------------------------------------------------------%---------------------------%-o-
-%------------------------------------------------------%-----------------%--------------------------------%---o--%----------------%------------------
---------S--------------------------------%------------------------o---------%---%-----------------------%--S----------%-------------------%----------
---%----------------------o-----------------------------------------------o----------%------------%-----------------------------------%-------------%-
------%------------------------%---------------------%-------------o-------%%--%----------------------%-----------------------------------------------
-------------------%--------o-------------------------------------o--%------------------------%----------------------------------------------------%--
-------------------------------o------------------%---------------%------o----------%------g-----o----------------------------S-%----------%----------
------------%--------------------%---------------------%---%----------%--------------------%----------------------------------------------------------
-S------------------------------------------------------------------------------------------------o-----------%---------------------------------------
----------------%---------------%%-%--r---%-----------o-------------------------------------------%--------------------------------------%------------
------S---o------------o--------------%-----------%%-------------------%--o-------------------S---------------%-------S----------------------------F--
-M-----%------------S--------------------------------------S----------------------------o--%--------------------R-%--o--------------%--------------#--
-X---------%%-%------------%-%%----------%-------------%------%----------------R---%---------------%-%---------------------%---------S------%---%--#--
-X------------|------------|-|-------X---|-------------|------|--X-----------------|-------X-----X-|-|-----------------------X--X-----------|---|--X--
