------------------------------------------------------------------------------------------------------------------------------------------------------
----S-----o--------------------------------------------------------------%--o------------%----%----------------------%--------------------------------
-----o------------------------------------%----------------------%----------------------%-------%----%----------o-%--------%---------------%--o-------
---------------------------------------------------------------------------------------------------------------o---o-------------%--------------------
---------------%--------------------S-------%------------------------------------------------%-%-----------------------------------------%------------
------------%---------%-%---%--------------------%---------------------%--------------------------%---%--%-----------%---------------o----------------
----------%------%--------------------------------------------------------------S------%------------o-----------------%----%----------------S---------
-------------------o-------------%-----------------------------------%--------------------------------%---------------------%-%---S----%-%%--------o--
------------------------%-----------------------%----------------------------------------o--%----------%----------------------------o----|-----%------
-----------------------------------------------------S------%---------%-%----------%-----------------%------------------o----------------%------------
--------------------o------------o-------------------------------------------------------%--%-------%-------------------------S-----------------------
--------------------------%-----%-----%%------------------------------------------------------------------------o--o------%------------------%--------
----%--------o-------R------%-----%%--------------------%%--------------------------------------------%------------------------%-------------------F--
-M----------------%----------%-----------------------------------------------%----------------------------------o---%-%----------------------------#--
-X----%-%%-%-R---%-%---%-%-------------%----%-----%-------%--%-----%--------S---%-%--------------------%--%----%-----%-%-%-%-%%--%-------%---------#--
-X----|-|--|-----|-|---|-|-X-----------|----------|-------|--|---X-----X--------|----------------------|--|----------|---|-|--|--|-----X------X----X--
