----------------------------------------------------------------------------------------------------------------------------------------------------------------------------------------------------------------------
--X--------X----------XX------X------X-------------X-----------X---------X------------S--------X------------------XS----------X-----X-----X-------X-------X--T-------S------X--------------X------X------X------------
----X--------X--------X------X---X-----X-X---X--X------------X----X-S--X-----------------------------X--------------#--X-------SXX---X-------X--------------XXX---------X---------------------------X------S--S----T--
-----------------S--T---------X--X----X---X---X------S----------X------------------X-----------------X--XS-X-2---X--X-X---X-XX---XX--------T------X---------------XX--X------------X------X--X----S--X-------------XX-
---S---------X------X-X-----------X---X---------X---S---X------X----------S------2-----XX--------X-----------------------XX------XX--------X-------------X---------X----------S----X--X------XX--X---X------X----X----
----------------X--X--------X-----------------XX------------X-X-----XX--------------------#-----X---------X--------X----X-X----K---------X--X-XX----X-S---X-X------------------------XX------X------------------------
X-------T-X------#-----X------X-------X---------------------X--------------------------X--XX-----X-----X---X----T--X-------------------XX----------X-------------X-X-------XX--------X-----------X-------X--T-X-------
--------X----X---X-------------X-----X----X------X-X----------X--------------X--------X------------S-----X--X-X-X---------U---X----XX---------X-T-------X-------------X-------X-----T----X---#----T---------T---------
-X-X----------X----------X-------X--X--X-----------------S--X---XX---------------------------------------------XX---X-X--X----------X--------X--X-S-----X--S-X---X---------X--------X--------X----X-X-X-----X---X-----
-------------------------------------------XX--X--X---------X-T---X-----------X-------------S---X------------X--X-X--X----X----XX-X---X--#-X-X--------T-----X-------X----X--X--------------------X-----X--X----X------
-----X---X-------------------------------X--X------X---X------X------X----X--------S------X-------X-X----X---X-------X-------------X-----X--XX-X-X-XX-X---------------------X-X---------------------X--------XX-------
----X-X------------------X---X--X---X-X---X-X-XX------X-XS------X-----X---------XX---X-------X-X-----X----X------------------------X-------------------------X--S--X-------XX---------------X-XXX------K--X-----------
-----X--XS-------------X--X-------X-----X----X--------X---S---X-X-------------------XX--------X---T-XX---X--X------X-X-X------------------------X---------X----X-----------X------X----------X---X----X----X-------F-X
---M--------X--X-------X----X---X--X-X-X------XS----X----------------X--------XX--------X---------X---X---------X------X---X---------X----X-X---------T-------X-------X------X------X-------------X-----X--X-------#--
X-XX-X----X-------------X----X-----X--------X-X---X--------X-------------------XX-----------X-----------X--X--------------X---------------------------X-----X----S-SX--X-XX-----S----------------S-----X-----2----XX--
-X-XX---X--------------------------X------X----------------XX-------------X-----------X----X-----X-----X---------X-----X-----------X-X-----------X--------------X-------X-----X--X---X-X----------------X-------------
