---------------------------------------------------------------------------------------------------------------------------------------------------------------------
------o--------------------------------------------------%-------%---o--------S------S-------------------------------%-----------------%----------%------------------
--%-------------%-------%--------------S-%----%------------S-----------------------------S---%---------%----%-----------%---------------S------%---------------------
-----%-%------%%---%-----------------------------%-----------------------------------%--S-----------------------%-S------------------%---S-------S--------S-%----S---
------------%-----------o-------------------------------------------------------------------%------------------------------------------------------------------------
---------%-------------------------------------------------------------------------------------------------o----------------S--------%------S----------%-------------
-----------%--------o---------------------------------------------------------o-----------S--------------%--------------------------S------------------------------o-
---%--------------------------------------------------%---------------------------------o-----S----------------------------o-----------------o----------%--o---------
--------------------------------S---------------o--------------%---S--------%--%-----------------------------------%-------------------------------------------------
--S-----------------------------------------------%-----------------?-----------o-------------------------%-------------%----------%--%-------%-%--------------------
-------------o--------%----%-%----------------%-------%--S-S------------------------------o------%----------------------------------------------------------------%--
-%--%%-----------S--------%----------------o-----------------%----%-------------%-----------------------------------%-----------------%-----%------------------------
-----------o--------%----------------------------------o-----------------------------------------------%-------------------------------------------------%--o---o--F-
-M-------o----S-%%----------------------------------%---o-------------------------------------S--------------------S-----------%-----------------------------------X-
-X-------------------------------%-----S-----------o-------------S-----%-----%----S---------------------%--o-------------------------------------------------------X-
-X--------------------------------------------------------------------------------------------------------------X--------------------------------------------------X-
