----------------------------------------------------------------------------------------------------------------------------------------------------------------------------------------
------------------------S-----#----------------#---#----#------##--------------------------------#---------#-------------o--------#-----------#----#-------------------------------#----
--------------#--------------------------------------------2------#-----------------------------------#----------------------#-----------o----------------------#-------#---------------
-o------#--o-------#----------#--------------------------#----------#----------------------------------------------#------#------------------------#-----------S------------------------
-----------------------------------------------S----------------------#------#--#--------------------------#----#---#---S--------#---------------------Q----------------------#-----#---
--#------------------------#--------#---------------------#----------------------------------------------------------#---------------------#-----#--------#1--------------S-------------
-----#-------------------------#-##-----------#--#------#-#-----------#---------#------#--------Q----------S------------------------------------------------#---------------------------
---------------------------##----------------------------------------------------y--------------------S---2-----##---------o---------------------------#------#------#------------------
-----------------#-------------------#--------------------S--S-------------------#----------------------S-------#-Q----------------##-------------#----------------#---------#-##-------
---#-------#--#-----------------------#-#-----------------------------------------------------------------------------------SS-#---------------------X----------------#--#-#-------#----
--#--#--------------#-#--#----S---------------------------o--------o--------#---#------------------------------S-#------------##---------------------XS---------#--------------------#--
--------------------------------------------------------#----------------------------#1--o--------#---------------------------------#----------#-----X----------------------------------
-----------------#-------------#----------#---------#----#-----------------------------------------------------S------o----#-------------------------X------------------------------F---
----M----------------#--#--------#----------#-------------#------------------------------##------#-#------------#-----------------------#------------X--------------------#------#--#---
----X-------------------------------------#--------#----------------------------------------------------------S-----#--#---#-----------------X-------X-------------------#--------------
----X----------------------X-----------X---------------------X---------------X------------X-------XX-----X-----------X-----------------------X----X--X---XX-------------------X-------X-
