----------------------------------------------------------------------------------------------------------------------------------------------------------------------------------------
--------##------------------------------------------------#-----------------------------------------#---------#--------S-----------------------------------o----#----#----#-------------
-----------------------------S---------o--o------------------------#-----------#--------------------------------------------------------o---#--#----------------------------------------
------#--------------------------#---------------------------#---o-----#------------------------------#---------------------------------------------#-------------------------S---------
-------------------------S-----------------------------#------------#----------------------#-----------#----S--#------------------#-------2-----------#--#------------------------------
---------------------------------------------------------Q--------------------#------------#------------------------#---------------------------------#---------------------------------
----------2------------------------#--------------#---------------------------------------S---------------#------------#------------#------------------#--------------------------------
-S----#-------#-----------------------------#----#--S-----------#-----------#-------#------------------------------------------------#--------------------------------------------------
-----------------------------------------------------------------#--------S--------#-------------------------##-------#--------#S-------#--------------------------------#--------------
-----#-----#-----------#---#-----------------------2-------------------------#----------#-------#----------------S-----------##------------------------#------#--##--S------------------
----Q------##------------------------------##-----#----------#-------------#----------------#S---#--------2-------#-----------------------------#------------#-#------------------------
---------------------------------------------------------------##--------#--------#-------------------#-------------------------------------------------------#--S---------#S-----------
----------------------------------------------------------o------#--------------------------------------#-----#-----#--------------------#--#-----------#------o-----#--------------F---
----M---------------------#-------------------------------------S-#------#------#-------#--#-----------------------#-----------------------------------------------##-------------#-#--X
----X--------------------------#-#---##--#--S---------------X--------------#-------------------------X--------X---------XX--------#-------------------##---------------------S---------X
---XXX---X--------------------------------------------------X------------X------X---X---------------XX-X----XXX-X---XX--XX-------X-------------------------X--------X---------X--------X
