----------------------------------------------------------------------------------------------------------------------------------------------------------------------------------------------------------------------
------X-------X--X-XS----------X-----XX---X---XX---X---------------X---------XXX---------------X--XXS--------X------X---X-----------XX------X--X---X-X-------X---X-----X----S-----X-----X-----X---T--X----------S-----
----------------X----X--------X---X-------X------X-X---XX---------XX--#-------XX-S-X------SS--X--S------------------------X---X--------X---------X---------XX-----------X----X--------------------X--X------S--------X
----------------------X----------X-X-----------------X--------t--X--X-X-----#-----------X---X--------X--------X-X---X----X---XX----X--X---------------X--------X-X--------X--XX---------X---------X----X-X-----X------
--X---------------------S----------------X-------#-X---X----S-X-------------XX-X-XX-----X----X----XX-------S-----T-----X----XX-----X--X--X----X-------X-----X----X--T---------XX-XX----XXX-----T-----X-----#-----X----
---T--------X-X-X------X-----XX------X-----X-----X--------------------------------------X---------XX--XX-X---X---X----------X-----X-X--X-X----------X-------X-------X----------X----X---X--T---X-----XX----X----X-----
X--X---XX--S------X--------T----X---------X---X-X--X----X--XX--X---X----------XX---------S-------X----X---X-------------------X--XX---X----X-X---X-X-------S-----------#------X---X----X---X--------X----X----X---T---
-----------------------X---XX-----X-----X-------X-------------------S-------------------------------S--XX-------T--------X----------X-------------X------------X-S--X--X--XX---------X--X-------------X---X--X---XX---
X---------------------X-----X----X----------X--------X-----------X-----X----------------X------S----------------X---X----XX--X-X-----X-------X-------------XXS------X-----------------------XX--------X-----------X--X
------------X--------------------X---X-------X---X----------T---XX-----X--S----X-----------XX------------------------X--------X----------X---------------X--X-----------------X--X-X---X--X-X------X-X-X--------S-----
--T---X--X----X--S------X-X------------X-----X---X-X----SX--XX------S-------X-------------X------T----X-X------X-----X---X-X---------X---XXXX----S-------X--------X----X--T---------------------X---------------------
XSX---X--X----------------------X----------------X-----------------------X-----------X-----------X-X-----XX------X----------X----------------------XX----X-X------------XXX------------------X-X------X-----X---X---X-
---------X---X-----------X---X-------X-X--X-------------------X-X-----------------X--------XX--X--------X------------X----S----X-------X-----X---------X-----------X-----X-X---X--X--XXX-X------------X------------F--
X--M-----X-S------XX------------------------XX--X---XXX---------------X------------S--------------SX------X-----X----------------X-----------------------XX-----------TT---------X-------------------X-----------X-#--
---X--XX--X-------X---X--X-----------------X----X--X-----X--X------X-----X-----------------------X----X--X------------------X------X----X---------------------X------XXX---------------X---X--X---#-------XX---X--XX--
----------------X--X---------X-XX--X----------X-------X----------------X---X------------X-------------------X--X------X-----X---X----X-X----------------X-X---X-XX-----------------------------X-XX--X----XX---XX----X
