----------------------------------------------------------------------------------------------------------------------------------------------------------------------------------------
---------------------------#-----------#-------------------------------------------#-#-------#--------#--------#---------------------------------------------#-------------------#------
-#-------------#------------------------Q--#--#-----------------------#-----------------------#--#--------------------------------------------------#--------------------------------#--
-------------------------#-------------------#------------------------------------------------#-----------------------------#-----------#------------------SC---------------------------
--------#-#----------------#------------------------------S---------------------#-----------#-#--#-----------------------------#----------------------------------------------#---------
------------#--------------------------------------#----#-------------#--------------S-#--------------#--------#-----S-----------------------#------------------------------------------
----------------------#-#---S------#-----------------------------------------------------------#-Q--#-----------------------------------------S----------#-----------------#----#-------
----------------------#----#-------------#-----#----------#--------------#-----------------------------#--------------------------------#-----------------------------------#--------o--
-----#---------------------#---------#------------------------------#---S-----#-------------#----#-----------------------------------------#-#---------------2----S---------------------
---#-------#-----------------#-------------------------------------------------#S-----------#---------#-------S-----------?Q----------#------#---------#------------------#-------------
-------------------------------------------------------------------------------#-------------#--------#--------#--#---------------#--------#-------------#-------------o-#-----------S--
------#----------------------------#------------------#-------------------------------o--------------#----------------------------------#-#-----#-----------------------##--------------
X----#--------------#-------------------------------------------------X------#S--------------------------S-------------------------------#------------------------------------------F---
X-#-M--------#------------------------#-------------------------------X------------------o---------#S--------------S----------------#----------#-------------------#----------------#---
X---X------------------#--------------#------------------#------------X-----#----------------------------------#--S------------------------X--------------------------------------------
XXX-X--------------------------------------X------------X-------------X---------------------X--------X-XX-----XX--X----X------XX-X---------X---------------------X--------------------X-
