------------------------------------------------------------------------------------------------------------------------------------------------------
-----------------------------%----------------%-%------%------------%-------------oo--------%-------S--------------------------%-%--%-%----------%----
---------------%%-------------%---------------------------%-----%-------o---%------%------------%-----------------------R-----------------------------
--------------------------------------------------r-----------%-----%--------------------------------------S------------------------------------%-----
----%------o-%%---------%---------o---------------%---------------%--------------------------------------------o----------------------o----------%----
------%%----------------------------g----------------o---------------%----%---------------------%%------------------%---------------------------------
----------------------%-------------%------%-------%----------%----%---------------------------------------%------------%--%----------------------%---
-%--------------%------------------%---------r-----|-----------o---------S--------------------------------%-----%-%-%----------------%----------------
-------------------%---o-------%-------------%-----%--------%-------o--------------------------------------------------------S------------------------
----------%---------------%-----------------------------------------------------%--S----%-----------%--------------------oo----------------%----------
-----------------------------------------------------------o-------o--%--------------%-------------------%--------------------------------------------
-%--------------------------%-o------------o-------------%-----%---------------------|-%------%-------------------------------------------------------
-------------------------------%-------------------------------------%---------------%------------%--%-----------%---%--------------------------%--F--
-M-%-------o------------------%--%---------------%-%---------------------------%----------------o------------o------------%------------------------#--
-X----------%-----%-----%---%-------%---------%--|-|--%------------------------------%-------%--%-%%-X----------%---%----------%--%-----%-%--o-----X--
-X----XX----|-----|--X--|---|-------|---------|--|-|--|-----------------------------------------|-|--X----------|---|---X------|--|-----|-|--------XX-
