----------------------------------------------------------------------------------------------------------------------------------------------------------------------------------------------------------
--#---------#-----X-XX----------------o---X-S-X-------------X--X--%-----X-----#--------X----X--g---X-----X-------------#-------X--S-----------X--------X-X----------X-------X-----X-----X---SX--------X---
------#-XX---g#-o------------------X-X----X---------S----------X-----X-------------------------------XX---------------X---%--#---X-------------Q-o---#-----g---g-%--X-X---o-----------X-------K-----K---%-
-----------X------------XX--X-------------------------------Q------S------------#----------%-----Q--------XX---X---X------------g---X-----------S--------X--X-------------S--X--X------%----SX-X------XX--
------------X---X--------------------------S-#-----X-X-X----------------------X----SX--S----------S#---------SX---------------S------------------------------#-----------X---------%----------X-----S-----
---#-------------------X----X-----#-------------X------------X--S--C-X------SX--------------X----S------X---X-X-----------------------#---X-X--X----g------------X----X-----#----------X-----X-------X----
--#------------------X---------------------------------X---------X------------X-----X-----------S--%-------------X-------------X-----------X-S------XS-%-----------X--X----------X-------------g--X-X-S---
-----#-----X--------------------------X-------------XX---------S--X-------X-X--X---------------------%-T-----X----------X--X------#----------X----X-X-----------X----X-------#-----------#-------------X--
----X--#----------------#-------X--S------X---X-------?-X-----X----C--------------S-X---#--------------X-------#------------X-------%---S------X------X-o--------X---------------------------X-----X------
-------------X-----------------X---------X----------X--#--------------#---------%---------X--------------o---------------------X------XX----S#-------S----------------XS--------------#-------------------
------X------X-XXXXS--------------X-----X---------U-X------------#-----------XX------X--X------------X-----S--S--X---X--X-o------%----------------------------X------X-------XXX-------------S#---S---X---
-----X-----------X---S--?----SX------------------X--------X-------X----X--------#-X-X--g---#--X---X---S--X------------------------X-------%-----X-----------------------T---------S---Q-------X-X--------X
--%------------X---------X------------------#--#S--X--X--X-----------g----------------X-g---XX---------XX--S----%-X------------X-------S--|---S---S----------%--S-------X---X-------#--#-----------X--F---
---M-------------%----X------X-----S-X---------X-------------------------X--S-----%----X--------------X-------#--X--------X-----------S---%---X---X-X----------------XX------XS----------------S------X---
---X-----%--XX----g----X--------#-------------X--------S-%---X-------------------K-X--XX-------X------X------------S---------#-----%---------S----------X----X---------------X--%----------X---S-----X---X
X--X-----|-X---------X----X-----------X-----------X------|-X---------------X--------X----XX---------X---------X----X-------X--------XX-----------------X-X------------------X---|-----X-------------------
