------------------------------------------------------------------------------------------------------------------------------------------------------
-----------------------------------------------------------%-----%----------%---------%---------------------------%------------------------------o----
------------------o----------------------S--%--------%----------------------------------------------S----------------------------------%-----%--------
----%---------------------------------------------------S------------------%--%-%----%----------------------------%--------%------%-o---------------%-
---------%-----------------------%------%--------------%---------%--------------|----------------------%----------|-----------%-----------%-----------
-%-------|---%----------------------------%-----------------%-------------------%-------------------------%-------|-----------------------------------
--oo-----%--------------------------------------------------------------------------------------------------------%------------------o-------------%%-
---------|---------------------o----------%----------o---------o----------------------------%--------------------------------------------S------------
---------%---------%----%--%--------------------------R---------%----------------------%-----%----%-------------%------------r-%-----o--%-%--%---%----
------------------%------------------------o-----------%-S----%----------%-----------------------------U------%--------------%-------%-S--------------
----------%------------------------%--o--------------------------------------------------------%-------------------------------------------S----------
--------%----S-------%--------------%------------%------o--------------o------------------------------------------------o------o---------------o------
------------------%%------o-------------------o------%--------------------------%----------------------%-------------------------------S-----------F--
-M---------------------------------------%----------%-------------%----------------------------------%----------------------g------------%--%-----##--
-X-%------%---%-%-%-------%-%---%--%----------------------%--------------%-%-S-----%-%--------------%------%---%-%-----%-%--%%---------%----|-----##--
-X-|------|---|-|-|------X--|------|----------------------------X------X-|-|-------|-|------------X-|--X-------|-|-----|-|---|--------------|----XXX--
