----------------------------------------------------------------------------------------------------------------------------------------------------------------------------------------------------------------------
----------------X-----------------X--------X----X---X-X--X--------XX--XXX-------X----------X-X--T-X-SX---X-----X-X--XXX------------------S----------X-X--S-----X-----X----X------------------X--------------------X---
X-XX--S-----X--------X-X-----------------XX-X-----X---------X------------X----T--X-X--X-X-------X------X--------S--S--XX------------------------------------XX---X------X----X-----X----------X---X---------X-------X-
---------X--X------------X-------X------X----X----X------X--------T---T------XX----------X--X-S--X-XXXX-X--X---X-------X------X-----------X---T-X------X------XX---------X----------------X--X-----------------X---X-X
--X--XXX--X---S-X----X----------X--X---------X-----X--------X-----XS--X----X--------X--X----X-----------X---X---------X-------------------X---X---------X-------S---------X-------S--X----X---------------------------
-S----X-----------------X----------------------X----------S----X--------------X----X------X--XX------------X--------X--X-X--X------------T---K-X-X----X------------X--X-X----------------X---X-X-X-----------t----S---
------X---SU-----------XX-------X---X-----T-X---------------------XX-X--------------X-----X----------------------X---------X---------XX--X----X-------X----S-X----X-----X----X-S-------X---X-----X-----------X-----XXX
---X---------XX--------------S---SX----X--X-X----X----X-------T----X-X-----X----X-X-------------------XS--S---------S---X--X---X-X--X--------------------XX--------XX--X----XX----X----------X------X--------X--------
--S-----------X---X---------X-----X--X----------------X-X-----X----------------X---X-X------X----X----------XX----------X------------X-X-S-X---X--------------XX-----------XXX----X--K-X------X----X----X---X-X------X
------XX----------X-------SX-----X----XS--X------------X-----------X---X-X-----X--------------S--X----------X--------X-X------------X------------X---------X----X------X--------X---X--------------XX------X---X------
-------------X--X------------X----X---X-X-----S----X---X---------U---X-X--------X----X-T-----X-----X------U------X-SS-X------X--X----------X--X-S-----------X---X-X-----#------X--------X-----X---------S--X-------X--
------XX------SX---X-----------------X-S----------X--X-X-----------S---XX---K--------X-X----------X-----X--------------X----X-------X--------X--------------------------X-T-----X--k-X-------------2--------X---------
-----X------X--X-----X--------X-X-----X-----------XX----------X--------X---X-------X----X--X---X------------T------------S--------------S--------X-X---X------------------X----X---SX--T---X--------------X--------F--
---M------X----X---------X--XXX---------------X-------T-------------X-----T---------------X--X-----X--------X-XS-X-XX------T---X------X-----X-X-----------XX----X--X-X---X----X--X-----X------X------X--X----------#--
-S-XXXS-X-----------S---X------X----X---X--k------X---X--------X----------XX-S--X----T------------------X------------------X----------X-----------S--------------X---------XS-------------X-------S--------X-X--X--X--
------------X------X---X-X-----------------X------X-----------------X-----X--------X-X------XX-----X--X---X------XX-------------X-------------X------X-------------X-------X----X----------X-----X-----X-X--------X---
