----------------------------------------------------------------------------------------------------------------------------------------------------------------------------------------
-------------------------------------------------------------------------#-------##------------------------------SC--#----------------S-#-------#------------#--#-----------#-----#-----
--------S---------------------------#------------#-------------------##------------#--------#-----------------------------------S--------------------o----------------------------------
-------------#--------------S----#--------------2------#------------S----------------------------------y--#-----------#------------------------#-------S--------------------------------
---------------------#-----------------------#----S----#--------------------------------------#---#--o-#--#---------------------------------------------#--#--------#-------------------
--------#---#----------------------#-----#-----------------------------------#----------#--------------------------SS----#------------#-#--#----------------------------------US------#-
--#-----------#---#S----------------#---------o---#-----S--#----------SC------------------------------#-------------------2--------o----#------------------------------------#----------
----#------#----------------------------#-------------------#------------------------------------------------------y-------------------------#---#-----------------o-----S---#----------
-----------------------#--#----------#----------#------------#-----o-----------------------------------------------#-----------#------------------#-----------------------#-------------
-----#----------#----------------------------------S------------------S--#-S-----------------#------------------------------------#------------#---------------------------#------------
---#------------#---#------------------------------------------------o-S---------------------------------------------S----------------------------------------------#------------#-#----
-----#----S--------------------#-----------------------------S----------------------------------##---o------------------------------------#-----------S---------------------------------
-----------------------------------------------#------#-------SC-------------------------------#-------o----------------------------------##--#----------------#-------#------------F---
----M-------------------#----------------------------#----------------------------#-------#--#-----S------------------S-------#----------------#------------------------------------#---
----X----------------------##--#-----X-----------------#------------------------#------------------------------------------------#-----#-------------#-----#--#-------------------------
-X--X-----------XX-------------X-----X------------X-------X------------------X--X---X------------------------X--X------X---------------X--X------------X--X----------X------------------
