---------------------------------------------------------------------------------------------------------------------------------------------------------------------
--------------------%--------------------o---%%--%-----%-----------S---S----S------------------------------o-----%---------------------------------------------------
----------------%-----------S-----------S-----|-----%--------------------------------o----------%--%-SS-----%-%-----S-o---------%---S----------------S------------S--
-------------------%--S-----------------------%---%-------------------------------------------------S---o-------------------------------------So--%----------%-------
------------o---------------------------o-------%-----------------------------------------------------------------So-----------%-------------------%---------------S-
-------%---%--------------------------------------------S-------------------------------------%-------------------------------%-%------------o-----------------------
---------S---------------------------------S--S------------------o--------------------------%-----o--------%---%--------S------------------------------------------%-
----%------------------------------%---S-S------------------------------------------------------%--------------|---------------------%-------------------------%--S--
----|----%---------%---------------------------%---S--%--------?------------%---S------------------------------%-%---------S-----------------------------------------
----%------------%---%%----%-%----------%-------------------------S--------------------%-------------o------------%---------------------------------%---------S--%---
-----%--%-----------------------%--%---S--------o--o-------------%----------------------------------------------------------------o---------------------%----------S-
-----------------%-------------------------------%--------------------------------------------------%-----------o----------------------------------------------%-----
---------%-%-------------------------------------------%----------%-----------%------------------------%---------------------------o---%-S---------------%------S--F-
-M----%-----S------------S------------o----%-------------%------------%------------------%---------%-----------------------------------------------%------%------%-X-
-X---------%--%-------%-----------%---%-%-----%%------S---%---------%%----------%----------------o------%---------%--%----%---------%--%-------o----%--o--------%--X-
-X----X----|--|-------|-----------|-----|------|----------|---------------------|----X--X---------------|------------|--------------|-----------X---|--------------X-
