---------------------------------------------------------------------------------------------------------------------------------------------------------------------
--------------o-------------%---%---------------------------------%-------------------------------------------------S---------%-------------o------------------------
------------%-S-----------------------S-%-------%----------------%---%%--------------%-------%---------------S--------S------------------------------%---------------
---o---------%--------S-------S----------------------S---------------------------------%-----------%-----------------------%------------------S--S-------------------
----------------------------S-----------------------------------------------o-S----------------------------------------------o---%-----------------------------------
--------------%--%---S---------%--S-S----%------S------------------%%-------------%--------------------o--o---------S------------------%--%-----------------%-----%%-
--%-----------|---------%----------------------o-------------------------------------o-----o-----------S--------%----------------------------%----%------------------
--------------%-o---------------------------S--------o---%---------------------------%----S---------------------|-----------------------%------S---------------------
------------o----%--------S---%------%---------------------------o---------------------------%---------%--------%---------------------------------------%-----%%-----
---------------%-------------------%---------S----o-----------------?----%--------%-%-------------------------%----------------------%-------------------------|-%---
-------------------------o-----------------------------S-%------------------S----------------------%------%---------%-------%--o----%----------S--%------------%-----
----------%------%------------------------------S--------|-----S-------------------------------%----------------%-------------------------------------%--------------
------%----o----%------------------------------%-----S---%------------%-------o---%-----%----------S---S---------o--------S----%---------o-------------------------F-
-M---------------%--------------------------%----------S-|--------S------------S------------%-------%---------------------------------%----------------------------X-
-X-----%--------------------------%-%--------%--%-------%%------------%--S-------%----%------------%|---o-------------%--%--%-%---------------%--------%--%--------X-
-X--------------------------------|-|-------------------|----------X--|----------|-----------X------|-----------------|--|--|-|------------------------|-----------X-
