----------------------------------------------------------------------------------------------------------------------------------------------------------------------------------------------------
--------#----------------------#-------S--------------##-------------------#------S--------------------------------Q-#------#--------#-------------------------------------------S-----------#------
-----#-------------------------------------S-----------------S---------------------S------------S--------#----------------------------#------#----------#---------------S---------------------------
----------#-------#-----------------------------------------------------S----------------------#--------------S-#---#----#---------------------------------S------------------------#------------S--
--------K------------------S------------------K------------------------------------------#-----------------------------#------------S-----------------------------------#-------------------#-------
----------#------------------------------------------------------------S-----#----------------------------#----------#----S--------------#-----------------------Q--------#-----------------------#-
-----------------#-----------------------##----------------------------------------------------------#---------#---S---#-----#--------------S--#------#----#------#-----------------#---------------
------------------S-------------------------------S------#-----#------------S------------------------------##----------#---#------------------------#----------------#--------------#-#------#------
---#----------------------------------------------------#---S------------------------------#----------------#--------S------------S-----------S------------------------------------S--#-##--------K-
----#-------S---S------S-#--------------------------------------#--------S--------------S-----------------------#--S-----------#---------#--------K-----------#--------------#------------#-#-------
--S-----------#----#-------S-----------------------------------------------#-------------#--#------S--S----K------------#---------------------------------------------------------#--------------SS-
-------------------#--------------------------------------------------------------------#------------------------S--K--------------------K---------------------S---------#---------------------S----
--------#------------------#----------------------------------------#-----------------------#-------------------------------------------------------------#-#------S---------Q---------#-S-------F--
-M-------------------------------------X------------#------------------#-------------------------------#--------------------------------------------------------#-----------#----?---------------#--
-X----------------------------#----K---X----------#--------------------------------#-----------X------------------------------------------#-------#--#-------------------------------#--------------
XX--X---------------X------------------X--------X-X----------------------------------------X-X-X----------------------------XX------------------------------------X--X-X----X---------------------X-
