----------------------------------------------------------------------------------------------------------------------------------------------------------------------------------------
--------------------------#-------------------#-----------------------#---#------------------------o----------------#---------------S--------#-------#------------Q--------o----#-------
-------#-------------------#--------------------------#--------------------------------------------------------------------------------------------------------#-------#------------#--X
--------------------------------#----------##------o-------------------------------------?Q------------#----------------------#----------------------#------------S--------------------X
------------------------------------------------S--------------S--#--------------------#-----#------------------------------------#-----#----------#-----------------------------------X
-------------#------------#--------------------#---------o-----------#-------------#--#-----------------------------------------#----------S-----------#--------------------#----------X
---------------S----------------#--------------------------------------------------------------------------------#---------------#-------------------------SC----------#---------------X
X------------#-------------------------#--------------------#----------------------#--------------------------o----US-----------------------#---#--------------------------------------X
X----#---------------------------------------------S--------------------------------#-----o---#----------------#-----------------------------------##--------#----------#------#-------X
X---------#------------------------#--------#--------------#----------------#----#----------------------------------S-#---S----#---S----------------------------------S----------------X
X------------2--#-------------------#---------------------------------------------------------------#-----------------------------------------------#----------#------------------#----X
X-----#--#---------------------------#---------------------------------------------------------------------------------#--------------#-----#-------------S----------------------o-----X
X---------o------------------------------#---------------------------------------------#----------#-------------#-#------------------#---------------------------#---------#--------F--X
X---M------#---------------------------------------------------------#--------------------X------S--------------#--------------------------------------------------#-----#------#---#--X
X---X-#--------------------S----------------------------------------#----------#--#--#----X----#--S-------#-o--------#-##-------------S-------------2----#-----------------------------X
X---XX-----------X------------X-X--X---X-------------X-----X-----XX---X------X------------X---------X---------X--X------------------X--X----XX-----------------X----------X------------X
