----------------------------------------------------------------------------------------------------------------------------------------------------------------------------------------------------------------------
---X------X--XS-----------X-T--X--XX----X----------X---X---XX------------X---XX-------2-X---------X---X-X-----XX--X------X----S---X------------------X--X-----------XX----X--X-----------------X--XXX-X------------X--
-T---X--------------X--X--X-X---X----X---------------------X------X-----------X-X------------X-----X--X-------X---------------------------XX--X-X--X-X----------------------X--X--XX-----X---X------X-XX------XX------
-X---X--S-X-------X----X-----------------X---------X--------------XXX--------X------X------S----------------------------#--------X---------------SXX-X----------------X---X-----XX-------------X--------S---X-X-------
------X-------------------------------------X--------------X---------X--------------------X------X----X--T--------X--X--X----X---X---X------------X---X---X------XX-----S-------------X--------X-S---------------X-X--
--X---X------------------X----S----------S---XX--------X-X-------X-----------S-XX--XX----X-X--------X----X------X-------X----X---X------X------------X-------------X---X---X---X------------------XX---S----X---------
X----X---X-X---X--X--------------SX--XX----X---XX-X------------------T-----------X--XX-----XX-X-X---------XX-------------------------X----------X---X--XX--X----X--X---------X--T----------XXX--SXX-XX---X---------X--
--XX----X-X------X-----X-------------------X-X-X---X--------X--U--X--X---------X------X--X--X------------X----X----X----X-------------------X---X-------------XX--------------X-X-X--X--X------X--X----------X--------
-------------X-X---------------------------------------X--X---------X---------X-X--S----------2------X----S----------------X------S-X-X-------X-----------X----X-X-----XX-----------X---------X----S------X----XX-X---
-XX------------------------------X-------K--------------------------X----X----------X--S-X------------X-S--X----X-----X------S-------------------X-----------------X-------------X------------X-X----X-----------X---X
------X---X----------XX-X-----------X--------------------X--------X---T------X---X---------X-X----------------------------------T---------X---X------------XX--------X--X-X-----------X--------T-------------------X--
-X-X----------X-----------------X--------------X--------XX---X-S------XX------------------X-------------X------X---X--S--XX-----XXX---------X--X---X---X----------------X--------X--X-X--------X----X-----------------
--------S----X--S------T-----X-----X---------X-X-----------------X---X---------------X-----U-X-X-S---X--------------T-------X---X-----X-----XX----------S---------X------S-X-------XX-------X---------T---XX-------F-X
---M--------X--X------SX----------XX-X-----------------------X----------------X---------------------SX---------X-X-XXX---------X--X------X--X-X---S---X-----X---T-X--------X----T--------S-X----------X-----S--X--T#T-
---XX----XX----------U----X-X---X--X--X-----X----X---------X------X----------X--X-------X-X-X---------X-------T----X--------------X-X----X-----t---------X----X-X-----XX-X--S--XX------XX--X--X--X---X------------XXX-
X--X---XX--------X----X--X-------------------------X---X-X----X---X-------X----------X--X----X----------------X-----------------X---------X----X---------X----XX-X--X-X---X--------------X-X-----------X--X---X-------
