-------------------------------------------------------------------------------------------------------------------------------------------------------------------------------------------
-----SS-S-----------SS-------------S-S-S--------------SS---------------------S--------SSSSS--S-----------S------S--SSS--SS-----S-----------S---S--S----S---S-S----------------S-------S---S
S--SS-S-----------------SS-S------------S----S----S-----S-----g------------------S-----------CSS-SSS?----S----S------------S-S--S-----S----S-----S----S---SS-----S--S----------------------
S--------S----SSS-------------------S-----S-------------SS---SS------------S---S-----S-S-S---S---S---S--------------S----------S--S---------S----S-CS------S-----S-------S-S-----------S---
S--SS--S----SSS---------o--S-------S-S---------SS--S---S--S-S-------S-----S--------S------S--S-S----S----------------------------S-------Q------------S--------S-------S---SS---S--S-S-SS--
----S-------S-----------S----SS--S----S--S------S-----S--S-----S--S----------S--Q--------S-----------------S-----------S--------S-S----S---S-------S-----S--------S-----SS--S----SS--S-S--S
-----------------S-----SSS-S-S-SSS------Q--S-SU--------S-S-SS-S--------SS----S-----S--------------------S------S---------SS--S--S----S------S---S-------------SS-----SSS----S---S--S-S--S-S
------S--S---------S--S-S---S---S---S-------------SS-S----S-----S---SS---S-------S----------S--------S--S-----S-SS----------S-S-S-------------S----SS--S---S---S-----------S--S-SSS-S--S---
-----------S-S--S-S----S---------S-----SS--S---S----------------S--S------2-S-S------S--S-------------------------SS---------S--S-----------S--------------S--S-S------------Q--SS---------
---S--------S-S--S-S-S----S--S-S-SSS-S-S---SS------S-----------S----S----S---------S---S-Q-------S--SS------------S-S----S---S-S-----SS----SSSS--SS----S-S-S-SS-------S--------SSS---------
--S------S---S-SSS--S--------------------CS---SSS--------------S--S-S---------SS----------------S------S-S----S---S----S--S--S--S-S-----------S--------S---S------------------------------F
-S-------S---S-------------SS-------------S--S---------S--S--S-----SSSS---------S--S---------S-S---S-------S-SS--S---SS-------------S------------S------S-S--S-SS-------S----------S--SS--S
-------S---------S-S-SS----S--------S---------S---SS-S----------SS------------------------------S--S-SS-------S-------S----SSS--S--S----SU-S-----S--SS---------------------SSS----------S--
--M-------------------------SS----------SS------------SS-----------Q--TS-S-S------S----CS-------S--S------------S------S--S-S---S-----S---S-S--S------SS---S-S--------------S------S-------
--X-------------S------S----S---------S------SS------------S----------X----SS------S--------SS-S--S----S-----------------S-------S--------S---S----SS-S--------S-S---S--------S--S---X----S
X-X------------------X--------------------------X------------------XX-X----X--------------------------X--X---------X--------X--------------------------X-------X--------------X------X-----
