------------------------------------------------------------------------------------------------------------------------------------------------------
-----U-----------------------------------------------------------------%----------------%------------------o------------%-----%------%%-------------o-
------------------%----%---------------------------------------------------------------------------------------------------------------o---------%----
-----------------------------------------------------o----------%-%----%---------------------------%%--------------------------------------%---S------
--------------------------------------------------%---------------------------%--------------%--------------------------------------%-----------------
----------------------------%-----------------o------------------------------o-------------------%---------------------------------%------------------
--------------------------------%--%-----------------------------------------%----%-----------------%-------o-%-------------------o----------S--------
----%---------------------------------------------------------------------------------S-------------------------%---------------------------%---------
-------------------------------%-----------------------------%-------%---------------------------------%-------%---------------%----------------------
-%-----------------------------------------------------S-------------------------------------%----------------------%-----o-o-------------------------
-----%----------------o----%----%--o-%-----------------------------%-%----S---S-------------------------------------------------%-----%-------------%-
-------------U-%--------------%--------------------------%-----------------------------%---%----------------------------------------%-----------------
----------------------%------------------------------------------------%-%-----------%------------%-------------------------------------------%----F--
-M-----------------------------o-o-------------------------------------|---------------------------------------------------------------------------#--
-X--------%-----------%-%-%-----%----%---------------%-%-----%---%-----%-----------%-%----%---------------%--------%----%----%--%%--%--------------X--
-X--------|-----------|---|-----|----|------------X----|-----|-------X--------X--X-|-|----|---X-----------|------X------|-----------|--------------X--
