------------------------------------------------------------------------------------------------------------------------------------------------------
--%-------------------------------------------------------------%---o--S-------------------------------------%---------------------------------------X
------------------------------------------------------------------------------------%---------o-----%------%%----%---%-----------------S--%------%%--X
-----------------------------------%-------------------%-------o------------------o------------------------|-%------%--------------------------------X
--------------%--------------------------------------------------------------------------------------------%-------------%---------------------------X
------------%-------%------------%--------%--%----------------------------------------%---------%-----%-------o----------------------------------%---X
---o--------|---------------------%------------------------o--R--------------------------------%--------------%-------%-------o----------------------X
------------|----%---------------------------S---------------%--%------------%-%----------o------------%-----------------%------%----------%%--------X
------------%-----------------------R-----------------------------o--------------%---------------o-------------------------------%-------------------X
----------------%-%-----------S-------------------------------%--------------------------------%%----------------------------%-----%--%--%---%-------X
------------------------o----%---%-----------------------oo----o------------------------%---------------%----%---------------------------------------X
---------%-o---------------------------------------------%----%---------------------------------%-------------%--%----%---------------------------%--X
-----------------------------------%----o----------%----------------------%---%%---------------o---%---%------------------U---%--%---%-------------F-X
-M-%--------%---------------o---------------------------------------------------------------------------------------%---------------------%--------#-X
-X----%----%-----------%-----------------o---%-------------%--%%-%---------%--%-----------------------%-%----------%----%%--------%------%---------X-X
-X----|----------------|----------------X-X--|-------------|-----------X---|--|----------------X------|--------------X-X-|--------|-X----|---------X-X
