----------------------------------------------------------------------------------------------------------------------------------------------------------------------------------------
------------#-----------------o-----o--------------------------------------#------------##---------------------S---#-------#---------#--------------------------------#-----#-#---------
----------o-----------o-----------o-------------------------------#-----------------#-----------S--------------------------#--------------#-------------------------------#-----S-------
--------S------------------#-------------------------------#------#--#------------------------------------#-----------------------------------------#------------------------#----------
X----#------------------#-S-#-----------------------------#-------------------#--------------------S---------------------------#--------------------------------------------------------
X--------------------------------------#-----------------------#-#--------------#-----------------------#---------------------------------------------#--------------#------------------
X---#-------------#---------------------------------------------#-----------------#--##------------------#-----S--------------------------Q-------#-------------#-----------------------
X----o-------------#---------#--------#---S-----------#----------------------------#--------#-----------------------------o-o--------------------S--------S-------------#---------------
X--#-------------S---------------#---#---#----------------------#------------#--------------------##-----#-#--------------------------------------#-----------------------------o-------
X----------#---------S-----------#-------------#---#--------------#-------------------------------#------------------------------------------------#-----------------------------------X
X----------------------o-----------#------------------------------------------------#---#-#---------------------------------------------------------#---S-------------#-------------#--X
X---------------------------#--------S-------#----------------------#---------------------------#----S-S------------------#----#----------#----US--------------------------------------X
X------#--#-----------------------------------------------------#------------------------------------------------------------------------------------------------##--Q---------#----F--X
X---M---------------------------------------S-------------------------------------S-------#-----------------y---------##--o----------------o----#---------#----#---------#----------#--X
X---X-------------------------------------#--o----#----------#----------------------------------------------#---##------S-------------------------------#----------#-------------------X
X-X-X-------X---------------------------X----------------X-------X---X---X--X--------------------------X-X-------X--XX---X--X-----X-X------------------X---X------------X--X------X---XX
