--------------------------------------------------------------------------------------------------------------------------------------------------------------------------------
-----------------S-------------------------#------------------------------------------------S-#--S------------------------S------------------------S--------S-------------------
----------------------------##--------------S--------------------------------------------S---------#----------K---------#------#------------Q--------------------S-#-------#----
-------K----------------------S------------------#--------##--------------------------------------------------------#--------------#-------------#----------S-------------------
----------------------------------#---------------------------------------------------------------------------------------------#-----------------------------------------------
-----------------------------------------------#-------#-#---------#------#----S----S----------------------------------#---#----------------------------------------------------
--#--------------------------S--------------------------------------------#-----#----------S------------------1-------------------#--------------Q------------------------------
-----#------#-----------#----------#--------------#----------S------#-------------------#---#-----------------------------------------------K----------------#------------------
-S---------------------------------------K-----------------#---#-----------------------#-S-----S----------------------#---------#----------------------------------------#------
------------------------#----------------------------------------S-------------------#--K------------------------------------------------------------S--------------------------
-----S----------------S-----#-------#--#----S-------------------------------#--------------------------------------#---------------------#-----------------#-------------#------
----------------S---#------#--------------------#--------------------------------#-----------------------------------------S---------------S----------------##------------------
----------------K------------------------------------------------K----SS------------------------------------------------------------------#---#-----------------------------F--X
-M----------------------------------#----------------------#------------------------------S---------------------#---------------#-----------------------------S-------------#--X
-X--------X----------------X----------S----X-------------K---#--------------------X--#--#----------------------#----Q------S------------------#-----#---#---#--S-#-------#-----X
-X--------X----------------X-X-X---------X-X------XX-X-------------X--------------X------X--X----------------------X-----------X----------X---X--------------X---X--------XX---X
