----------------------------------------------------------------------------------------------------------------------------------------------------------------------------------------------------------
---------X--XX----%--S---g#-----#-X-----%----X-----1-------------X--X-------------X------------X-----#-------------X-X------X------X-------------X------X------X---g---------X---o------X-----------------
-X------X--------S----#----g-X---o-------------------------#---------------------------o--X------X---X-----X-#-S----X----------------S--X-XXXX-S------X------S--------So----SX----------X-------SS-------S
S-----XX-S---------#-----S---------%--X--------#---------------%----------%-#--X--------#-----X----------X---X--K-#--------------------X-----X-----------o----X----X-----------------%---SX--S---------S-X
-------X-S--S----Q-----------------|-------#-X------------%--------X------|---------#-----------X--------XX--X-----------X-------------------X--------------------------Q-----X---X-X-----------------X--X
--SSX---X-----g----#-X-------X-S---%--S----X----X-----------------%-------%----X-----X-S----------X-------X-%--XX-------X---X-X------XX--------X------------X------%-X-X------X-------XX-X----X-----------
------S------SX-----------X----------X--S-------X-----X-----X--------X----|-----------------%--X---XXS-T-----S----X---X---#-------S---X------#-----S--g----U--#---X-----X-----X-#----X---------o-X-----XXX
----%--------------##---SX------------X----------g----X----S--!-----------%-------------------X--%--X--X-----------------X--------X-X-------X-X----S-----#------------------X----------X---S--------------
-------#-XS----------X-------X--------X----------X---X------g-----------------------------g----------#---------------X---------------------XX--X-X-----X--X-X-S--------X--X---S-----X---X----S--------X---
XX--------------X--XX-----X-X-X-------X-------------------X--X-----S--S--X-----------------------------------S---S-S--X--------X----X-----------------#---------------X--------------#------S-----------XS
---XS-------X-X------S----------------------g-S---------X--X-----------S---------XX-----XX-X------#------S--X---X-#-XX--------XX-----------X--K----------S-------X--X-XX-----X-------XX--S----------------
-o----#--X-#--------------#---S---X--T---------------------X-----------S-----o----------X-X--X-X-S----XS-X---S--------------------X---------X---------XX---#----X---------Q-#--X-------X-----------------S
--o---XSX-----#------------XS--------X-------XX-%---------#-------X-XSX---#-------------------#------------S----X-----g-X------%----X--X-XXS----X----X------------XX--------------S-----#-----------X-F---
-#-M--------X---X------------------------X-X-------k----------S----X-------------X-----X--#--X--S---S-------S-------------------X---X-X----X----------X----X---------S---------------S-----X------X---S---
---X--X-X----------------X--------------S-X--%---?-X---------X------X--------X-----S--------------S--%-------------X----%----S--X--------o-----------X--XX------------%-X----o------X----SXX---------X--%-
X------X--------------X--------------------X---------------X---------XX-----X---X--------X-X---X-----|---X--X-----------|---XX----------------------X-X----X-----------X------XXX----X--------------------
