-------------------------------------------------------------------------------------------------------------------------------------------------------------------------------------------
--SS----------SS--------SS--------S----S------S----SS-------SS--SS-------------S-----S------------S-------SSS---------S-S-----CS--S---------------------------S--S----------S-2-S-S--------
S---S----S-----S--------S--S--------SSS--------S-S----S----S----S----------------S--S----o--------S-----------S-SS---S----S--------------SS-S-------S-----SSS-S-S-------S----S--S--Q-----S-
-----S--------S----S---S-S-S-S----U--S--------S---S---SSS-------S----------SS-----S------S-----S------S------------S---------CS------------S--S------SS-------------------S-S--------S-----
--S-SS-------------S------S-SS---------S-----S-----------------SS--S-Q-----S--------------S----S------S---------S--------------S-------S---SS--S-----S-----S--S----S-S---S---S-S-----------
S--S--o-SS-S--S--S--------S---S---SS-------------------S--------------S----S-S---S---SS--------S-------------SS-----S------------------------S--S---------S----S--------SS---SS----S-S-----
------S------------S-S-----S----------S----------S---S---S------S---S---------S---S--S-S-S-----------SS---------S-------S--S----------------------Q-S--S--------------SS-------S-----------
S--------S---------SSS--S----SS-----U--------S-------S----------SS-----S------S--------S--S----S-S--SS----------SSS--S-----------S---S---S----------------------------------------S--SS---S
S---------S--------------------------------S-----------S-S-S------Q-----S-----S--------S-S-S------S---S-S---S---S-----SS-------------S--S-S-S-S-S-----S-----S---------------------S-----SS-
----S----S----------Q-S--------S---------SS-S-S----SS-----S------------SS--S--S-----------------------S---S--S-----SS---------S-------S-----S---S---S-S-------------S--------------SS------
--S-----SS---------S--SS--S------S--------S----------S---S------------------------------S--------S----S-SS--------S-S---S-S-S-----S---S-------S----------S---S-----------S-S---S--S-----S-F
-S---S-S---SS-S---S------------------S-S--------S------SS---S----S------------S----S------S-------S-----SS--------------------SS---S-------S------------S----S----S--S---S---------S----S-S
--------S---S--S------------------S------S------S---S----------------S-------S----SS-----SSS-----Q-S---SS---------S----SS--------S---------------S-S-S-----------S----------------------S-S
S-M-----S------S-------S-----------------S-------------------------S-------S--S----S------S--------------S----S----------S-------------S--S--------S-------SS----------Q--------SS-SS------
--X---S----S--S-------S--S-SS---X-S-S--S-----------------------S--S-----S---S-----------S--S-S-S----------------S--S---------S---------X--------------S-S------------S--S------S------S-S--
--X------------------X----------X---X-----X---------X----------X--------------------------XX----------------------------X--X--X-X--X---X------X---------X-X---------X---X--X---X-----------
