----------------------------------------------------------------------------------------------------------------------------------------------------------------------------------------------------
--S-----#---------#-----------------------------------------##---------------------------------------------------------------------#------------------------------------Q------------------#--------
-----------#---------------------------#-----------------------S------------#-------------------------K--S-----------#---------------#-----------------S---------#-----------------#----------------
----S------------S-----------#-----#-------------------------------------S----------#--Q----#------------------#---------------#---------------S------------------------------------------#---------
-----#---------------K----------#-----------------------#-----------------#--------------#---#---------------------------------------#---------------------------------------S--------#-------------
----------#--------#------------##--------------------------S--------------##-------S--------------------------------------------------#----------Q---##--------------------------------------------
----S------------------------------#--------------------S-------------#---------SS-------#--------------------------K------------------#----------------------------------------#-------------------
-----------#----------------------S-#-----------------------K----------------#--------------------------------------------------------------------------------------#------------#-#-------#--------
--#-----------#-----------------------------------------#--#------------------##-----------#--------S---------------------------------#-----#-------#----------------#-------------------#--#-------
---S----#----------S-----------#---S----------------------K-#---------------------------------#--#--------------------------#-----------------#--------------------#----#--------#---------K--------
--------------------------#---------------------###------K------------#----------#-----#--------------------------------------------------------------------------------------------------#---------
----------#----------#-------------------------#----------------------------------------------------#--------------------------K--S------------------------------------------------------S--#-------
---X-----#----------------------S-------------------------#-K-----------------#---------------------------------------------?-#---------------#----#----#----------------------------------------F--
-M-X-S-------------------S-----------------#---------------------------#---------------------------#--------------#---------------------#----------------#---------#---S----S--------S--S------#-#--
-X-X----#---------#------------------------------#--------------#-----------S-S--------------------------------------------------------#--#-------#-------------------X-X---------------------------
-X-X-X-----X-----X--X------------------------XX-----------------------X------X---------------------------X------------------------------X-----------------------------X-X------X-X------------------
