----------------------------------------------------------------------------------------------------------------------------------------------------------------------------------------------------
-----------------#-------------------#---#--------------#----------------#---------------#-----------#--------------------------------------#------------------------#----#-------------S-----------
--------------------S---------------S-------------------------------------------#-#---#------------------------------------------------#----------------S------------------------#-#-----#----------
-#------------------------------------------------------S--------------------------------------S-------------------#-----------------------------------------------------------------------#--------
-------------------------------------------------------------------#--#------S--------------------------#------------------------------------#--------------------------#--------------#------------
--#-------K--------------------------#-------S------------------#----------------------------------#-------#----------------------------------------------------------------------------------------
-------------#-#------------------------S---------#----#-------#----------------------S------#--S---------------------##---------------------------------K-------#-------------------------S------S-
-----------------------------------S-----------------#-------------##--------#----------------------------#----------------------#-----------------------S----------#-------------------------------
---S---------------------------------------------#-----#---------------------#-------------S-------#--------------#-------------------------------Q----------------##--------#----------------#-----
------------------------S----------------------------S-------------------#-----------------------------------------------------#-----------------#-------------------------------#------------------
--------#------------------------#--------------------#-------S------S--#--S-----#--------------#--------------------------S-----------#-#----------------------S-----#--------------------#--------
----------#--------------#-------------------------K----------------#----------------------------------------------S------------------##---------------------#--------------------------------------
------------------S----#----------------------------------------Q---#---------------------------------------S-------------------------------#----#---S----#------------------------?-------------F--
-M----------------------------------------#-------------SCS----------------------------------------------Q--------------------#--------##-----------S----------------S---------------------------#--
-X-------#------------------K----#-#------#----------------------------#--------S----#---------S--------X------#--------------#------------------------------------------------------#----------X---
-X----------------------------X----X------------X--------X------X--------------------------------XX--X--X-------X--XX------------X-X--X--X----X-X-----XX--------------X---------X---XXX--X-XX---X---
