---------------------------------------------------------------------------------------------------------------------------------------------------------------------
-----%-------%-----------%----------S------------%--------S--------------%-----------SS------------%-%------------------------%---%-----------%--------%-------%-S---
----------o-----%--%--------S------------S---------------%---------%--%---S---------------%----%---|--------------S-----------|--------------------%--------%--------
---------------%--------------------------------o----%-%--------------|------------------%---------%--------------------------%---------------------%----------%-----
---------%%----|-o--------------------------------%-%---------------%-%---%----------------------------------------------------------o------------------------%-%-o--
---------------%--------------------------o-%------S-%--------------------------------------------%-%---------------S----------S------%---------%--------------------
-------%-----------------------------o-------o---------------------------------------%------S---------%-S---------%------------------------%--------o----------------
-----------S------------S-----------------------S--%----------%--------------------------S--------%----------------%--------%--------------------S-------------o-----
--------------------------%--%----------------S-------S-%------%---------------------------%----%%---------------%-------%----o--S--%-------------------S-%----------
-----------------------S-----------%--------------%-------------------------So--So--------------------%-------------------------------%------------------%-----%---S-
----------------------S---%----------------------------%-----------------------S---S----------------S---------%--------------------%---------------------------------
----------------o----------------------------S---------------%-------------------S---------------------------------------------------o--------%-------S-S-%-%%-------
-------%%------------------------------------------------o--------------------------S--------------------%--------------------%--o------%---S--o-------------------F-
-M-------S------------%----------------%------%--------------------%-------S-----------------------o----------%------------S-----%---------------------------------X-
-X-----------%--%---------%%%----%%------------%-----------%------------------S--%------------%------------%--------S-%---------%--S-----------o------------%----%-X-
-X-----------|--|----------------||--------X---------------|----------------------------------|------------|------------X---X-------------------------------|----|-X-
