--------------------------------------------------------------------------------------------------------------------------------------------------------------------------------
--------------------------------------#-------K--------------Q-----------------#---------------#-----------------#----------#---------------S----S--#--------#--------------#---
--------------------#--------------------------------------------------------#-----#-------S----------------------------------------------------------------------#-------------
-------------------#-------#-S--------------S----------K---------------------#-S------------------------#----------#--------------------------------S---------------------------
-----------------#---#----------------------------------------------------------------S-------------------------#---------#-------------------#------Q--------#-----------------
-#----------------------------#------------------#--------------------------------#------------#--------------------#---------S----#--#----#------------#-----------------------
-#--------------------#--------------------#-----------------##--------------------------S---------------------------------------------------------S----------------------------
-------------------------S-----------------------------------------------------------------#--------------U---------------------------------------------------------------------
----------S------------------#----------------------#------------------------#----S---------------#----------S--------------------#-----#--#------K--------------S--------------
-------------S---------#-------------------#-------Q-----------#-------#------------K---U------------#----------------------#------------------#---------------------K---S---#--
-----------------#--------------#------------------------#----------------------------------------------------------------------------------------------------------------------
------------#---------K----#----#-----------------Q-----------S------------------------------------------------------------#---#-------K------Q---------------------------------
-------------------------------------------------------------------#----------------------------#-------#-----------------#---#---------------------------------------------F---
-M-----S----------------------------S--------------##---------------#-#-#----------------K-----------------S---------------------------#-------------------------#----------#---
-X----------------------------------------#---#----#--#---------------X---------------------------------------------------S---S--------------------#---------U------1-----------
-X-----------X--------X--X---------X------------X--X--X-X-----------X-X-X----------X---X-X--XX-------X----------------------------XX-XX--X--X---------X----X---X----------------
