-------------------------------------------------------------------------------------------------------------------------------------------------------------------------------------------
-S-----S----------------S-S-SS--S---SS----S-SSS-------------S--------------S---SS---S-------SS---S--S-SS------S-S---S-----------S------S---S-S--------S----------------SS-------S---------S
--SS-----SSS------S-------S-----SS------S-S----S------S---S-------------------S-----S-S-----S-----S-----S----------S-----------S-S------------S---------S--------S--S-----------S-S--SS----
SS-------------S--S------S----S--S--S-----------S--------Q---S-SS------S---S-------S-----S--S-----S-----S----S---------------------SS---S-----------S---------S--------S----S----S--S-S----
-SS--------S--------S-----S-----S-S-S-SS--S---S-S--S-------S-S---------------S----S-S-----------SS---------SS-S--------S-----S-------S----------S-S-----------S--S-----------S--S---S------
---------S--S-------S---SSS---S-SS---S--S-------------S-S----------S------S------S---S--------S-----------o---SSS---S--S--S-----------SS-------------------SS------------S-----S-S---------
---------------------------S---S--------S---S-------S-------S-----S-------S-S----S---S--S------------Q---SS---S------S-----S-------S-----------SS-----S---SSS--SS--S-SS----------S-S--S----
-----SS-S-----------S---------------------Q----S-------S----S-S-------------S-----S----S-S-2--------S---S--------S--------S-S-SS--S-------S-------------S------S---SS---SS--S----------S---
----------S------------S--S-----S----------------SS-S--------S----------S--S----S-S----S-------------S-S-S--S-------------------S---------------SS-S----S-g-----S--SS--S-----------S--S----
-----SS--S-SS-S-------------S--S-S--S---------------S------S---S---S--SS-S-----------S---S-S--------S-----S--SS-------------------S----------------S-----SS-S------------------------------
---S--S-S-S--------S----S-----S---S-SSS--------S-----S-S-------S----S----------SS--Q---------S----S------S---S----S-------S-S------S--S--------------S----------S-----------S--S--S--SS---F
--------------S-------S---S-S-----S-S------S--oS---S----S----------SS--S--------S----S-----S---S------S--S--S---------------S----------------S----------S-----S-S-S----S---------S-SCSS---S
---S-SS---------S-S---S----------S--S----S----S------S---------S-S-------------S--S-------SS-----Q-S-----------S------S---S-S--S-------S----Q------------------oS-S-----S-------S-S--------
--M--S-------------S----S-----S---S------------------S---S-S----S----S---------S----------S--------------SS---------SS--------------S--S---S------SS---S-------SS--------S---------o-----S-
-XX-----S----------X--------S-S-S-------S---S---------S--SS--S--------S---S----X--Q-S-S-------S---S----S-------S-----SSSS--------S---S---S-X-------------S-S-----S----S--S---------S--S--S-
-XX----------------X-----------X-------------------------X---------------------X--------------X---------------X--------X-------------------X----X--------------X-X--X----------------------
