------------------------------------------------------------------------------------------------------------------------------------------------------
-----------------------------------------------------------------------------%-----------------------------%---------------------------------%--------
-----------------------%-------------------------%------------------------%-------------R-------------------------------------------------------------
------------------------------------------------------------------------%-----------------------------------------------------------S----------%-%-%--
--------------------%---------------%------------------------------------%---------%---------------------------------%--------------------------------
---------------------%------------%-|-------------------%%-----------------%--------o-----------------------%------%------------------%---------------
--------------------------------%---%---%--%-------------|---------------------------------------------%%------%------------o----%-----------o--------
--------g------------------------------------------------%----------------------------------%------------------------------S-------%------------------
--------%----------%--------------------------o------------S-----%---------------o------------------------------------------------------%-----------%-
-----%---------------%--------%--S------------------o-----%--------%--------------------%--%-----o-----------%---------------------------------%%-----
--------%----------o---------%----------------------------------------%-------------------------------------------------------------------------------
----%-------------------------%-----------%------------%------------------------------o--------%--------S----o------------------------o---R-----------
-------------------------------------------------o--------------------------------------%-------------------%-------------%-----%------------------F--
-M-------%-----------------------%--%-%----------------------------------R----S-------o-----------------o-------------------%----------------------#--
-X-----%--%------------%----%----|-------%-%---%-----------%------------%-----------%---S--------------------S----------o--%-------------------%---#--
-X----------------X----|----|----|---------|---|------------------X-----------------------------------------------X----X---|-----------X-----------X--
