---------------------------------------------------------------------------------------------------------------------------------------------------------------------
----------S-------%---S-------%-------%-----%%------------%--------------o---%--------------S-----%--S------------------o----------------------------------%---o-----
-----------------------%----SS-----------------------%----------------------%----------------------------%-----S----------------S-----%---------S----%---------------
------%-------------------S------%-----------------%---------------%--o-----------%----------------------------------------%-------------------S---S-----------------
---------------------------------|-%---%----------------------%---------------%---------%----------------------S-%----%--%--S------------------------------%-S-------
------------------------------%--%--%--------o--------------------%------%-------------%----------------%--------------------------------------%----------%----------
----S--%------------------------S-----------------------------------------%--------------------------------------------o---------%-%---------S-----o-----------------
-----------------------------------------------------o-------------%------------o---------------%%---------%%--------------------------------------------------------
---------------------------------------------------%-------S--%--%----S-------------%-----%-------------------------------------------------%------------------------
-----------------%-%----------%------S----------------%---S----------S---------------------------%------%------------------------------%---o-----%-------------S-----
---%-------%-----------------%---%-S--------S-----------------------o-----%--------%-%---------------%--------------------------------%---------------------o------%-
------o-S--|----------------------------%----------o------------------%%------%----|--------------------S----------------o-------------%-------o---------------------
-----------%%-------%-------------------|%-----------------%----------------------%%-%--------%---%--------S---------%--------------------------------o------------F-
-M----------------------%---------------%-------------o-------------------------------------o------------o------------S--------------------------------------------X-
-X---------%--------------%-o---S---%--------------S--%----%-------%-----%---------------%%%-%----------------o----%---------%----%-------%---%--%-----%-%---------X-
-X---------|------------------------|-----------------|----|-------|-----|---------------|||-|---------------------|---------|----|-------|------------|-|---------X-
