----------------------------------------------------------------------------------------------------------------------------------------------------------------------------------------------------------------------
-----X-------X-------------------X-----X-----X----X---X--------------X--X-X--------X--------------------X-------X-X--X--X--------XX---------------X-X--X-X----------------------------X---X----------X--------------X-
X-----------X-----X--------------------------X----------T---------T-------X--X------XX--X------------XX--XXS-------X--X-----------------------S---------X--------X-------X--S---X--X--X------------X---X--X---X-XX----
----------------XX-------------X-----------------------SX-------X-X----------X----X-X----------S---X-------------XX----------------XX----X-----X--------------------X--S---T---X----X-----XXX---XX--XX---X------X--X--
XX------------T---X-----X----X-----T--T-------t---X------XX------------------XS-X------------------X----X------X--------X-------X-----------------U-------X----------------X--X----------X-X--------------X-----------
--X-T-----X---X---------X---X---X--XX-X-------X-----------XX---X-XX--------------X-------------------X----X---T-X------X-X---------------X----X------------X---X---------X------T---------X----X--------------SX-----X
---XX-----------------------X--X-------------X---X---X-------X-----X---------------------X------------X-----X-X-----------T------XX---------------------X---------XX------X--S--X------------------------------X---X-X
--XX------X--X--------X-------------------S-----X--------XX---XX-X--S------X----X----X----X-----------X-----X-------------X--X----------------------S--X--X-X------X----------X--XX-------X--------------X----------X-
-X-------------------------X---X------------X-----XXXX------X-X---X-----------X--T--------------------------------------------------------XX----------X-----X-SX------X-----X--X--------------------X-----X-----------
--------------X-X-X----------------X----X--------X---X-----------------------X---X--XX---X-----------#----X-------XS-------X----k-----X-----X-----XX-------XX---------X-X-X-------------------X-X--------X--X---------
-S-----X----T---------------------X--X-X-----------X--X---XX--------S-------X---S-X-X---X------------X----X------X---X-XX-------X-X-----X----XS---------XX----------------XX-X-S-----X-------X-X----XX----#--X--------
----X-------X-------X-------X--------------------X--------X--XXS--X-----X---X------------XX------X-T----X-----X----------------------X-----------X--------X--X-----X--X---X------XXX--X-X----X------------X--X--------
----------X-------------X----X-X-X--------------X----T-----K---------------X-X---------------X---XXX-------------------X-X-X--------U--------S---------------X-X------------X--------------X--XX--------X----------F--
---M----------------------S-------X----X-X-----------X------------------X----X------------------X-----S-------X-------------X-X------T---X-X---X------------------------------X-------X------X-X------X-----XX-XX--#--
---XX------------U-----------X--S---X------XX--X--------X--------X------------------X------XX---XX-X--------------XS----------X----X-X--X-------X-------X----------X--XXXX----XX-------------------S-----X---------X-X
X-X--------X---X----X--XX----X-X--X-------X-----------------------X------------------------X---------X-X-X--X---------X--XX---X-------------X------X----------------X---X-X-X----XX-XX---X-X--X----------X-----------X
