---------------------------------------------------------------------------------------------------------------------------------------------------------------------
-----------S-----------------------------------------S-------------------S-%------------%----S---------------------------------------------o-------------------o-----
--------------------------o---------------------S------S-----%----------------------%--S---------------%%-----%-----------------SS------------%----------------------
-----------------%-----------S---------------%---%-------------------%---------------------o---------------------------------------S---S--------------------------%--
----------------%----------S---------S-----%---------------------------------------%------%-----------------------S----S--%-------------------%------%---------------
----------------------------%-------%---------------------------%---%-S-----------o----%-----------------------%-----------------------------------------------------
--%-------------%--------o-------%%-------------------------%------------------%-----------%---------S---------------%-----%----------------------%------S-----------
------------------------------------------------%----------%-------%--------------------o-S---------------------------------------------S----------------------%-----
--S---------------------------------%------%-----o-----------------------------------------------%------------------o--------------------%-----------------%---------
----------o------%---------o-o-------------------------------------S------------o--------------------S--------------------------o-------%---------------%-----S------
-------S----------------%-------------------------------------------S----------S-----------------%-------------------o------------------------------------------%----
-----%--------------%------o------------------------%------------------------%---------%--------------------------------%------------%----------------------S--------
----%----%-----o-------------%----%--%---------------------------------------------------------%-----------------------------o------------------------S------------F-
-M-----------------------------S--------------------------------------S---------------------%----------%-----------------------------------------------------------X-
-X---------o-------%%---------------------------------------------%------o----------%-----------%-------------------------------------------%-----------%----------X-
-X------------------------------X-------------------------------------------------------------------------------------------------XX-------------------------------X-
