----------------------------------------------------------------------------------------------------------------------------------------------------------------------------------------------------------------------
---------X---------X---X------------T------------------------X--S---X--S-----X--X--------------------------X----S------------------XX-K--X-X----X--------XX-X-X------------X----X-------------------X-X--X-----------X
-------X-X-------S-------XX-------X-X------X------X--------X-X------------X-----X----------------------------------X---X---S---------------------XX--------X--X---X------X-------2-X-------XX--------X-------X--------
------S--X----------------X-------XXX------------------X--------------X--X--------X-X---X-------------X---2---------#-----X--------X-------S-X-X-----XX-------X--X----T-SXXXX------X------XXX---------X-----X-X----X-X
-----------XXX--X------XS---X--------------X--------------X--X-X--------#-------XX------------X-X-X-----------------#---#-----X------X---S--------XX---X-----X--------X---X-----X---------X--------------------------X
--------X-X---X--X--XX---------X--X-----X---X---X---------------X-------X----------X-X-S--X---XX--------XX-------S--XS--X----------X-----------------X-----X-X-X-----X------------X--------------------X-X----X---X---
---------X--X--------------------------------------S--X-----X-----X--------------X----X----------S-----X----------X------------X----SX---X---X---XS-------X-X--------X----XX------------X------T-----------------X----
-X--------S----S----X---------X--S------X-XX-----X----------------X------X-------X-----------------------------t----X----XX----X--X-------X----X---------#----XX-X---X---XXX---------------X---X-X--------------------
--------X-----X-S--X----------X-X----S--X--XX--------X----X-K--T---X----------X-----X-S----------X-------------X-----------------------------X--X--------X---X---------T-----X-X--------------------XX----------------
----X-------------------------------------SX-------------------X----X----X---------------X------XX--------------X--------U-S---------X-------------X------------X-X----X-S--------------XX--X------X------X--X--------
-S-X-------------XX------X-----X--XX------------XS----------XX---X----------------------X--X--XX--X---------------X-----X--------X-----X-X------XX--X--S----X--X-----------X--S---XX------X----X--X-X---X--------X----
---------X-X------------------------------S----X----X----X--------------X---X--X----X------X------X------S--------X------SSX--------------------------T---------S----X--------------X----------X----------------------
-----------X------X---S-X----------X------------SXX-X-----X---------XX---X---X-------X-------------X--XX------X-----X--------------X--X-T-----2---X---X----X-----------X---------X--X---X------X--X----------#--X--F--
---M-X-X-----X----------X--------X----------X-X------X----XX--SX--------X--X----S-X---------XS-------------------XX---X------X-----X----X----X--------X-X-----------------X----X------X------S---------------X-----#--
---X-----X--K---X----X-X-XX----XX--X----S--SX-------X------X--------X----X--X--------------------------X-X------X----X--------------------XX------X-------------XX-------------------X---T----S----XX------------X-X--
-------X--------X-X--------------------------------------X--X-------X--X-X-------XX-X---X--X-X---------------------X--------X--------X--X------------------X-X----------X------X--X------XXX-----X--X--X--XX--X--X-X--
