---------------------------------------------------------------------------------------------------------------------------------------------------------------------
------------------------------------------o-----%------%-------------------------------------%-------------------------------%---------S---------------------------o-
-----------------------------%---------------------------------------S----------------------------------------------------------------%-S-----S------------S---------
-------S---%-----------------------------------%-%--------%------S------------------o-------------S-------------------------------o----------------------------------
--------------------------------------%%----------%---o-------------%-----%-----%-%----------%-------------------------------%------------------%-----------S--------
-------------------------------S---------------------------------%----------%--------%---------------%-----------So---------o------------------------%---------------
-------------------%-----------------------S--S------------------------S---%-%--------------------------------o----------------o-----------o-------------------------
--------------------%-------------------S---------%---------o-%-------------------------%--------%---------S-----------------------------------------S---S-----------
---------------%---------------%---------------%----%-----S-----------o--------------------%-----------------S-------%-----------------------------------------------
--------------------%%-----------%-------------------------------------------%---%--------%----------------%-------------------------S-------%--%----S---------------
------------------%----%-----------------------%----------%-----%-%-----------------------------------------%--------%---%-------------------------------%---------o-
--------S-o--%------------------------S-%-o-----%----------------------------------------%%-------------%-%--------------------------?------%---S-o----%-------------
--%----%----------------------------------------------------------------o-------------S------%--------%-----------------%---S------%-------------------------------F-
-M------%-----------------%-S----S----------------------------%-----------------o-------------%--------%%--%-----------------%-o---------------o------------o------X-
-X-------o--%-----------o---------------%--------------------------------%--------------------------------------------------%------%-------------------------------X-
-X---------------------------X-------------------------------X-----------------------------------------------------------------------------------------------------X-
