----------------------------------------------------------------------------------------------------------------------------------------------------------------------------------------------------------
----------------X------------------------X--X------#--X--o-X----X-X-%-----XX----------S-----------X---XX---#--------#---X-X-----X------X-So--X-X------------XX---%--S--------------X--X----X----X-----S-X-
--------------------------#-----X----X-------X------------S-X----------#-X-----------------------%-------S-----X---------------S---X-X----------S--X-------------------------X----X--------------k---X----
-----o--------S---------X-----------------XX-----X-#----X-----XX--S---XX-XX--------XX-X--K--------X-X--S---X-X-X---------------X-%----------X--------S-----------------S---#------------#-----S--X-----S--
--#-----%----X----X----------XX--X--S--------S--%-----g---%-S---------------------X------X------X-------#----X--X------X----------X-----X--X----------------X---------X----#--------------S-----------X---
--------------X-------------X---------------X-----XX--------S------------XS------X------------o----o--S--------------g--X----------X------X--X-X---%---U----------X-o-X---X-S--#----%----X--Q----------#--
-S---XX---#--X----------#------X---X----XXX-----#---X-------------------------X---------X---#--------------XS---------#---X-------#--------X--X-----------------X----------X-------X----------XX---X-%----
-X-----------------X-----X----------X--X-----------C--%-----S------X--------X--#------X-X-----X--X-----%-----S------X---X------------U------------XX--X----X-------------XX-XX-------XX-t--------------X--
X---X-----------S-X-----------X-------X--#-----------#-X------X-----X------------X---XX--#---X-------X-|--X-----S-X----S--X---------------o--X-X-------X--------------XX----X---S----X--X-----------X-----
-X----------S----X-X--X-X---------#---X----------------X-----X-----X---R------X---X---------S----S-----|----------------------X-----X-X--#---XX-XX-----X--X------S---#------------XX-X--X---------X-------
-----------------------X----#----X------X----------------#--X------X--X-------XX-X----------X----------|%-X--------X----------------X--X----------XX-----------!------------XX-------------X---------X----
-----X--------#-------X-------X---XX-----------------k---X-----#--------X---------S-------#------------%----X--X--X----S-------X-----#S--------#------#-------------X----X-----X-----------------#------X-
-------X------------------------#SXXS-----X----------S-X----------------------X--------#------X----#--------X-X---------S----Q--o---------X-----------#---X---X--------X----------------------------X-F--X
---M-------XX--------%---S------X------X--X----#------------X--#--y---------------X----------S-X--X--#-X-------#-X----------S-X-------------------X--X-----X-X----X--------%---X-------------------#--X---
XS-X-------------X--o--X------X--X------X--X------------X---------X---#------#-----X--------X------X----#--S-------------X------#------X-------XX-X--X--------o----------X-|o-S-----X-------X-----%----X--
----X--X---------------------X-----------X--------X-------X------X-------------------------X-----X--------X------------------X--------X-------------------------X--X-------|----------------------|-X---X-
