----------------------------------------------------------------------------------------------------------------------------------------------------------------------------------------
---------#-----------o--------------#------------------------------------------------2-----------#----------S------------------------------#----------#---------------S-#---------#-----
--------------------#-------------------#----S----------------#---------------------------------------------------#-------#--#------#--------##------------------------#-S--------------
------#---------------------#------------#------------------------#S-----#--S----------#-------------#--------------------------------##-------------------------------------#----#-----
---------------------------------#----------------------------------------------------------------------#------------------------------------S--------------#--#------------------------
------------------------------##----------#--------#----#--#--#--------#----------XS----------#------------------S--#-----------------Q-----#-------------------------------------------
-----------#1-----------#-------------#-S-------------#---#-------------#---------X-----#------------------------------------------##-------------------#----------------#---------S----
--------------------#----------------------#--------------#-----------#-----------X---------S----------------------#--------------#----------#--------------#-------------------------#-
--------------------#-------------------------------##1-----------2-----#---------X----------------------------------------------------#---S--#------------S----------------------------
-----------------------------------------------------------------#-------#--------X------#------------##-----------#---------#--------------S-------------------------------------------
-------#----------------------#--------------------------S----------------------#-X---------#-#----S-------##------------------------#--#--#-#--------#---------------------------------
-----#--------#--------------------------Q---------S-------S----------------------X-------------------##-------------#-----------------------------2-------o----S---------#-----#-------
--------y-----------------#-#-----------------------------------------------------X------------------S---------#---o--------#--------------------#----------S------------------#----F---
----M---#-------------------------------------------------#-------#---------------X-------------S-------------#-S----------##------------#---------#------------y------#------------#---
----X-----------------#----#-------S-----#-----------------------------S----------X---------#------#----S---------------------------------------------------#---#--------X--#-----------
----X-XX-------X-----X----X--X--X----X----------X--X----------------X-------------X------------X--------------------X-------------------XX----------------X--------------X--------X--X-X
