------------------------------------------------------------------------------------------------------------------------------------------------------
-------o-------------------------o--------------S-------------------------------%-----o---------------------------o------%---------------------%------
----o-------%----------------------%-------%----------------o--------------%-------------------------------------------------%----%-------------------
------------------%------------------------------o---------o------%---%--------%------------------%---S--%%----------------%--S-----------------------
---------S---%------------------------------------%----------------%------------S---------------------------------------%-----------------------------
-----------------------------------------------------------------------------------------o--o------------------------------------------------------S--
------o-------------%-----S-o------------------------------------------------------------------------%-%--------------------%-----------------------%-
----------------%--------------------------------------------------%--R---------------------------------------------------%%----------------o---------
----------------|-----o--------%---------------------%-----------------%-%-S-------------%---------S---------------------------------%--------------o-
----------------%--------------------------------%---------------------------------------------o---------------------------%---%------------%---------
---------------------------------------o----------o-----%---------%-----------------------R----------------------S------------------------------------
-----S----------%-------------%%---------------------------------------------------------%--%----------%--------%------------------------------%------
------------------%-----------|--------------------------------------------------%---%-------------%--%-----------%--------%-----o------%-----%----F--
--M-%-------------------%%----%----------o------------------------o-----------------%--S----------------------------------------------------%------#--
--X-----%---o-%----%---------------------------%--------------------------%----%-%-------%%------o-%----------%%-----%--------%----%-------------%-#--
--X-----------|----|---------------------------|--------X-----------------|----|-|-------||-------------------|------|----X---|----|-------------|-X--
