---------------------------------------------------------------------------------------------------------------------------------------------------------------------
------------------%-------------------S-------------------------------------------------S---------------------%---------------o----S------------------S--------------
-------%--%----------------%------S--o---%-------------%-------------%---%---------------------o------------------------------------------------------------S---S-%--
------%--S------------%--------%-----------------------------------S---%---o-----%--------------%---%----------------------------------------------------------%--|--
-?------------%----%---------------%--%---o--------------------%--%--%----S-----------o-----------------%---------------------------------%--------%-S------------%--
-----------------S------%-%------------------------------S----------------------%----------------------------%---------%--------S---S--------------------o---------%-
----------------------o--------------------------------------%%-----o-----------|-------------------------------------------------S---------------%------------------
--------o------------------------------------%-%--------------------------------%-----------------------%------%----%--------------------------------------%---------
-------%--------o---------%--------%-----------------%---------------------S-%-------o-------%-----%---------%--------%--------%--------S--o-----------------%-------
----------------------------------------o------SS--S--o------------------------------------------S-------------%-----------------------o----------%-----------%------
---S-%------------%------------S----------S-------------------%----------------------------S--%------------S----------%-------S--------------o-----------------------
-------------------------------------------------------------S------S--------------------S----------------------S-----------------------S-----%----o-%---------------
--S---o-----%---o---%-----o------%%-------------o--%-----------------%--%-----------------------------------------------S-------------------------S------%---------F-
-M----S--S---%---------------------o---------------------%-----------|---------S---%----------------------------------o--------------------------------------------X-
-X--%--o--%------X--%----%------------------%-S-%-----------%%----%%-|--%%------%----------%%--%-%------%%----%--%---------%%%-----%----------%------o------%------X-
-X--|-----|------X--|----|------------X------------------------------|--|------------------||----|------|------------------|-------|------------------------|------X-
