------------------------------------------------------------------------------------------------------------------------------------------------------
-------------------------------------------------------------------------------------------------------------------------o--%-------------------------
----------%-------------------------------%-----------%------------------------o-------o-----------S--------------------------------------------------
-----------------------o---%--------------------------------------o-------------------------------------------------------U-o------------------%--%---
------------%---o---R------------------------------------------------%%--------%----------g---------------------------%%-------------%%-------S-%-----
--------------%--------%------%--------%--------------------------------------------------%----------S---------------------------------%--------|-----
-------------------------------%-----------------%--%-r-----%-------o-----------------------%---------------------------------------------------%-----
------------------------------------------------------%--------U---------o----------%---------------------------------S----------------------------o--
---------------------------------------------------------------------------------------o-%------------------------%%---------o---%--------%-----------
-----------%--%-----r---------------%-------%---------%------------------------%-----------------------o----------------------------------------------
---------------%----%--------%-------------------------------------------o-------o---------------%------------------------%--------%------------------
---%------------------------------------o-%----------%-----------------------------%-----------%--o------------------------------%-----------%--------
---------------------------------%--------------------o---%-----%-%--------------------------------------------------S-----------------------------F--
-M------------------%-----------%-----------%-----------------------------------------%---------g-----%-------------------------------------%---%--#--
-X--%-%-----------%------%-------%----%--%-------S-------%----%%-----------------------%----%-%-%--%----%-----%--------%------%-----%-%-%-----%--%-#--
-X--|-|------------------|-------|----|--|-X-----------------------------X--------XX---|------|-|--|----|-----|--------|------|-----|-|-|----------X--
