------------------------------------------------------------------------------------------------------------------------------------------------------
---------o-----%-------------------------------%----------------------------------------%---------%------------o-------------------%------------------
-----------------S----------------------%---------------------%-----o-------------------------------%-------------------------------------------------
-------%-%------o--%-------------------------S------------------%-------o-----%-%--------R-----------%-----%-----o-------------------%-----%----------
---S--------------------------------------------------------------%--------------%------%------%----o-----------------%------------------------%------
-------------------------------------S-----------------S--------------------------------------%-------------------------------------%-----------------
------------------------------------------------------------------%---------------------------------%------------r-%--------------------%%-S----------
--------------o--------------------%----------------------------------%------------------------------------------%------%--------%%-------S-----------
------------------------%%--------------------------------%------o-----%-----------------------------------------|--%--------------------%-----o------
---------%-----------------%-----%-------------------%--%--------------------------------------------------------%-----------%-------------------S----
------------------------------------------------o-----%----%-----------------------------%-----%----o-----------------------------%-------------------
-----------------%-------------------------o---------S----%-%----------%-------------------------o---------------%--%---o-----------------------------
-------------%-------------%----------------------%----------------------------%----------S--------------------%-|---------------------------------F--
-M---------------%-------%---%-------------o------------------------U--%-------------%------------------%--------%-----%---%----%------------------#--
-X------%-----------------------%--%--S------%---------%----%----%----------------------S----%-----------%-%-------%------------------%-%%----%--%-#--
-X---X--|--X------------------X-|------------|---------|---------|-----------------------XX--|--X---X------|-------|--X---------------|-||-------|-X--
