----------------------------------------------------------------------------------------------------------------------------------------------------------------------------------------------------------
-------TS-------%-X-----------o-------------X------X--------X---------------o---X---X----X-@-----X----K-----g---X------X--------------X-X-X---X--------%-o---------XX-----S------XSX--X----------------S--
----%--X--X------------------S--#------X-X--X----------X---%-------Q-------#-X---X---X-o-------X-----X-----------X------------------------X----X------X-----------S----S----XX--------X-----X--------X----
--SS-----S--SX--------X----X---------X----X------------------%---X-------C-X--X-------X--X-#-X---XX-X-g---X----------X---#------------------X-----X-XS-------------X---------X-S---------X----------X----X
S--X--S----#-----X--X-----------S-----SX-X--------%-X------X-----------S----#-------X------X------------------X-------X--XX-----------------------------o---X-----------X----X---X-XX--XX----X-----X----S-
----S-----X---X--X------%-------X---X-X-X--%---------X--SX-X-------XS-X----X-------------------------X----?--T----#---------------X--------X---X---------------S-----X--X--S----S----XX-----S-X----X--X---
-----------------X-----%|--X-------X---------%-----#---X--X------------X---------------X--------%--XX--------X--------------X-----X-----SX------------------------%---XS---------X-X-----SX------S--------
--X----------X----X-----%----X-------------X----------XX---------------------S--T----SX------------X-----X------------XS-X----X--------#-----X----------S------------------------X---X---------------X-Q--
--X------X-#----------o---------X--XX-#--------SX----XX-----%-----------X------XX------X----o---------#----------------X-------------------XS-X-X----------------S----X--S---------------------XXS------X-
---X---------XX------X-X--X----------S--------------%----SX-------X-------X--XX-------X-------X--X----X-X---S--------------------X--------------------------X--X---------------X---X---------X----X-X-----
------------X-------------------------S-X-----X-------X------X---------------------------S-#----X-------------------------------X----------------------X-----Q-------------X---X-------g---%----S----%----
---X-#--------#---Q---X-------------XSX--------------------X----------------------#--S--------S----------X-----------------------------X-S----X---X---o-------X-XX--X----g---------X-X-----------X------S-
------##-X-X-------X--X---------t--%-----X-X------X------------X-%------#-SX-XX----X--SX---X----------X--X-X----------X---------S-----X--X-----------------o-----------------------XX-X---XX-X--X-----F---
X--M---------X------S-----X-----XS------SX---XS---X--S-----X-X-----------------XS---#-------g---#--C---X-X-X----X---X--X---X----------------#------g------------X-X-----------------------------------X---
---X-S---------------#-----#---%--X-----------X---------K---S-#---------X-S---o---%------S-X---%--XS-X-X----------X---X------S--%-----X----------X------X----X------XXX-X-----TS----S--%----------X-------
------X----X------------------------X------X--X--------------X-X------X-----------|-------X----|---XX-X----X----X---------------|-X-------------X------------X---X-X----------XX----X--|--X----------XX---
