------------------------------------------------------------------------------------------------------------------------------------------------------
----------------------------------------o-%-%------%----------------------------%---------------o-----------------------------------------------------
---------%----%------o-S---------------------------------o------------------%%------------------------%---------------------------------------------o-
----------%--------------------------------------------------------------------%----------%----------------------o------------------------------%%-o--
------------------------------------------------------------%%---------------------------------------------------%------------------------------------
---------o-----------------------%---%------------------%-------%-%------%---%------------------------------------------------------------------------
------%--------------------------------%-------%-----------------------------------S--------------%---------------------%--%----------%---------%-----
----------------------------------o-----------%------S---------o----%----------------%--%----------------------------------------%--------------------
-----------%----------%-------------------o--%-%------------o-------------%---%--o---------------------R----------------------------------------------
--------------------%-|-------S-----------------------------------------%---------------------------%---------------o---%-%-%------------------------X
------------------%---%-------------S----o-R-------------%%-----%-------------------------------------------U--------o-------------------------------X
------------------------------------------------------------------------%------------------------%----%%-----%---------------------------------------X
--------%-------------%-%---------------%------------------------------------------------S---------------------------%----S---------%%-------------F-X
-M-----------------------------------------------------------------------%----%----------------o----------------------------------------%--------o-#-X
-X------R--%%-----------------%------%-%----%-----R-----%-----%---o---%-----------%-------%------%---%------%-%----%--%----------------------------X-X
-X---X-----------------------X------X--|----------------|-----|-------|----X------|-------|----------|--------|-------|--------X------X------------X-X
