----------------------------------------------------------------------------------------------------------------------------------------------------------------------------------------
------------o-------------------------------------S---------#---------------------Q---#-#-------------2-----------#---o-----#--Q--------#----#-------------#---------#------------------
------o---------------#SS-------------------------------------------------------------#-------#--------------------------#----------------------#---------------------------------------
----------o---#---------------------S---------------------#--------------------#--#--------##--------#------------------------------#------------------------#-#-----------#--------#---
-------------#---------------------------------##---------------------------#-------------##-#1-#------------------------#-----#--#-------------------------------#---------------------
---------------------#-#------#---#--------------------------#-------S--#-----------------------#----------------------------#-------------------------------#--------------------------
---------#--------#-------------o--S--#-----------------#----------------------------------2-#------------------------------#--#-----------------------------------#--------------------
---------------------------------------o----US------------------------------------------------------------------#----------------------------------------------------#S-------#---------
------S-#----##----------------------------------#---------------------#----#------------------------------##---------------#-#-----------------------#------y----------------#---------
----------------------#--#-----------------#------#---------#----------------------------------#-------------------------------------------S------#----------#--------------------------
-----------------Q-y-------#----------##---#---------------#--------------------------o-------------------------------------------S------------------#----##--------------S-------#-----
-------------#-----#--------------#----------S-------------------------------------------#-----#--------------------#--------#---------------------#---------------2--------------------
-------------------------S-----------#----------------------------#----------------------#--------------S-SC-------------------------#-----#--------S----------------------------S--F--X
----M------------------------------S-------------------#------------------------------------#---#-----#------#-----#-------------------------------------o---#-----#-#--------------#--X
---XX----------------#------------------------------------------------------S-------#----------------o-#-----------#------X--------------------------------#---------------------------X
-X-XX--------------X-X-X-----X-----------X----X----X-----------X------------------------------------X---X------X---------XX----X--------X--X----------------X----X----X---X------------X
