------------------------------------------------------------------------------------------------------------------------------------------------------
-------%------------------------%-------------------------------------------------------------------------o--------------------------------%----------
-------|--%---------%------%--------------------%-------%--------%------------------------------%--o--------------------------------------------%-----
-------%----o---------%--------------%-----------------------------------------------------------------------------------------------------------%----
----------%----%------------------------------------------------------%--o---%-----------------S------------o------o---------------o--------%---------
-----%----------------------%----------------------------------------------------------o----------------------%-o--------------------o-----------%----
--------------------------------------------------%--------%-----o-%-----------------------%---S---------------------------------------------------%--
--------------%-------%--------------%----------------R---------------S-------%-------------------%--%------%-----%-%-------------------------%--%----
-------%-------------------------------%-o--------------------%-----------------------------------------S---------------%-----------------%-%--o---%--
--U---o-R-------------%----S--------------------------R--------------------------------------------------------------%----o------------------%--------
---------------------------------------------o---------------------------------o--S------------%-%---%-----------------------oo---%----------------%--
--------------------------------------------------S---%--------------------------------%-------------------------%---%----------------------%---%-----
------o------------------------------------------------%---------------U-------S--------------S-------------%-----o-------o------------------------F--
-M---------o-----------------------------%------------------------------%----o---------%-----o--%---------o----o--------------r------------o-------#--
-X----------%---%------------------%----------------%------%-%--o-------|---%--------------%----|----%----%-----%-----------%-%-----%--------------X--
-X-----X----|---|------------------|----XX---X-X----|------|-|----X-----|------------------|----|---------|---------------X---|-----|--------------X--
