------------------------------------------------------------------------------------------------------------------------------------------------------
------------%------------S---------------------%---%--%--------------%---------%------------------------------------%-S--o----------------------------
--------------------------------S-------S-------------------S----------%---------------------------S------%-------%--------------------------------%%-
----------S----------%--------------%-%----%------%%------%-----------------------------%-----%------%---------------%-----------------------%-o-S----
---------------------------%--%---S--%-----------%-----------------------------------------------------%-o----------------------------------------%---
-----------------------------------%--------%------------------%----------------%----------------%--S-------------o-----------------------------%-----
---S------%%--%-----%---%------U----------------%-----------------------------------%---%%---------------g--------------------------------o-----------
----------------R-----o-----%----%-------o------------------------------------------------%-%--%-------S-%-------o-----------------------------S------
-o------------------------%--------o-----%---------------------------%----------------------------------------------------R--%-------%----------------
------------------------------%-------S----------------------------------------R----------------------%-----------%-----------------------------------
--------------------%------------------%---------------------------o-----------------------%-------------%-------------------%------------------------
---------------------------------------------------------------------o-o--------%--------------------------------------%------------------------------
-------------------------------------%%-----------------%------------%--------------o----%--------------%-----%----------------%-%---%----------%--F--
-M-----%------%-------------------%-----------------------------S--------------------------------------------------%--o-----------------%----------#--
-X---%----%------%-%------------------%------S---%----------------------------------%------%-----------%--o-%-%-------%----%--%----%---------------X--
-X---|-----------|----X----X---X---X-X----X-----------------------------------------|------|-----------|------|-------|----|--|----|---------------X--
