-------------------------------------------------------------------------------------------------------------------------------------------------------------------------------------------
-----S-------S--SS--------------S----S----S--SSS-----S---------S-S------S------S-S--S--SS-S---S--S----S------S----S-------S-------S--------S-S--S------S---------------S-S-S----S-----SS--S
--------------------S-S---S-------------S---------S-------S-S------S--------------S------SS-------------S--------------S-S------SS-S--S----S---------S-----SSS-----------------S----SS--S-S
-S----S---SS-S-S------------S---------SS-----S-S-S-S-----S--S-S-S--S--------S----------------S----SS-S------S----S-------S----------------------S----------S-S-S------S--S-----------------
---S---S--S--S--------SS----------SSS-S-------S--------S---S----------------SS--S-SS----------SS------S-S-----S----------------S-S-S----S--S-------S---------S---------------------S---S---
-S---S----SS-----------S-----S--------------SS--------------S-----S-----SS---------S-----S--S---SS--SSS---------S--S-S-S---------S--2-------S-----Q----S------------S-----SS--------SS-S---
-SS------------CS----------S---S--S--SS-S---S-S----S---S-------S-S-SS-------S-SS-S-----2------S-----S---S------S----------S------SS----S-S--S----S---S-------S---S----------S-------S-----S
---S----S---S-------S-------------------SS---S------SS-SS----------S--------S------S--S---U-----------g--------S-----SS-----S-S-----S-----------S-SS--------------------SS---SSS---------S-
--------S--S--S-S--S---S---------S-S-------S-------SS---S-S---S---S-S----SS-----SS-------S------------S---S---------CSS-SS--S------S----------------S--S------SS-----S----S--------S-------
SS---------------S----S--S------S-S--S--S-S---SS---------------------S-----SSSS--SS-SS---S---S--S-------S--S-------SSS-S--S----S-----------S-----S------S--------------------------S-S-----
S--Q--S-S--S----S----------S---------SS--S----S--S----S-----S--S-S---------S------S------S---S---------SS-------------S------S-SS---S----S-----------S-S------S---------S-----------------F
-S--------2---S-----------S----SS-----------S---S-------------S----S-SS--------S--S----S--S---------S--------------S-----S--------------S-S-------------------------------------S-S---S--SS
---------S----------S--S-----S---S--SS-S--------------S-------------S-------S---S-S----------------S--S----SS-S---SS---S-------SS--S-----S-----SS----S------S---S----Q-----------2-S---S---
--M-S---------S-SS---------U--------------------------S----S-------------------S---------S--------SS---------------X------------------------S-S---------S-S-----------S--------S---S---S-S-
--X-SS-----------S--X----------S---S-S--------S-------------S-----SS---S----SS-S---SS--------S-----S-S--2----------X-t----S-----S----S--X------------S--S---S-------------S----S--S--------
--X------------X-X--X----X----X-X-X--X----------XX------------------X-X----------X-X--X-X----X---X-----------X-----XXX----------XX-X----X-------------X---------XXX-----------X------------
