-------------------------------------------------------------------------------------------------------------------------------------------------------------------------------------------
---S----S-S--S--S--------S----------SS----S--SS-------SSS--S-S-----S----S--S---------S---------------S-----------S-S-S----S-S----S-S----------S-S-----------S--S-----------S--S-S--SS-S----
S-S-SS----S---S-------------------------S--S-S--S-------S-S----------S---------S-S-S-S--------S--S----------------------S---S---S-S----S----------S-------S----S-S-S--o--------S----S--SS-S
--S------------S-------Q--------------S------SSSSS--S--------------S---------------------S----------o--S----SS---------S-----SS---S---S---------S---S------S--SS-----SS--S-S---S-S----S----
S-----------S----S--------S---S-----------SS--------------S-------S-S--S---SS-----S---S-------------S------S----------S----S----S-------------------S---------S---S-------S--S-S-S---------
-SS---------------S--------SS------------S--------------S-----------S-------------SS---SS------S---o----S-S------S------------S--------S---------S------SS-----------------S--S------------
----S-------S--SS---S------S--S-S---------S-------S---S--S--S----S------------S------------------S-S---S--------------------S-SS------S--S--S-----S-----S--S----S---S----------CS-S------S-
-------S-S-------S-----------S-S-----------S-----S------SS--------S-----S-------S--------------------SS--------S----S-------S--S------------S---------S------S-S-------------g-----S--S-S--
---------SS--S-SS-------S-S---S----------------S--S-----SSS--S-S------SS---S-S----S-S--SSS-S---S--SS------S--S---------S-----S---U----S-----S------------S------S---------S--S----SS-------
-------------------SSS--------S-S------S--------------------S-------------SS---S-----------------------S-2--U-S----------S-----------------S----------S-----S----S-------------------------
-----S---------------------S---S-----------SS--S------------------S------S-------------SS-S---S--------------S--------S-S----S--S-------S----S------S--S-SS--------S-S-S---------S-S----S-F
-SS----S-----S---S--S----2--------S-----------------S--S--------S--------S----------S---S--S--------o------S------S--------S----------S---S---S-S-S--S------S---SS-S------------S---------S
-S-------------S-----S-----------S--S-----S--SS---SS--------------S--S-------SSS----S-S-----------SSS------SSS------SSS----SS--CT-----S-SS------S------S---SS--S-S-------SS----S------S----
--M-S-----------------S----------------------------S---S-------S-S-------2-oS--S------------------S---S--SS--S-----------SS--S--X----------------------------S-------S-----S---SS---S--SS--
--X-S---S-S-S-S-SS-SS----------------------S---S-----SS-S------------------S------S--S------S-S----S--------------S--------S----X--S----S-------------SS------S--S----S---------S-SS-S---S-
--X-----------------X-------------------------------XX-------X-X--------X---------------X---------X------------------------X----X--X----------X-X----------------------------X-------------
