------------------------------------------------------------------------------------------------------------------------------------------------------
------------o------------------o-------------------------------------------%--------o--%------------------------------------%-----S----------%--------
---------------------------%-------%-----------------------o-----------S------------------%------------------------------%---%---------------------%--
------o-----o-------------%-------%----o--o---------------%-------S--------------------------------%%--------------------------------------%%---------
---o------o-----------------R-o-S----------%----------------o--------------------------------%---%---------------------%--------------o------------%--
---%------------------%%-----------------%------%---------%-------%----------%---%----%-----------------------%---o-----%--%-%-----------S-----%------
----------------------------------------------------%%---------o------------------------------------R--------------------------------------S----------
-------%----------------R---------%--------------%--------------------------S---------S----------------------------------------------R----o-----------
--------------------o---------%---------------------------------%---------%-------S-----%%----------------------------------%--------------------S----
-------%----------%--------------------%-----%--%-------o------------%---------------------------------------------------------%-o--------------------
----------S----%--------------%--%-------------------------------------%------------S------%------------%---%----------------------------%------------
-------------U----S---------------------%---%-%----%-%---S---%---%-------------------o---------%----------------S---------%-%-------------------------
------o----------------------------------------------|--o--------------o--------------------%-------%------------------%---------------%-----------F--
--M-S-----------%-------------------------%----------|----%--S------------------------------------------------%------%---------------------%-------#--
--X--%-----------------%---%---%---%-----%-%---------%------%--------------%--o-------%%--%---------%----%-%--|--------%----%--%%%---------------%-X--
--X--|----X---------X--|---|---|---|-----|-|---------|------|-----------------------X--|--|--------------|-|--|--------|--XX--X-|----X-----------|-X--
