-------------------------------------------------------------------------------------------------------------------------------------------------------------------------------------------
----------S---S-SS-------S-----------S-------------SS---------------------S---S----S-------S--------SS-S-------SS-----------S---S--------S---S-S------------------------S-----------S--S--S
---S-----------------------------SS---S--------S-----------------S--------S--------S--------S------SS-o------S-------------S--------------------S---S--S--SSS-------------------S-------S--
-SS---SS-----S-S--------S-----------S--S---S----------------SS------------SS----------SS-----SSS------S-----S----------S------SS------S----------------S--S----------------S--S-S----------
-S-----S-----------S--S--S----S------------S--S-------SS---S---------------S-------------S---S-------S--S---S---S----Q----S--S---S------------S--S---------------S---S------------S---S--SS
-------------S-S--S----S----------S--SS--S---S-S----o-S----S-------S-S-------SS-----------S----------S-S-----S--------Q--------------Q----------S---S-----S--------S--S---S-S-S----------S-
-----S---S-S--SS----S-S----S--------------S---------S-S---------------S---S-SSS------S------------S-----S---------S-S----S---Q------S-------------SS------S----S--S---S----S--------S------
-S-----S---------S--S---------S-------S-----S-S-------S--S--S---S----------S--S-------S------------S----S---S--S-----------S--S----------------SSS-SSS-----S---SS---S--S---------S-S---Q---
-S----S------S---------------S--S-SS--S-S-S------------------------------SS-------SS-----------TSS-----S-S-------------SS-----SS----S--S--S-------------SS----S--------------------SS------
----------S----S-S------S-------SS--S-------S----------SS--S----SS---------S-S-S----S---2----S-T---SS-----S---SS------S--SSS--------S-S----------S-2-o---SSS---U--------------S------------
------S--------S--------------S-----SS------------S-S-S-S-S----CS----SS---S------S--SS---S-S---X-------SS--S----------S-------------S-S-----S----SS-SS----X-------------S----------SS-----F
-S-S--S---SS------SS-----S-S------------S--U--Q--S--S---------2---------S-S--------S-S---S-S-S-X---S--S-S-----S----S---------S-----------S--SS-----S------X-S---------------------------SSS
S------------------------S------SS----------SS----S----S-----S--------SSS---S------------------X-S-S---------SSS-----------o------------------------------X-S----------------S--o--S---S--S
--M------SS-------SSS----------------S---------S--S-S?-S-------Q---------S--S--------SU-S---S--X------S--S--S------SS--S---S-------------------SS-S-------X---S--------S--------S--------S-
--X-----S----------S-----SS----------SSSSS--------------S-------S-S--Q-S---S-Q-------S---------X--S-S------S--------------S----S------------S-S-S-S--SS---X-S----S-----------S-X-S-T-------
--X-X---X-----XX-----X-------------X-X--X--------X------------X-----X---XX---------------X-----X-X---------------------------------XX-----------------X-XXX--X----------X---X-XX---X-XX----
