---------------------------------------------------------------------------------------------------------------------------------------------------------------------
----S------S---------------------S--S--------------------------%------o--------------S-------------------------------------------------------------------------------
-------------------------%---------%---%---o---%-----------%------------------%--------------------------o-----------------------------------------------------------
---------%----S---%-------------S-----------%-----%------------------%%--S------S-------------------%--%---------o-------------------------------S------%------------
-------o-----o-------------S----------------|%------------------------------------------------%-----------------%------%-------------------%-------------------------
------S--%-%---------%--------------S-------%--%%--------------------o-%------%---%--------------S----%---------|---------------%-----------%------------------------
--%-------------------%--------%-----------------------------------------------------------S----------------%---%------S-----------------------S---------------------
--|---------------------S-----------------------%-----------%-------------------------------o---%--------------------S-----------------%-%-------------------S-------
--%--------------------o--------------------%-------%-------------------S---------%----S--------|---%-o----------?---------%-----------------%-------------------%---
-----------------------------------------------------------------------------------%------------%------S----------%----------------%--S--%---------------------------
-----%------------------------------------------------------%----------------------------%------------%-------------------%------------------------------------------
------%------------------------------%--------%%----------------------o-----------------%-----------S--------------------------------?--%----o----------------%%-----
--%---------------------S-----o----------------------------%---------------------------S------------------%---S-------%---------------------o----------------------F-
-M---------%-------%--------------------------------%----------------%---------%-----------------%-------%-----------------------------------------S---------------X-
-X----------%-%----------------%%------------------------%%--%----%-----%--%---|--%--%-------%---|------------------------------------------------------------%----X-
-X----------|-|------------X---||------------------------||-------|-----|--|---|-----|-------|---|-----------------------------------X-----------------------------X-
