------------------------------------------------------------------------------------------------------------------------------------------------------
-----------------------------------------------------%------------%-------------------o--------------------------------------%---%--%--S--------------
--------------o---------------%--------%---------%----------%---------%----------------------------%-----------------%----------------------%---------
----------%------------------------------%--------o--o------------------o------------------------------------------%------------%---------------------
-------%-------o---------o----------U------------------%---------------------------------%---------------%---%---------------%------------------------
-S------o----------------------------%--%---------------------%-%-----------------------------------o-------%------------------------%---------%--o---
-----------------------S-----%--------------o-%---------%----%----------------------------%---------------------------------R-------------------------
----------------------------------------------------------%----------o----o------------------------------------%--------------------------------------
----------------%--%-------------------o-------------%-------------%--------------------------o----------------------------%--------------------------
-----------o--------------------------%-%%--------%%------------------%--------------------------------S------------------------------------%------o--
--------------------o-----------------------%------------------------------------------------------------------%--------------------------------------
--------------------------------%---%------------------------------------------------%---------------%----------------------o-------------%-----------
-------------------%----%--------------%------------%--------------------------------------%----------%------------------------o-------------------F--
-M------------------o--------------------%-----------------------%--------------------------o-------S--------------------------------------%-------#--
-X-----%--------%--%---%----------%--%--%--o-%-----%-----%------%----%%----------------------%--------%---%---------%--------o-%-------------------X--
-X-----|------X--------|----------|--|--|----|-----|--X--------------|--X--------------------|--------|---|---------|----------|-------------------X--
