--------------------------------------------------------------------------------------------------------------------------------------------------------------
-----------S-----o--------------------SS----SS----------S-------S--S-S--------------S-S-----------SSS---------------SS---------SS-----S-------------------S---
------------------------S---------S-------------o------S-------S--S--------S---S---------------S------SS--------------SS--S----SSS---S-S-------------o----S-S-
-------S-----S-----------S---------------S-----S-----S---S------------S----S----------S---S--S--@Q-------S-----------o--------S-----------S-SS----o-----@Q----
---S-S-S----S-----------S--S---------------S-S-------S------------------------S-S----SS-----SSS----SS-------SS--------S---------------------SSS--S-S----------
----S-S------S-----------S-------S----------S-------------------S---S--------------S-----S--S-S---S----SS--o-------S---S-S---------S----------------S------S--
-----SS-----------------S--SS----S-----------------S---S-------S---S----------S---------------SS--S-S--S---------SS---S-SS---S-------U-------------C----------
---------o---------S-S-SS------S-----SS-----------------------o----------S----SS-S-----S---------------S----S----------S----SS------S--------S-------S--------
--------------------o-S-----S-----------S-------S------------------S--S-S-S--------S--S------S---S-----------------S------------S-S---------------------------
SS--------S------------S------------S---------------SSS------------S--------@Q--------S----S------S-----------S---------S---------------S-----------SS--------
---S------S-------------------------S--S------S---S----------S-------S---S----------SS----SS-S------------------S----S--S----S------------S-----------S-------
------------S----S-------------S-----------S--S-----S---------------------S----S--S-----oS-----------------------------------S------S--U--S-------------------
------------S---S-----SSS-------S--------------------S--S-----S------------S--------------S-S---S------S----------------------S---------S--S-----------o------
S--M-------S----S--S------------------S-----S-S--S-S---------------------S-S----S-------S--------S---------S---------------------------S-------S---S-----S--F-
-S-X-S-C---S-S-X-----o---o---X-----S------SS----------------------S-SS--------S--------X--------S--------U----S---------------SS---S-------S----------------X-
X--X-----X-----X-------------X-X----------XX-----X-----X-------------X---------------X-X------------------------X--------------X-----X-X----XX---X-------X--X-
