-----------------------------------------------------------------------------------------------------------------------------------------------------
----------%%---%------------------------------------------------------S---------%--------%-----------------S-%---S-%----%----------------------------
------------o--|-----------------------------------------%----------%----------------------%------------%---%--%--------------------------------%----
--%-----S------%--------------%-------%--------%-----%-%-------%-----------------%-----------------------------------------------------------------S-
-----%--------------------------------------o-------o-----%-%----%-----------------------------------------------------------------------------------
--S-------------%---S-------------------------------%---------%%-------%---------%-------------%------------%-------S--%--%---------------%----------
------------o-----S------------------------------------o----------------------------------------------------|---%----------%-----------------r--%-%--
-----%---%--%-----------%------------------------------------%------------------------o--------S------------|--------------------------------%-------
-------------%---------------------%---------%---------------|-----------------%-----%-----------------%----%------------%-----------%-----%%---%----
------------------o-----------%-------------------%----%-----|--%-----------------S---------------------o-------------------------------%------------
-----%---------------------%--------S------------------------%--------------------------o-%------%-----------%-----%-------o--%%--%-S-----------%----
----------------------------------%-------------------------------------o---%---------------------------%---------S-------%-------|------%-----------
-----------S---------------------o---------------------------%-----------S----%----------o-------------S-----------o-------------%|%---------------F-
-M-----------------------------------%--%-------------%-%---------------%-----------S--o-----------------S----------%-------------|--------%----%--#-
-X-------%-%--%---------------------------%---%-----%-|---%-----%------%---S-%--------------%--------%----%-%-----------%---------%-------------|--X-
-X---------|------------------------------|---|-------|---|------------|-----|--------------|---------------------------|-----------------------|-XX-
