----------------------------------------------------------------------------------------------------------------------------------------------------------------------------------------------------------
-X---------#--------X-#--------S-------------------X------XXX----X---X--------------------#--XX-----------------------S-X-X----%--------X---------------XX----X-----X-------SX--X----------S----------X---
------#---X-----S-X--X-----X---------X--------------X--#----XS---------#------X------#-------------X-X------#-----X-Q--------------XX--X-----%-----------------------------#---#-X-X-XX----X----X---------
X---S-----XX---X----S-%------------S-X---#--S-------------X------------------------XXX--S------#--X--X-X-#----------------S-------#--X----X------o----------#-%----X-X----------------X-------------------
----------X-X----SS------#--------XX------------#----------------------XX--X--g------------Q----------X---%--#---S--------X--X--------S--------#S----------------------X-----------------S------#-------o-
-------------X-X--X-X------------------------------#------X---------Q-#---X-X------X-X------------------------S--S----X--------------------X---------SXX---------X----------#-----------------------------
--#----SX--X-----g--X--2--------%------%------X----------------------#--X------#------------S-----#----------XX--------X---------------X-X----X-----g------%-----------X-----X--------X------XX--------g--
--X-------------------X----XXX---X---g--XS---X-------X--X-----X-----------X-------------XX----------X---------------#---X-o-----X----X----------S-----------------------%-S-SX---g---S-----#S-----XX-----X
---X---X---k------%-----#-#-----#----X------X--------------#-SX---------SS--X---------------o--------S--#-----S----%--------------X---XS------XX--------X-------X-----------X------X--#----#------------X-
----X-----XX------------X--#-------X---X---X---------XS--X-------%-------------------------X--X--S----X--g----------------TS#--XXX--X------X-S--------#----%---------S-----X-2--S-----X--X-----X----------
------------g---g-X-S--X-----------------X-----X--XS-X---------------X----X----------------------X-S-XX-----------------#-X-X---------S---------#-X--XX---------g----SX------------------X--------S-------
--------------XX---------XXX------------------------X----X-----------XX-----#-----------X---X-----X--------X------X------------S-----X---X-S----------X-------X--S--------------------------------X----X--
--S-------------X-Q---------#-X-X--S-----------X------------X---XX--------X------X----X----------X----X-#-------C-----XS--X---X-----------XX-X----------XS--X-------X-X--------%----------g---S-------F-X-
---M------X------X---------------X--------------------------XS--------X--X---------------------X-XXX--------------X-X--X---g-------------XX---------------SSX--X------X-X----------------o---X-----SX-X---
---X--------------%----------%--%--X-------XX------X--%-X--------X-X----X-----K--------X------S-------XX-g---------%--g----#------#--------g-------S----------------X---------X-%-%--#-S--X----------#-X--
---------X---X-X--|----X-----|--|-X-------------X-----|--------XX----XX------X-----X-------------------X-X----X----|-X-X--------------------X-------X-----------------X-----X---|-|-------------X-----X---
