---------------------------------------------------------------------------------------------------------------------------------------------------------------------
-------o----o----%----------------------------S------S---------------%-------------S-----------%----------S-------------------------------%-----------------S--------
-------------------------------------------%------------%-----%----%--------o---S---%----------|---------------%-----%---------%-%-----------%----%----S-------------
-----%------------o--%-------%----%-%------|%---o-----------------------------S---S---%--------%----------------------------------%-------------------------%--------
-------------------------------------------%-----------S------------------%------------S-----S----%--%----------------o-------%---------------%------%---------------
----------------------------------------%---------o--S-----------------%-------%----------SS-------------------S--------o---------------------|---------%------------
--------%---%----------------S----------------------------------o-------------%----------S------------------------------------------%-------%-%----------------------
----------%%--S-----------o----------------------------------------o-----------------------%--------------o-S--------%------------------------------%---%-----%------
-------------------%-------------%----S-S-------------------%--%------------------------------o----------o------%---o-------%-%------------%--------------------S----
---------------------------------------%------------------%--------------------%----%----%--%----------------------------------------------|%-S---%%------S----------
-%-------------%---------------%--------------------------|--%------------------%----------------------------%---%-------%-------%-S-----%-%-------|-----------------
------S----o----------------S--------S---------SS---------%---------%-------%---------S-------------------------------------------------------S----|-----------------
------------------o-----------%---%-----%-------------------S-----%-----------------------%-----------%%---%-------------------S-------------------%---------------F-
-M-------o-------------------------o---------%-------------%-----------------------------------%--%-------%--S--------%-o---------%------------o--o----------------X-
-X--%----%-----%-S--%--%---S--------S-------------------------------------------------------S--------%---------------------%--------S--%--%----------------------%-X-
-X------------------|-------------------------X---------X----X-------------------------------------------------------------|-------------------------------------|-X-
