----------------------------------------------------------------------------------------------------------------------------------------------------------------------------------------------------------------------
-------------------X---X---X--X---X--X------X--------X-X-------XX--------------X----X----X-----------X---XX----X--X-----X----X--------------T-X-----X-------T---X---X----X-----------X-----------X----X-XX-----S------
---------X--X------X-----X--X-------T------X-----X---XX-----------SX-----X------X---X------------X-----X----X--X-----------SS-----U-----X--XXX-X----------X-X--X---X-------------------------X--------X--XX----------X
-----------------XX--------X-----X--X-------X---T--S----------X-------------------X---X-X-X------XXX----------------------------------X-----------------XX----X-SX------------------S----------------XXS---X--S--XX-X-
----X---------------------------X--------------SX-----X--S--------X----XX----S-X----------------X-----X--------------S-------XX---S----X---XX--------------------X-----X--------------XX----------X---X-----------XX--
---XX--------------X--X-----X-------S--X-X------X---X-X-X-------------X-------X---X---------------X--X-----------X-#-------------X----------------------------X-X--------------X----------S---X-------X-XS----X-------
X----X-----------------------------X---X-----X-X---------SX--X-----------XX-----------K--X------X-------------SX--XX--X------------------X-----------------XX-----S-------X----------------S---S----#-----------------
-X----X-X------X-X----U-----------X-------X----X--------------------X-X--------------------X---S-#------X------X----------------------X-X-----X--X------------------X-X-S----T-------X----X---X-----XX---XX-X----S----
X--------X---------X------X--XX-------X---X--X---T------S------X--X------------XX-------X--X-----X-X-T---------X---------T------------X---X-------------X--X-----X-----------X-T-S----------------S------X------------
--------XX-X----------------X------X---X--X--X---X-X---------------------------X---------------------XX-----------------XXX-------K---------X-X---X-X-----X--X-------X--XX-SS--X----------------------------X----X----
-#------X----X---------------------X--------------------X--XX-----------------XX-----X----------------X-X-------------T---------------XX----------------------X---X------X------X---XX------X----X----X---------------
-XX---X-----X--S----------X-----2--------X-----X-X--X------X-X-X---------X-----X-X--XXX------X--XSX--X--X--------X---XX-----------------X-------X--------------------U----------X----------X--------X---X-X-XXX-------
----S--XX---------X-------XX-X-X------SX---------XX-------X---------X---X--S-----------X----------------X--------------#-----XX----------------X--XX----X--------X-X---------X---------XS--X-----------------------F--
-X-M-----------------------------------X-----------------X-T-----X---X-------------------U--X-X----------------X-------X---#--------X-X----------S-X-S---------U-X-------X----------X--X----X----------------------#--
---X------------X-X--------X---X---X---------X---X-X-X-----X--2-----------------X--------------X------X-----X--------------X---S--XXX-X-----XX--X--------X--X-------X-----------------------------------X----X-----XX-
--XX------X-----------X------X----X---------X--X-----X-----X---X------------X----------X------X-X-----------X--------------------X-----------X---X--------XX-X-------X-------------------------------X---X------------
