----------------------------------------------------------------------------------------------------------------------------------------------------------------------------------------
------------#--------------------------#--------#------------------------------S----------------------------US--#----S------------------------------------------------------------------
---------------------------------o----------------------------------------#-------------------------#------------------#-----------#-----------#-S---S-----------------#------------#---
---------------#--------------------------------------------------##----------------------------------#-----------Q--------#---------------------------------------------------#--------
--------#-##--------------#------------#----S---------#----#----#-------------#------------------#----#------------------------S-----------------------------------------#----#---------
X-----#--------#---------------------------------------------------#----S------------#--------------------------------------------------------------------------------------------------
X-S----#-----#-----------S--------------------------#-----------#-#--------#-------------------------------------------#----------#-----------------------------------------##------#---
X-----------S---#-----------------------#----------------------S-----o------------#------------#------------#-------------------------#------------#--o------------#--------------------
X--#-----------------------------o----------------#--------#-----------------------------S-------#----S----------------------#-------------#-#----------#--Q-------#--------------------
X-----------------------S----#--------------------#-#----------#------------------------------------o-----#------------------#-----#--------------------------------------#-------------
X------------S-----#--------------------------------------------------#-----------------#----------------------------------------Q----------------------------#---S--------#------#-----
X---------S---------Q-----#---------------S-#-------S------------#-------#-----------------------------#----#---#-----#--------------#---------------------#---#---#--------------------
X-------------#----S-------------#----#------------#------------------------------#-----#------S-#----------#-----#-----------------------------------------------------#------#----F---
X---M---------------#-#---------------------#---S-----#----------------------#--------------------------#--#---------------------------------------o-------o------------#-----------#---
X---X-----------------#-----------#------------o-------------------------------------------#--o--------------#-------------------------------------------------------------#------X-----
X--XX-------------------------------X------X----X-X-----X----X-----X-----------XX-----X---------------X-------X----X---X--X----X-------X------------X---------XX--X-------X-----X-X-----
