------------------------------------------------------------------------------------------------------------------------------------------------------
-%------------%-----%-%--------------------------%--%---------%--------------------------------%------------------------------------------------------
-------------------%---------------------------------%---%--------%------------------------------%-------------------%%-------------%--%----------%---
-o-----------------|--------%------------------%-%----------------------------------%----------------%-------------------------%------------------|---
-------------------%-----------------------------------------------------------%---------------------------------%------------------o-------------%---
---%---------------------------------------------o----------------o---------%-%----%--------------------%-------------------------%%----------------S-
--------------%--------%-----------%---------U----------------------------%----------------------%--------%-----------o----------------%------%-------
-------o----------------%------------------------------------%--------------------------%-%---------------------------------------------%%------------
------------%------%--------------------------------R--------------------%------------------%----------------%-------o---------------------o----------
------%------------------------%-----%---------------------------%-----------------------------------------------------%----------%-----------%-------
----o------------------------------------------%------------o---------------------------o------------------------------|----------------%---------%---
-------%-----------%------------%---------%--o---%--------------%-----S--------------------R-------------%-------------|----------------------------%-
-------|----o-----%---------S-----%---%-----------------------------%------------------------%-----%-------------%-----%--------------%----%-------F--
-M-----|-----------------------------------------------------------------------------%--------%---------------%--|---------------------%-%---------#--
-X--%--%--%-%-------%-----%-------%----------%-%-%--%-----%%----%---%--%--%----%--%--|------%--%---------------%-%-%-X-------%----S----|----%------X--
-X--------|---------|-----|-------|--------------|--|---------X-|---|--|--|------X---|------|--|---------------|-|-|-X-------|-X-------|----|------X--
