----------------------------------------------------------------------------------------------------------------------------------------------------------------------------------------------------------
------X-------g-------------X-------------#----X----XS-------------%----------X----#-#-XX-----XX-----#---XX---%----X------X----------------------X--------X------------X---------------------#---X--------
-----------------%---------X----%--------------X-XX---#--X---X--------------------X---X-X-X---------------X-----g-------------------X-X--k---%---X----X-------X-----X--X----XXXX---------S----XXX---------
---X-X--------X---------S-----K------#----------------------------------------------X-X--X---XXS-X---X------X--X--o-------------------X--X--%|----#-#-----------------#----------Q-----S--X---X-------X---
-----X----------%-------------SX--X-X--S----X-X---X---X------X-S----------#----------------------------X--#--------X-------------#-----g-----|-#-------X--%%---S-------X-----------X-----#--------X-------
X--X---------SS----XX--------------#------#----SX-------X----------X-X----------S--------X-------------------X-----X-------SS?------#--------|----------X---------------XS----------------X-----------X---
X-----XS----------X-----g-----X--------#--X--------------X-X--X--%-----XX-------X-----X-------------------------------X--X------X---X-%--X-X-|-X--g--X--X--X--X------X-X---S-----X--XS-g--------%-X-------
X--------X---%--------%--------X----X-------X--%-X--------------X------------X--------X-------o----X----------------X-----k#---X-------------%--X-------------X----------S--------------------X-----------
X-------------------Q--X----------#----%---S---------------------%-X--X---------S---S-------X---X----X-o---------#--------X--------------X----#-----------------S--------------------X--X---S------XX--#--
----SX-----S------------S-X---#------------------X-S----X----X-X------X-%---------------g--------------------X----X-----------------X-X--------X---X-S----X----X------------------X--XX---X-X-X------X----
--XXX---SX------------------%-------------------------------XXX-----------------------XX-X-X-X----------------------#-----S-SX------------%------------X----X---X-X--------XXX----X--X-----#----o-----%---
---------X---------X---X----------#-X----X-----------X-----X--X-----S--------2------S-------------#-X-------------------------------------------------XX---X----X-X--g----------S-X-------X----X----------
X-----------X--S----X-------T--%-----------------#-------------------X----X------------------------X------------X---------------X----------X----------------X----!----X------------------X----------X-F---
---M----S------X-X--X---#S--X-X---------X------------XX--S-XX--------------X-------X------g--X--X--------X----%-----------XXX-%-X-----------X-X--X---X--------------------X----------------S--X--XXX--X---
---X-----X-----X-X---X------------X------------S#------o-------X--------------X-----X----XX-------X-X-----X-o------S-X----------X------X-------------X-----X-XX--%-X-%-------X---------X-------------#----
--X----XX--------X---X-X-----X-----X--------------------------X---------------XX-----X-----------X---X------------X---X-------X--X----X-X------------X-----------|---|--X-X-X------X------------X---------
