------------------------------------------------------------------------------------------------------------------------------------------------------
-----------------------------------%--------%---------------------------------%-------------%----S-----------------%---%--------------------%---------
---------%-----o--g---%-----------------o------------------%----------------%---------S--------------%------------------o---%-%-----o-----%-----------
------%-----------%--------------------------o--U----------------------------------------%----------------------------%-------------------------------
--------U-------%-------------------%--------------------------------------------------%-----------------------------------%------%-------------------
---------------%-----------%-------%--------------------------------------------------------------%---------------%------------%--------------------%-
----S----------------------------%-----------------S----%-------%-----------%----%----------%----------o--------------o------%-----------%-----%------
--------------------------------------------%--%---------------------------------------%------------------------------------%-------------------------
---%--------S-----------o---------------------%---------------------%-o------------------------------------------------------------%------------%-----
-----------------R-------------%----------%------------------S--------------%------------------------%------------------------%-----------------------
--------o--%-o------------o-----%--%%--------------------%-----%---%---------------------%-%----------------------%-----------|-----%--------o------o-
-----------------%------------------------o-----%------------------------------------%-----------------------------%----------%-----------------------
-------%---------------------------------------%--%-----------------------------------S--------------------------------------------------S---------F--
--M----|---------%--------------o--%----------%---------------%-----------------------------%-%-%--------------------------------------------------#--
--X-%--|---------|-------------------%------%------%-%------%------%------------%%---------%----|--%--------------------%-----%---%----%--------%--#--
--X-|--|---------|--------------------------|---X--|-|------|------|-------------------X---|----|--|------------X-X-----|---X-|---|----|--------|--X--
