---------------------------------------------------------------------------------------------------------------------------------------------------------------------
-------------%-----------------------S-----------%----------------------------------------------%---------%%----%-%-----------o-------------------o-----%---------%--
-----------------------------S-%---------------------S---------------o-%------------------------------%------------------------------------------------%-------------
------%--------------%---S-------------------------%--%-----------S--S-----------------%-------------------%----------S------------S---------------------------------
---o------S-----------------------------------%---------------------%----------%--%-------%----%------S----------%---------------S--S-------o-----------------%------
----------------------------o-------------------%-----%--------?--%-------------------------------------------%-----%------------------------------S----------|------
--------------------S------%----S----------%----------|%%-------------------------------S---------%-------------------------%---------------------------------%---o--
---------S-----%-------------------o----------%-------%------------%------------------%--------o-%-------------%-S----S---%-------------------%--%-------------------
-----------o------------------o--%-------%------------------S----%---------S-----o---------------------------------o-S---------------o-------------------o-S-----S---
-------------------------------------------------%--S------------|--------%----------S-----------------%-------%---------%------%------------%---------S-------------
--S------------------%-------------S-%--o---------o--S-----------%-------------%----%-------------------S-----------%------------------------------------o----%--S-%-
--------------------%--------------------------S----S-------%-----o--------------%----------------------------------------------S---------------%---S--------%-------
-----------------------------------------------------%-----------------------------------%------%-S---------------------------------------------|----------%--%----F-
-M------%----------------------------%-----------------------%---------------%---%--------------------------------------S---------------o-%-----|------------------X-
-X--%--o-----%-%----------%--%--%-%---------------S-------------%-----%-----%----------------------%------%---------%%---------------%--------S-|--------?-%-------X-
-X--|--------|-|----------|-----|-|-----------------------------------|----------------------------|------|---------|---------------------------|------------------X-
