---------------------------------------------------------------------------------------------------------------------------------------------------------------------
-----------------------S--%---S------------------------%%------------%-S------------%--S--------------------------------------------S-o---------------%--------------
-------------------S-----%--o----o----------------%------S-------------------?--------------%-----%------------------------------%------%----------------------------
--------------------------------------SS---------S----S-----------------%---o-----S-------%-------------------S------------------------S---%-------------------------
-------o--S--%-------------------S----------------------%------------%-----%-------%--S--%-------------------S--------------o-----------------%---%------------------
--------------------------------------------%-----------|---------------------------S--------------------S-------------------%---------------------------------------
--------------------------o-%---------------------------%---%--------------------%-----------------------------------%--S--------%-----------------------------------
-----------------------------%------S--%---------------------S---------------------S----%------------------------------------------%-------------------o-------------
----S---S--------o---------------------------------------------------------%--o-------------S----%-----------%-------%------%-----------------------%------%----S--%-
--%----------%--------------------------%------------------------------%---|---S----------------------o-----%------%----------------------------------------------o--
-------------------o---------------------------------%------------%------S-%-----------%--------------S-o-----?------------%-------%----------------%-------%------S-
--------------%----------------%---------------------------%-----------------------%-S----%-----%--------%----------%--%------------------------S------%-------------
--------------------------------------S--------------%------------S-------------------------%-----o-----%----------------------------------------------------------F-
-M----------------------------------------------------------o-o----------------------------------------%---------%--------------------S-----------%----------------X-
-X-S--------%---%-----%-S-----------------%%-----%-------%%------------------------%----%-----------%-%----------------------------%-------------------------------X-
-X--------------|-----|------X------------||-----|-------||------------------------|----------------|----------X-------------------|--------------------------X----X-
