------------------------------------------------------------------------------------------------------------------------------------------------------
---S-------------------------------------------%-----------%-------%------------%--------------------------------S------------------------------------
---------%------------------------------------------------o---%------------------%-o---S------------------------------o-%-----------------------------
---------------------------------------------------------------------------%--------%-----------------------------------------------------------------
-----------------%-------------------------------------------o-----------------%-----%--------o-------------------------------%---------%-----%-------
----%---%------%-----%-------------------------------------o-----------------------------------%---------------%---o---%-----------%-----%--%---------
----------%-------------------%-------o----------------------------S---------------------------------------%-------------------%---|----%------%------
--------%------------------%-------------%------------------------------o------%-------------S-------------------------o-----------%------------------
-------------------S----------------------%-------------------------------%------------------------------%--------------------------------------------
-%-o-------------S--------%------%---%-----%--%--------------%----%-%----------%----------------------------------------------------------------------
------------o--------%---------%---------------------------%---------%------S------%----------------------o-------------------------------%-----------
---------%--------------%----o-------------oo-------------------%---------------------------------o-------------%-----------------------%-------------
--------%---------------------------------------------------------R---%--------------------------------o------------------%------------------S-----F--
--M---------------------------o------------------------%-----------------S--------S----------------------------------------------------%-----------#--
--X-------%---%--%-----%------------%--------%--------%-%--------------------------------------%-----%---------%--------%-o--------%%-----------%%-#-X
--X-------|---|--|-----|------------|--X-----|--------|-|-X------------------------------------|-----|---------|--------|----------|------------|--X-X
