----------------------------------------------------------------------------------------------------------------------------------------------------------------------------------------
------------#-----------#--------------------------#----------#------------------------------#-----------------------#----------------------S-----------------------#-------------------
-----------#----------------#--------------------------S-------#--------#--------------------#-------------------#---------#----------#--##-----#----#---------#------------------------
-#---------#S-----------#------S---------------------------#---#-----------------------------------------------------S------------------------#-----------------------------------------
--------------------------#-----#-----------------#------S---#----------------------------------Q-------------------------#---------#S-----#--#------------------#----#-----------------
----o----------------------------#---------------#-#------------------#--------#---------------------------------------------------------US--------------------------------S---#----o---
-----Q---------#----#-o--------------------------#---------------------------------------#---------------------------------------#------------------------------------#-----------------
-------------------------------------------#-----#-------------------------------------------------------#------S------#-----------------------#-#-------------#------------------------
---------#--#------------------S--------------#------------#-------#--------#-##-------------S-#--------#--------------------#----#--------------------------#--#-------------------#---
---------------#----------------------y-------------------------S--#------------------#------------------------------------------------------o-----------S--------------------------#---
--------------------------------------##-------S-------------------#S---------------------#--------#-------------------#--#-------------------------------#-----------------------------
---------------------------S---S----#---#-----------#----#-#--------------------##1--------------------------------------------------------o------------------------#-------------------
-------------------------------------------------#---------#------S-------#----------------------#------------------------#----------------------------------------#------------S-#-F-S-
----M--------------------------------#------------------------------------------#------#---------#-------#-----------------S---------------------------------#-----#----------------#---
--#-X--------------S------#---------S--------------------------------#----------#-----------------------------------------#---------------#------------------------------------#--------
----X-------------------------------X---X---------------X-----X-----X-------X---------------------X------X--------X---X-X-------------------X--------X--X-------X-X---------------------
