------------------------------------------------------------------------------------------------------------------------------------------------------
--------------%%%-----o----o--U-----%----S-------S------------------------%-------------------------o-------------%---------g-------------------------
-----------------------------R----------%--------------------S-----------------------------------------%------------o-------%---------------o---------
-------o------------------------------------------------------%--------------------%----------------------o--------%---%------------------------------
--%-----------------S---%------------r----------------------%------------%------------------------------------------------%--%------------------------
-------%-----%-%-------------%---%---%-----------%-S------%--------%--------%----%---------------------%-------------o--------------%-----------------
---------------|--------------------------------------%-----------------------------%--------------------------S-----------%------------------------%-
-------------o-%-----------o-------%-----------------------------S----------%--%-----------%---------------------S----%-------------------%-----------
-%-------%%-%--------------------------------------%-------------------%-------------------------------------------------o-----------%------------%-o-
------------|-------S-------o---------------------------%----------------------o-o-------%--------%------------%----------------------%---------------
------------%---------------%---------------------------------------%--------------------------------------%----------------------o-----------%-------
--------------o-------------------------------------------%--------------------%----%-%------%-----------------------------%-----o--------------------
--------%--------------o----------------------%----------------------%--------------------------%--------------S---------S--------------%----------F--
--M--------S---------%--%------S---o-%---------------------------------------------------------------------------S----%----------o--------o---S--%-#--
--X-----%---%-----%---o--%-%---------------------%----%----------------%--------%----%---------------------%------%-----%----%--%-%-%----%-------|-#--
X-X--X--|------------------|---------------------|----|-------------------X----------|------------------X---------|----------|--|-|------|-------|-X--
