---------------------------------------------------------------------------------------------------------------------------------------------------------------------
-----------------o------------So------------------%-----------------------------o-------------------------o----%--%---%--------S---%---------------------------------
----------------------------%-----o--------------%----%------------SS-------------%-----%-------------%----------%-----------------------%-----%---------------------
----%-----o-------%---S-----|-------S-----------------------------------------o-%----%--------%-S---------%------|-------------------------%----------S--%-----------
--%%--So------%-------------%------%-------------%------------------------%-%----%------------------%-------%-%--%----------------%%-----S---------------------------
--------------------%---S--------------o---------------%%---------------------%--------------------S---------------------------------------------%--%--------S-------
----------------------------------------------o---o---------------------------------%-------------%------------%-------------%-------------------------%--o-----%----
-------o--%-----------%-----------%----------%---------%-----------------%-------------------%---------------S-|-------S-------------------%------%------------------
-----S---------------------------S-----------------------o------------%----------------------------------------%-----------------------%------------------%----------
--S-%---------------S---------o--------S------%---------%--------------S-o----%-S------%--------------------------o------%-------------------------------------------
--------%-----S---------S-------------------%-------%---------------------S---------------------%----------------%-%--------------%-----------o----%-----------------
----------------------%-----%--------------%------o---------------------------------%-------------------------------S------------------------------------S-----------
------------------------o-%-------------------------------------%------%----------------S---------------%-----o-----------------------------------------%-------S--F-
-M---------------------%----------------S-----S---------------------%-------------------------------------------o-------------%%----------------%----------------%-X-
-X-------%----%-------%----------%--%--S------------%-%-%%---------------%-------%-------%--S------------------------------%--|--%---------------%-%--%%-----------X-
-X-X----------|-------|----------|--|-----------------|-||---------------|-------|------------------X----X-----------------|--|--|---------------|-|--|------------X-
