---------------------------------------------------------------------------------------------------------------------------------------------------------------------
-----------%------%--------------------------%----------------------%---%-----------------------------------------------------------------------------------------%--
---------------S---------------o--%%-%-------------%----S-----------|-----%%-----S---------------S---------%---o--------------S----------%----------S----------------
---------------------------------o---------%--S-------%-------------%-------------S-------------------------------------------------------------------S--------------
---------------------%---------------------|-------o--|-------------------------------------------------------------------%-----------%------------S-------------%---
------S------o----------%---%-------%------%-oo-------%------------------%---------------%-----%--------S----------------%-----------------%------o-----%------------
-------S--------------------------------------S--------------------------------%--%---------------------------%-o--o--------S------------------%---------------------
---o--------------%------%-------------%---S---------------------S----------------------------------%---------------%----%----------------------------------------o--
-----------------------%-----------------------------o------%%-----%--S-----------------------------------------------o------------%----------------%-------o----%---
--S-------------%---------------%--S-o------%------------%------S----------------%-----%-----------------------o--------------------o------------------o--------o----
----------%%-%--------------------------%-----%----------------%------------------%-----S-----------o-------------------------------------%--------------------------
-----------------------S------------------%---|-------------%-S-------o------------------------------------%------------------%---------------S---%---------S--------
----------------------------------------------%%-------------------------------------------%----------------------S--------S-----------------%---------%-----------F-
-M------------%-------%----S---------------------------------------------%---S-----S-------------------%-----%---S------------------------S---S--------------------X-
-X--------------------|------S-----S------%---%-----------S------S-S----%----------------%--%------%---|-----|--------%-----------%---%%-----%-------------------%-X-
-X--------------------|-----------------------|-------------------------|----------------|--|-X--------|-----|--------------------|---||-----|---------X-----------X-
