----------------------------------------------------------------------------------------------------------------------------------------------------------------------------------------------------------------------
---------S-----X-------X-X--X---------T---X--#--X-----------------------------X---X--S--X--S----------X-------------X-XS-------X-------X-----X-------X-------X---X-#------X---------SX--------XX-XX-------X-----X--X-X
-X--X---------X---------X------------XXX-----XSXX-------------X----------X-----XX---------------S----------X-X-------X----T-X--------------X------k---------X-X---XX-------------------X-----------X------------------
-----X---X------SX---X---2-----X-----------------------XS-----------------X-----X---X--X------------X-----------------X---X---X-----X---X---------SX-------X---------XX-------X--X-------------------X-X-------X------
-X------X---------X-----X--X-X------XX-X--------X----XS---------X-------XX---X------X--------X-----------X-----------X---------SX----------------X---X-T----X-----X-XX-------X--X-------X---XX---XX------------------X
--X-----XX--------------------------X---S--------X----------X----XX-------------X--------X-X--------------X-----X----X------X----X-XXX--------XX---X-X-X-XX----X--X--X---X---------------X---------X-----------------X
---SXX--------U--------X----X--------------X--X---------X-XX-------X-----XX----------X--X--------T-----------------------X---XX---XX-X------------X----------X--------------X----------S--------X-------------------X-
XX-------------------S-X-X----------X----------X---------------X--T-----T--------X--X----X----XX-X-#-----X-----X---X-------X-----X--S-----X-------X------------X--X---X-X--X-X-------X-----------X-------------X--X---
-------X-----------------------------X---------------------X------X-----X----X---X--X--------------X--------X---------------------X---X---X---X--X----S----------X-----SX----X-------------X----S-----X--------X------
------X--X-------X----S----X------X----------X-----X-S------------------X----------X-------------X-X-------------------X----X----S---X---X------X--X------X-------X----------X--X-----S-------------------------------
----X---------S-X-------T--------X----------------------X--------------X--XX----------------------X------------X-----X-X---X----------X---X-X-XX-----X--X----------X---------X---------------X---X--X-XX---XX---X-----
X-----X------X-X--------X---X-------T---------------X---X-----X------K---------------X---X-------X---------X----X--X---------X-------X--T------X-XX-------X-S---X--------------------------T--X--X----X-XXX----U-T---X
-XS--S--------X------------------XX-X----X----------XXX-----X-XX---XX--X---SX----------X--X------X-X-----X--X--X-X-X-T-------------X----XX-----X--X----K---X-XX----X-X------------------XX-X---------------------X-F--
---M---------X-----XXX------X--------------X----X--S----X---XX--X-------X----------------X-X----T----X---------------X--------X---X------------X-----------------S----X-------X-------------X----S--X--X-X---X--g--#--
--XX------------X----------------------X---X-----X-------------X--X------------X-S------------X-X--SX-X-X------X----X-------------X-------X-------X---X-------------X--T-T----X-X-----X--------X-----X----------SX-XX-
X----------X---X---------X--X----X-----X-----X----X-X--X--XX--X----X---X------X---X--------X--X--X----X-----X---XXX---X---------X--------X-X---------XX-----------X----X-XX-----X--XX---------X----X-----X-X--------X-
