----------------------------------------------------------------------------------------------------------------------------------------------------------------------------------------
------------------#---------------------#----S---#---S---------#--------#--------#----o------------------------------------------------#-----S-------------------------------#----------
---------#------------------#--------------------------------#-----------------------S----------------------------#----------#------#---------------------------------------------------
------------------------------------------------------------------------------------------------------------------#---------------------#-----#---------#-------------2----------#------
--#------------------------------#------------------o-----------------------------------------------S----------------------------------#-----------------------------#-------------#-#--
-#-------------------------------#--------------------------------------#--#---S----#--------------2----------#-------------?Q----------#------------#----S------###--------------------
---------#-----------Q-------------#-------------#--#----------------#-------------------------------------o----------Q------------------#----#-----------------#-----------------------
----------#-------------------------------------------------------#--------------------------------------S----------------------#-S--#------o-------------Q-----------------------------
--------------------------------------------------------------#----------------------------#----------#------------#-------2--------------#--------------#---------------#--#-----------
---------#-----------#-------------#-#-------y-------S----------S--------#--------------------------------------------------#--------------------#--------------------------------------
---------------------------------------------S--------S----------------------------------------------#-------#-------#----------#--o----------------#---#-------------------------#-----
-------------------------------------#-2-----------------------------------#----#----------------#-----------------------------------------S--#-------------------#---------------#-----
-------------------------------#--------------------------------------------------------o------------------------------------------#------------------------------------------#-----F---
----M--#-----------------#------#-----------------------------o---#--#--------##----#-----------------#------#---------------------------SC-------#-------S-#-#---------------------#---
----X--------S--------------------#-------#----------------#----------------#------#--X--------X--------#------------X-----Q------------XX---------------------#------#-----------#-----
----X-------------X---------X---X----------XX------------------X----------------XXXX--X------X-X------X------X---X---X--------------X---XX--X----------X--X-----------------X-----------
