----------------------------------------------------------------------------------------------------------------------------------------------------------------------------------------------------------------------
-----X-2-----X-X-------------X--X-t----S-----X----X-XX--------X--X-X--------X----XX-----------------------X---------------X---T------------X------------X-----X----XX----------X---------------------------2--X-XX----
------T-----XX---X---------------XX-------------X-------X--------------X----------XX--S------X--X------X--X------------X---X-XX--X---XX---------S----X---------X-----------------X---------S-----------S--------------
-----XX----X--------X---XX-X-XS--X--------------------------------X---X-------X------------XX----S--------X--------------------X-----X---SCS---------X---X-----------S------------------X---X----XX-------------X-----
---XX-------------XX------------X----X-------------X--------------------X--XX------X------X-------------------------X---------------X-X---------X------X--X---------------S-XX----------------------X-X-X----X--------
---X------XX--------------X----------X---X----SX-------X----------------X------X--X--------------X--S------X----------------X-X--X-------------X-X-X------------------X----X----X-X-XX-X-----------X----X----------T--
-----XX-X-----X-X-----T----X-X------X--X-----X----T--X-X-X-----------X-X--------------X--X----#----X----X-X--------X--------X--------S-X-X-----X-------X---------X--X-------------------------------------X------X-X--
----S-X------XX-------X---------X---X-----X-------X----XXXX---X--XX--------------X--X-----X--XX-X-----X--------------X-----X------------X--S---X---X---X--------X--XX-S------------------------------S-X-------X---X--
-X------X--------X------------X---SXX--X---X--------------X-XX------------------X---X----X-------------------S--------X-------------------------------X----------------------X-XXS------------X---X----X-----X--------
----X---------X-X---------------------X-S-----S-----------------------X-------XX------X-X-X------X------------X---------------------------------------------------T-----------------X-----------------------S-X---X---
--X-------X-----X----X---S---------SX------X-----------X-------X-----------------X---X-------X----SX--X----X-----------------------X--X-------------X------X------X--X----X------------X---------X-XS------S----X---X-
---------------X-----X-X--------------------T-------X-S-------------X-----X------------------------------X-----X-----X-----------X-----X------X---X------X-------------S-------------------------X--------------------
XX-------------X-----X-X-XXX----------------XS---------t----------X--------X-----X----X-------X---X---------X------XX---------X---------XX-----X-------------XX-----------------X------X------------XX-----X-------F--
X--M------XX--XX-XS-------XXS----------X--------XX--XX-X------------------X---X------------X--X---------------------------------X-------X-S-----X---X---------------X----------------X---X---#-------------X-------#--
---X--X--X-------X---------X-X------------------XX------X-----XX---XX-X---XX----------------------------X--X---XX--X-XX---X---XX-X-X-----X---X----X-XX--X-----X--X----T---------XX---------S-X-X-SX----------------X-X
---X----------------------X---X--X---X--------X-----X---X-X--------------X----X------XX----X-----X-X------XX--------X----X---X---X--X----------X--XX----------X-------X--X-X----X-----XXX------X---X--X-------X------X
