----------------------------------------------------------------------------------------------------------------------------------------------------------------------------------------
--------##------------------------------------#----------------#------#---#----#-----------#------------------------------------------------#-------------------------------------------
---------------------S--#-y-------#---##-----------#-------------------------##----------------------------------------------------#--------##--------------Q-S--------#----------------
--------------------------#-----------------------------------------#--#----------#------#-------#--------##--------------#--------#---------------#---------#-----------##-------------
---------------#------#---------#---------------o-------------------------------------------------Q---------------##------------------------------y--------------S----------S-----------
----------------#----------------------#------------------------------------#-------S-------------------#------------##-------------------S-------#-----------------#-#-----------------
-------#-----S---------------------##S-----------------#------------------------o----------------------------------------------------#--#-------#----------------------------#-----S----
-----#------------------------------------------#-----#---------#------------------------#------------------------?Q--------------------#---------#--------#----------------------#-----
-------Q-----------------S---------#-----------2-------------#--#--#----------------#---##------#----#-----------------------------------------------------------#----------------------
---------------S-----#--------------#---------#---------------------------#-#-------------------------#----#-----------------#---------------------#-------#-------##-------------------
-----S------------------------#-----#------------------SS-----------------------------------------------------------------------------------#--#----------------------#-------S------#--
-------S--------------------#--#---------#---------------------------------#--S----2-----------------------#-------#-S---------------------#-----------------#--------------------------
-----------##--------#-------#-------------------------------------------#-------#------#-----#--#-----------S--------#---------#------#--------------------------------------------F---
----M----#-----------------------------------------------#-------S---------------------#----------------------------#------#-----------#--------------------------------X---------#-#---
----X--------------#------------------------SC----Q-#-----------S------X---#--#-##--------#----------------#--------------#-------------------------------#--X----------X---------------
----X---------------------X-----------------X----X----X--------------X-X--------------------X----X--------XX----------X---X------------------X-X----X----X---X----------X-----X---------
