-----------------------------------------------------------------------------------------------------------------------------------------------------
--%--------o-----------%-o--S------------%--%-r---%----%-------------------------------%-----------------------%--%------%-%----------%--------S-----
-------------------------------------------%--%-----%--|----------%--------------------|-------%---------%%-----%-------o-------%--------------------
------o--------------------%----------%----------%-----%---%---------------------------%--%-------------S------------------------------------------o-
--------------------------%--%----------------%----------------------%--S-----o---o-----%--------%----------------------%-------%--------------------
------------------------------------------------%------%-------------------------%-----------------o-------------------------%-------%---------------
---o-------------------------S-%---------------S------o|--------------------%----------------------------------------S--------------%--S--%------%---
--------%--%---------------------------%--%--%---------%---------------------%------------------------------------------------------|%----------o----
-------------------------------------%----|-o-----------------SSS-----%--------%-----%-----------------------%---%----o-------%-----%------------%---
---------r-o------------------------------%---------------------------------------------------%----o------o-------%------%---o---------------------o-
---------%%-------%----------------------%-S-----------------------%--------?-%%------o----------------r--%----------------o-----------------------%-
-----r----------S--------------------------------------------------------%-----------------%-----------%---S----------------%----------%----%--------
-----%-------%-----%-----------%----------------------------%-%---------%----%------%-----------------%------------------%-------------------------F-
-M-----S------------S--------------------o--------%-------------%----------%--------------S---%--------%----------------------------%-----------o--#-
-X--%-----%---%-------%-%%----------------%-----%--%%---------S------------|-------%---%-o----------%%%--------o------%---%-%---%------------------X-
-X------------|-------|---------X---------|--------||------X---------------|-------|---|-------------||-------------------|-----|------------------X-
