--------------------------------------------------------------------------------------------------------------------------------------------------------------
S--------------------------o------------------------------------S--------------S-----S-S----S-----S----S-----------SS------S-------------------S---S--S-------
--S----SLS--------S-----S-o-----S----------S--S-S--S----------S---S------S------------g-------S----------S-S-S---------------------------------------------SS-
-------S----o--SS----------------S----------------------S-S-S---------S-S--o------S-S-S-----------S---------SS------o-S--S----S---------------S-------SS---S--
-------------S--------S--------SSS-S-------------S------------------SS----S-S----------S-o----S---------S-----S----S--S----------------S-o-----------S-SSS----
-S--S-S--------------------------------------S-------------------S----------SS--o----------S---S-S---S----S-S--o---S-S---S-S-S---------S-S----SS-------S------
------S-----------S----------S--S---------------S--S-S-----S--S-----S--S--SS--S-----------SS-------------S------S-------------o--------S-----------------S----
---------S---S-----S----S--S--S----------------------------S--S---------S--------S---------S----------o--------------------S---S-S--------S-------------------
--SS-------SS-----------------S------S-----------------S--S---------S-----S---------------------------------S---U--S----------SS----S--S------S---------------
S--S---------------SS-------S--------------S---S-----------S-------S-o----------g-----S-----SS--S-S------S--------------S-------SS----S------o---------S------
-S------------S----------------S-S-S-----SS--------------S--S-------------S-----S------SS----S--------------SS--S-------------o---SS---S---S---S-o------------
-----S-S-----SS-----S---S--S--------S--------SS---S-------------S------------------------------------S---S------S--S--------S-----S--S----S---SS--------------
-----------------------S------------S---@Q----------------S----S--------------U--------------S---S--o----S-S-----------S--SS---------S---S----X---------------
---M--------o-----S------------SS---S------------------------S-----------------S-------S-S-S--S--------S----S---S---------S------------S------X---SC-----S--F-
---X-S------S-------T---S--X-------S----S----X-----S--S-S-----X-----S--S---S----S-----S--------g--S-S-S-S----------------S-----S---S----------X---------SS--X-
X--XX---------------X------X--X------X-------XX--------X--X---X----------X-X------X---------X--X--X----------------X--------------X----X----X-X----X-X------X-
