-----------------------------------------------------------------------------------------------------------------------------------------------------
---------%---------------------------o---------------------------------------o----------------------------------------o----------------------%-------
-----------------------------------------------------------%-%---------------------------------%----S------------------------%-----------r-S-|-------
-------------------------------o-%----------%--S--------------------------------%------------------%---------%--%------------------------%---%-------
-o-------------------%-----------------R----------------------%-%-----%--------------S-------%-------------------------------------------------------
----------o--o--------------%--------%----S--------------S--------------%%---------?----------S-%---S-------------%--------------------------S----S--
-----------------o---------%----------------------S-------------------------------------------------------------------%------------g-----------------
------S-----------%-----%----------------------S-------%------%---------------------------------%-----------------------------S----%--%-%-%-------%--
------------%-----------|---------------%-------------------------------------------S--%------S---%------SS----------S-----------------------%%------
-----------o----o-------%-----%-------------o--------o-----%--------------------------------------------------------------------%------%------|-S----
-----------%----------------------%--%-------------%%--------%-----%---------%-%--------%---------------------------S-----------------------%-%------
----------------------o----------------------------------------------------o-----%---------------------------S-----------%---%--------%---%----------
--------------------o-----------------------------------------%------------S-------------------------%---------------------%-----------------------F-
-M-%----------S-S--------------------%----%---%%------------o---------------%-------%--------------o-------------------%-----------%---------------#-
-X--%--%------------%----%%------%%-----------------%----%---%--%-----%---%----%-------------%----%--%--------%---%-%-%|-----%----%-o-------%%-----X-
-X-----|-------XX---|-----|------||-------------X---|----|---|--|-----|---|----|-------------|-------|--------|-----|-||-----|----|----------------X-
