-------------------------------------------------------------------------------------------------------------------------------------------------------------------------------------------
----------S------------------------S--SS----S------SS-S-------S-S--S----------Q---SS--SS--------------------S-------S--SS------------S--S-SS--S--S-------SSS--SS-S---S-S-SCS--SS---S-------
S-S------S-S-------S---------S---------------CS--S-S-S----S----------o--S--S---------------------------S-------------S--S--S---------S-S------------------------S----S-----S----S---S---S--
----S------SS-S-S-S--S-S-----SS---S-------S-----------S-S--S--S--S---S---S---------------S-----SS---2---------SS----------------------S----------S---------S--------------------S----------
-----------S--S--S--S--S--SS--S---S--S--------SS----S---------SS---S-----S-SS-------------------------S-------S-SSS-Q--SS---S------S-----------------S----S-S----S----------S-------SSS----
S--S-SS------------S-S-------S---------------------S--------S----------S--o------S--S-----------S-SS--S-S-----SS--------------S---------------S----S--------SS-----S---------S-----S-----S-
--------S---SS--S----S----------------S------S----------------S-------S--SSS-------SS----------S----S----------S-S---S-----S-----S----S------S-----S----S-------------S--------S-------S---
----------o---------S--------S------S---g--SS------S------------S--S----S--SS-------S------S--S------------S------S---S-S-----SS----SS----S--------S-----S------S----S-SS-----S------S-----
S---------S---S-----------S---------S---S----S---S-----S-------------------S-S---S-S-----S--SS---S------S--S------S--S-------------S-SS-S-S--------S-------------S-------------S-----S---S-
-------S-----------S-S-SS----------S--S-S------------S-------S-S------------S------------S-S----------S-----SS---SCS-S-SS---S-S------S-----SS-----------S-----------S---S---------------SS-
-----------S----S-----------S------SS-------S---2----------S----------S-----------------S-----------S-CS-----------S------S----S-S-S--S------S-S-SS----S----------S--S-----S--S-------S-S-F
------S-----S----S---------S---o-S--SS------SS-S---S------------S-----------S---------------S------S--------S---------------S------------S?-S-S---S-----S--SS--------S---S-----S-S--------S
-S--S-----S--S----------SS---SSSS----S-S----------S-------------S--S-------S--S---------SS---------S---S-SS-----------------------S-S---S----S---S----S--------------S---S-----------------
--M----S------------------------------Q--S------------------S-SS----------------U---S-----S--S---S-----------------S-----SS-S---------------SSS----S?------S-S-----S---------S-----S------S
--X-----------S----SS--------S-----SS--------S---SS---S------S-----S-------SS-----------S--2--S-S--S---Q--X---------S-------------------SSS---S----------T--------S----S-----SS------------
--X-------------------------------------------X--XX------------X--------X-XX--------X--------X------------X-----------X-X--------X------X-------X------XXX---------------XX-------X--X----X
