---------------------------------------------------------------------------------------------------------------------------------------------------------------------
------o-------o------o-o-------------------%------------------------------%-----%----------------------------------S---------------------------%---------------o-----
----o-------S-----------------%----------------------%----------%-------------------------%-------------------------------------------------?------%-------------S---
-------------------------------------------S-----------------------------------------------------S--------%-%------------%%%------------------------------------S--%-
-------S------------------%-------%%----S-%--%---------------%%--------S----------------------------------|-|-------%-------------%---------S-%---S------------------
------o----------------%--|---------------------------------------------------------------------------o---%-%------%|-----------------------------------%--------%---
----------o---------------%-----------------------------S-----------------------------------------------------------%---%----------------%-------%-------------------
----------------%-----------%%--------o----S--------%-------%------------------------------------------------------------------------------o-----|----------------%--
--------%%---%-----------o------------------S-%---------%---------S-------------------------------------------So-------------S-------------------%---S---------------
----------%--------%------o----%-%--%---------------%--------------------S---------o-----SS---%----------------------------%----%--------------%------%------------%-
-%---------------o----------------------------------------------------%-------------------------------%------------------o-----------------------------S---S----o----
---o----------------S------S-------o----------------------S--S----------%--%-----------------------S---o--------------------------%---------------------------o------
---------------------------------------------------%----S---------------------------o--------------------------S---%--------------------S---------------S----------F-
-M------------------%-------------------------------%----------------------------------%-------%--S-%----o----------------------------------------------------%----X-
-X--S----o----------|--------------------%----%--------------------%-----------------------%---------%----o-------------%---------------%-%---------------%---|----X-
-X------------------|--------------------|----|-------------------------------X---------X------------|-------------XX---|-----------------|---------------|---|----X-
