--------------------------------------------------------------------------------------------------------------------------------------------------------------
--S---------------------S-oS---S-----S--S-S--S---------S-S----------S-S---S----------S--------S--------------S-S----S---S-SS---@Q-------------S-----S--S------
S--S-----------S-------------------------o-----------SS-----S----S-------------S-------S-------------S-----S-S----------S---------S----------------S----------
S--S-----S-------SSS----------S---S---------------------S---S-S---------------o------------------U-------SS---S----------o-----S-S-----S----S--S----SS-o------
---SS------S----------------S----S--------S--------S--o----S------S-------------------S--------------S-S-S----------S-S---------S-------------------S-S---U---
S--------------------S--S------------S---S----------SS----------S--S------S----------------------S---------SS----o--S----U-----SS----------------S-S--------o-
-----SSS----------------------------------S---S-----------S--S----S-----SS---------------------S------SS-------------S------SS--------------------------SS----
---------S------------SSS-----S-S-S-S---------------o---S----------S---------S-SS-----------------S--------S----S----S-------------------------------S--------
-S----------S--S----------S---S-----S------------------S--------S-----S-----------------S--------------S--------SS---------S---S--S---------------------------
-S---------S--S--S---S----------S-----@Q----S------S-----S---------S--------S-------SS-----------------------S-----S-S-S-S-SS-S-----S------------S-S---SS-S---
---------S----S-----------S--S------S----S----S--------------S----S---S-------------S---S-S---S----U---S----------------S----S-SSS-----------S-----------SS---
-----S-S---g----S--------S-----o----S-----------------S------------S----------S----S-----S----------------------S---o------------S----------S---SS-----S------
-----------S--------------S--S---S--------S---------S-------S-S---S---S--------------------S-----SS--------S-----S---S---------------S---S------S--S----------
---M---o------------------S--S----S---------------------------------------------S----------S------------S--------------------S----------S---SS-------S----S-F-
---X-----S------S-----S--S---S----------S---C-------S-S-------S-S-S------o-------------------------S-S-SS----S-------S-S----SS-----------------X------------X-
--XX----------X----X--XXX--X-----------------X---X---X-----X--------XX---------X-------------------X---X--------X------------------X-----------X------------X-
