------------------------------------------------------------------------------------------------------------------------------------------------------
--S--%------%-%-------------------%-----------------%---------------%-------------------o--------------U-------%---%-----%---------------------%------
-----------------------o-------%---------------------o---------------------------------------%----------%%-----------------------------%-----S--------
----------------------%-------------%------------%--------------------------------%---------S-------------------------------------------%-%-----------
-------------%------------o---%-%--------------%------------------------------------------------------------o----------------------%------------%--%--
--------------%-------------------------S-----%------------o-----%-------%-%----------------o-----------o------------o-------%------------------------
------o---%--------%---o-------S-----------------------%----------%---------------------%-------------------------------------%-----------------------
---------------------------------%----------------o----------------o-------------------------------------%--------------------------------------------
------------------o-----------------o----------------%------g-------o---------------------------------------------------------------------------------
---------o-------------------o--%----S----------------------%--------------------------o------------------------------------------%-------%-----------
------------------o------------------------------------------------------%---------------------------%------------------------------%%---%------------
-%--------------------------%---------S---------------------------S---S--------------%------%---%------------------%-S-----------------------%--%-----
---------------%--%--%--%-------%---------------------%-----%----------------------o----o--------%-------------S-----------------------------------F--
--M----------------------------------%---------S------|--------------------------------%--%-------%--------------------o------S-------------%------#--
--X---%----------------S----%---------S--%----o-------%---%----------%----------%----------%---%---%----%--------#--%--------%----%-%------%-%-----X--
--X------X------------------|-----------------------------|----------|----------|----------|-X-|---|----|--------X--|--------|-X----|----X-|-|-----X--
