------------------------------------------------------------------------------------------------------------------------------------------------------
---%---------------------------------------%-------------------------%---------------------------%------------------------%------------%--------------
-o-----S------%-----------------------S-------%-----------------------------%---%------------------o-------------------o------------------------------
-----------%------------%-%-%-S-------------------------------------o------------------------------------------------------------%%-------------------
------%---------------------------%------------------o-------%-%------%---%------------%------------------------R------------------------S-%----------
-----------------------------------U-------%----o-------------------------------S---------------%-------------------%--------%--------%---------------
-----%--------------o--S------------------%----------------------------------------%---------------------------------------%----------------%---------
--------------------%-------o-------------|-%-------------------------S------------------------o--------o--S-----o--------S------%---------%----------
--------------------------------%---------|-----------------------------------%---%---------------o----------------------------o------%--------R------
----------------------------------%%------|-----%--------%-------o----------------------%----%-----------S--%--%--------------------------------------
-------------%-------S-----------------%--%----------------------------------------------------------------------------%--U--------------%-----%------
--------o---%----o---------------%---------------------S------%--------------------------S-----------%------------------------------------------------
---------------%------------------%-------%---------%%----------------%----------------------------------------------------%-%-----%-%-------------F--
--M--------------------------------------------------|---------------------S-----------------------------------%%-----------S----------------------#--
--X---%--R------o---%--------------------%-----------%-%---%-------%-----%-------------o-------------------%-%--|----%-----------%%--%----%----X---X--
--X---|-------------|--------------------|--------X----|-X-|-------|-----|-------XX------------------------|-|--|----|-----------|---|----|----XX--X--
