--------------------------------------------------------------------------------------------------------------------------------------------------------------
----------------------------S--S-S--S----------S----------------------S----S-S------S---S-----------S---------S---S--------S------------SS-----S-S--------S---
--S--------------------------S----S-------o-------S----------@Q-S-----------S-------------S--------S----S---------S-----S----SSSS-S--SSS----------------SS-S--
--------------------S----S-S--------SS---S------S----------SS-------S-----S--------S--------S----SS------------------------------S------------S-----------S---
-------S---S-----SS-----S-S-------S----S------------------o------S-S-------------S-------C---S----------------S---SSSoS----------------------------SS---------
---------S-------S---------S--S----S------------------SS-----S------------------------S---g---S---------------S------------------S-------S-S------S---o-------
-S--S---S------g----S-----S-------------S-S-----S--------S-----------S--S-S-----S-S-----S-S-----S----------S----o----S------------S-------S------S---S-SS-----
----SSS--------S--------S-S---S--SS-----------------S-S-S-S-------S-----------------------S---------o---S-S-S----S-------So---------@Q-----------S----S---S---
----S--------S-------------------S---S---SS-S-------------S---------SS---S--------S---------S------------S---------S-S-------------------S----------o--SS--S--
----------------------------S------------------S-----SS-------S--------S-----------------------SSS--S-----S------S----------------------------o--S-------S----
-------S-------SS----------------------------------S-S-------------------S------S-----SSS----------------------------U------------------------------S-----S---
-----o---------S--------S------S-------S----------------------@Q------S----------o----S--S--------------S----S----S-------S-S---------------S-----SSS----S----
--------S-S-------------S----------S-----SSS-------SS----S--------S------------S--SSS------------S------S----------S-----S--S--------S----------S---S---------
-S-M----------------S-S----S-o-------------S--------S----S-S--------S------------S----S----------S-------S-SLS----S-------------------------------S----S----F-
S--X-------------S----S---S-S----------SSU--X--------------S----------S-S------S---------S------------X--------------X----S--------S--S--S-S----------------X-
---X--X--X----X--X-------XX-X---X----XX----XX-------X---XX--X-X----X-X-------------------------X-X----X-----X--X---X-X-----------X-------------------------XX-
