----------------------------------------------------------------------------------------------------------------------------------------------------------------------------------------
------#-------#-------------#---------##--#-------------#--#-----------------Q----------------------------------#-----------------------------#----o-----#-#-#-------------#-------#----
----------------#------------------------y#--------SC-#----------------------------#---#----S---#----------#--#----------------------------------o------#-#-------------#-----#---------
---------#---#--#-#------------------#--y#-----#-----------------------------#-#--------#------------------------------#------------#---------------------#-----------------#------#----
----##------o-----#---------------------#-----------US-------------------S------------------Q---------#------S------#--#------------------------#--------#--------------#-----#---------
---------------------------------#----#---------------------#-----------------------------#------#-------------------------------------------#------#-----------------------------------
-#------------------------------------------------#--o--#-------------------#----------------#-------------------S---------------------------------------#-----------#------------------
-----------------#---#-#---------------------------------------------#--#------------------------------------#--------------S----------------#--------------------S-------------------#-
----------------------#----------------------#--------------------------------------------------#-#----#-------#------------------#-----------------------------------------------------
----------#----#---------------------------#--2--#------------------#--#------------------------------------------------#-------------------------#---#--#-----#-----------#---------#--
-------------------------------------------------------------------------S------------------------------------------------------------#-----------------------#------------------#--#---
---o---------------------------------#----------------S-----------#------------#S----------------#------#---------#-----------------------------o----Q-------------##---------#---------
------------------------------------------#----------S---------------------#--------------------------#---##-S------------------------------------------------#----------2----------F---
----M----#--o-------##------Q-----------------S--#-----------------o----------------------------------#----------------------------------------#-------------#-------------------S--#---
--#-X--------------------------------#---------------#----------------------------#-----#-----------------S----------------X--------o----------------#--#-X------#-------#--------------
----X----X----------------X----X-----------X-------XX-X----------X---X---------X--X-----------X----------------------------X--X----X---------------X------XX-------------X------------X-
