------------------------------------------------------------------------------------------------------------------------------------------------------
----------------------------------S---------------------------------------%-------%------------------------------------------------o------------------
------%--------------------------------------------------------------------------------o----------%-----------------%%--------------------%-----------
--%----------------------------------%---------------------------%------S--%-----------------------%----%-------------------------------------S-------
----------%-----------%--------------------------------------g----------------------%------%-----------------%%----------------------------o----------
---S-------------------%---------------%--------%------o-----%----%%--------------------------------------------------------------%-------------------
------------------%---------------------------o-|------------|------%----------------------------o---------------------------------S------------------
-------------------------%------------S---------|------------%-----------------------------------------------------------------------------o-------%--
--%----%--------%---------%--------%%-----------%-----------------------o------------------%-%---%------%-------------------------------%------%------
---R-----------------S--------%------%------%-------%---%----%------------------------S----|----------------------------------------------------------
-------o------------------------%-----------------------|--------------------------%-%-----%--------------%----------%-%------------------------------
--------------------------------------------------------%---------------------------------------%--------------------------------%------------------o-
--------------------------------------------%-----------|------%-----------------------------------%-----------------------------------------------F--
-M--------------------%---------------------|-----------%---------%-------------------o-----------------------------%------------------------------#--
-X----%--------%----------%-------%--%%-%---%-----%%--------%--------%%-----%--------------%---------%--%---------------------%--------------------X--
-X----|---X----|----------|-----------|-|-------------------|--------|---------------------|-X-------|--|------------------------------------------X--
