-------------------------------------------------------------------------------------------------------------------------------------------------------------------------------------------
----------S-------S----------------SS-SS-U-----S-S---S--S------S--S-------S---------S----S----S--S---S----S---------S--S-----S---------S--S--------SS--S-S--------SS------------S------S--S
------------SSS------SS-----S--------S----------S-----------S------S--S-------------S------------SS--S-S----S---SS-SS--------S-------------SS------SS-------------S-S--------S--S--S-------
----------S-----SS-----S-SS------S-S-----S------S--S--SCS-------SS-----g----------S---S---S-SSS-----------------------------SS------SS-------S----S--------SS-S-S-S-----S------------S-----
--------------------S----S--S--S-SS--------S---S--SS-----S-S-SS--S--S--S---S?------------SS---SS---------------S-----S-----SS------S-------S--S------S-S-S----------Q----------------------
S--S---SS---S--S-----Q----------S-------S--S-----2-S---S--S---------S---------S-S------SS-----------------------S----S-------------------------SS---------S--S--------S--S-S---SS----------
-S---------S-SS-SS-S--------------S-------SS---------------S---------S---S--SS-----S----S---S-----------S--S----S------S---S-------------S------S-----S---SS--S----------SSS------------S--
---------S------S--S------S--S-------------SSS-----------------SS--S----S----------S------------S--S--S---S-oS----SS--S-----S------------------S-SS-------S-------S--------SS-------S--S---
-SSS---S---S-----S---SS----Q-S---SS--SS-SS--S-S----S-S--S---------------S---Q-S-----S-------S---------------S-S----------S---SS-SS-----S-S------S--S---S-S----S-----S--S--------SS-S-S---S-
-------S--S--S-------S--S----SSS-S-----------S--------------S-----SSS-S--S---------S--S-S---S-----S-SS----------------------S------S---S-S---S-------------SS----SS-S--S-------------S-S-S-
-----S---S--S----S-----------------SSS--S------S--------------S----SS---------SS-SS--S--S----S---------S-S-S----------------S--------S---------o--------S------S-SS-----S--------S------S-F
----S----S---------S----S-----S-S---------------------S-------SS---S-----S------S-----------S-----------S----S-------------Q-----SS---S------S-S---------------------------S--------S-----S
------------S--------S---S---------S---------------------SS---S----S---S---------SSU---S-S-------S---S--S-------S--2--------------S--SS--------S---------S---S--S-------------------S------
S-M-------U-----S-----S---------S---------SS----S-----------S-S--S--------------S------------S--S----S-----S-S----------------S--------S-S--------------------------------S-S------SS---Q--
--X--T----------------SSSS-----S-------S----SS-----------S-----S-------------SS------S--S----S-----S-----SS-------------S--S-------Q------S----S------------S---S---SS-----S--S-----------S
X-X--X--X-------X-----------XX-X-----------------X--X------XX-X-----------X--------X----X---------X---------X-X-XX------X----X-----------X---X---------X--------X--X----X------X----XX-----
