----------------------------------------------------------------------------------------------------------------------------------------------------------------------------------------
---------#-------------------------------------------#--------------------#----------------------------------#---------------------#----------##-----------------#----S-----------------
-----------#--------#------------------#---------------#----------------------------------------------------#-------#---------#-#-#----#-----------------#-----------------------S-#----
-------------------------#-------o----------#-------------#----------------------#----#---------------#----#-----------S----------------------------------------------------------------
----#---#-----------------------------#----##-----#-----#---------------------#-------------------------#-----------------------------------------------------------------##------------
---------------------------#-----------------------S------#-----------o----------------------------------#-----------#---------#-----------------#-------S-------#----------------------
-#----------#-----------------------------------#----------------#----------------------------#----------------------------#------y-----------------S-----------------------------------
---------S---------------------------#----------#-----------#-------------------------------##--------S--y#-----------------------#----#----------------------o------#------------------
--------#--------------------#-----#----#----------------------------------------------------------------#--------------#-----#------------------S-----------------------------o--------
--#------o--------------#-----------------------------#----------------------------------------------------#------#------o--#--#------#-------#-----------------#-----------#-----------
-------------------------------------------#---------------------#------------------#---------S-------#-------S---------------------------------#-------------------------------------#-
---------------------o---#------------2---------------#----------------------#--#-------#------------#--------------#----------------------------------------2------------#---SC--------
---o----------------#------------------------S--------------------#-S------------------------------#---------------------S---#-#------------#-----------------------#-#----------S--F---
--2-M--------#----#-------------#--#----------?Q----#-----------------------------o-----o---------------------#--------S----#-----S---#--------------#----#-#-----------------------##--
----X--o------------#---------o--#------------------------------##-------2-------------------y#---------------#----#----#------------------------#-----------------------------------X--
----X-----------------------------X--------X-----X----------X--X--------X--------------------X----------------XX--------X-------X---------------------X-XX--X-X--XXX----------------XX--
