----------------------------------------------------------------------------------------------------------------------------------------------------------------------------------------------------
------------------------------------#---------------------------S-----#-#---------------------------------------------#-----------------------#--------#----#---------------------------------------
----S------------S------------------------------#----------------K------------------#-----------------S---------Q-------#-------S-------------------S---------------------------------------------S-
-------------------------------------------------#-S---------S-------------#-------------------#--#------#-#---------------------#--------------K---------------------------------------------------
--------------------------------------#------##----------------k#-------------------S---------------------#----Q-----#--------------------SC-------#------------#-----------------------------------
------------------#--------------------------------S-----------#-------------------S--------------#-----------------------------------------#---------?---------------------------S--------#--------
-#-#------#------------Q-----------S--------#--------------#----------Q----------------------------------------------------?---------------------K-#-----?-------------S----------------?---#-------
-------------S-------------S-----------------------------------------------------?--------------#-----------------------------------------#----------------------S-------------#-------------S------
--#--------S--------------------------#-#-------------#-#---#---------------------------S----#---------------#-----------#------------------------------------------------------------------#-------
----#-------#---#---------------------------------------#--#-----------------------------------#-------K----------------#--------------------------#------------------K------------------Q--##------
-----------------------------##---#----S-------#---------S------------Q--------#------------------------------S-----#-------------------------------#-----------#----S--------------------------K-#-
-----------------------K----?------------S---------------------------------------#-------#----------K-------------------------------------------?-S-------------------------------#-----------------
-------#--S-#------------------Q----------------------------------S----------------------------#-----------------------------#-------------------------------------------#----------------#--#---F--
-M---------------------------#------------#----------------------------#-----------#------------------------------------#----------#----#---------X-------------Q-------------------S------------#--
-X--------#---------------------------------------------------------------------S------------X-------------------S--------S--------X-#------------X----#-----S-----------S--------------------------
-X-X----X------X------------------------X-------X--X----XX---------------X-----X--------X-X--X---------------X----------X--X----X-XX-----------X--X---X---------X--------------------------X--------
