---------------------------------------------------------------------------------------------------------------------------------------------------------------------
--%----------o------------%------------%-------S-----S------------------------%----%---%--------%----------S------------%--------------------------------------------
--|------------------%--------------------o---------%---%--------------------S-----------?----------------------------S--------------%-------%-----------------------
--%----------------------%-----------------------------------------o---%----------S---------%----------------------%--------%----------------------------------------
------------------------%-------------------%%----------------?------------------o----------------%---------------------------%--o--%---------%-%-----------o--------
---------o----%-------------%%---------------------%----%-----------------------------------o----------S----So-%---o-----------------------S--|----------------------
-%-------%-----S--------%---|-----------------------------------------------------------------------------------------o--%---------%----------%---S---S------%-------
---S------------------------%------------------------S----%--------%-----------S----%-S-o----------%--------S-------%------%------%----------------------------%-----
--------------------------------o-------------------S---%-------%-------------------|---------------------------------%%--------------------------------------%------
------------------------------------------------------------------------%-----------%----S--------------------------S------------------------------------------------
-----o-----S-------%-------S-------------------------%--------o----%--%-------------------o--------------------------------------------------------------------------
--S-------------------------------------------------------%-----%--------------------%--------S-------------------%---S-------------------%--So--S---%---%-%---------
--------------------------------------------------------------------------------------------%--------------o-----S-%-----------------%---------%-------------S-----F-
-M----------%----------%--------%------------------------------------------------S---%---------%-------S--------------------%---------S---%------------------------X-
-X---%-----------S-------%---------S------------%--%%-----------%---%--------%----------%---------%--%%-------------------%----------%--------------%--------S-----X-
-X---|-------------------|-------X-----------------||-X---------|---|-------------------|------------||-----------------------------X-X-------------|--------------X-
