---------------------------------------------------------------------------------------------------------------------------------------------------------------------
---------------%-----------%------%---------------------------------S-----%----%------------------------------%-%-------------------------------?------------%-------
-----------S--------%----------------------S---------S---------------------------%----------------------------|%-------------%---%--o---------------%-------o--------
-------------o-------------------------------%-----------------------%------------------S------------------%--%------%%-----------------------------------%----------
-------------S-------------------%-------------%---o------------------------%-------o------o--------S-------%---------------------------------------------------%----
--%--%--------S------------------|---%--S-------------------------------%---|--------S----------------------------------o--------------------------------------------
-%----------%--S-----------------%-----S-S--%--------o------------------|---%--o-----------S-----------------------------%------------------------------------o------
------------------------------------------%------------%----------%-%-%-%----------------------%--S----------------------------%---%----------------------o----------
-%----------------S------------%----%------------S----------S--------------------------------------------------------------------------------------oo------------%---
----------%---------------S------------------------------------------------------%-----------S-----------S--S--------------------o------------------%-o-------S------
----%-----------%-----------------------%----------%---------o-S-----S----------------------------%------------------------------------S-%-----------------o---------
--------------------------S--------------------%-------%------------o---------S--o--------------S--------------------------------------------%------------%----------
--------%------------o-----------------------%-------------------------%--------------------------------------?-------%----------------%---------%-S---------------F-
-M-----------------------------------------------------------%------S----------------------%--%---%---------------------------------------------------%------------X-
-X--------%-%---S---%----%-------%------------------%-------------------%--%--------%-----------------%--------o--%-%--%-%-------%%---%-------------------S----%---X-
-X--------|-|-------|----|--------------------------|---X------------------|--------|-----------------|---------X---|------------||---|----X-----------------------X-
