-------------------------------------------------------------------------------------------------------------------------------------------------------------------------------------------
---S------------------------S-S-----S----S--S----S---------S-S---------------SS-------S-----------------------S---------S------------S-----S-------S--S---------SS---S--------SS--S-S----S-
---S-S-S--------Q--------S-------SS---S--------Q---------US--SS---SSS--S-------------------SS---S--S----------S---------S----S-S-------------S---------SS----S-------------------S------S--
---S----S-----S--------S--Q-SS---S-----------S-----------------S----S---------------------S-------S------------------S-------------------S-S-----------S--------------S--------SS-S--------
----Q-S------S-S------S---------S-------S------------o--S--S--S-----S-S---S-------S---S--------------------S------S---S-------------------S-----S--------------------------S----S--------S-
--S-----------SS-SS--S----SS--SS----S------------S--SS----S-S----------------SS-----S------S---------SSSS---------S-SS---SS----------S-SS-S--------------S-S---S----S----S-----S-S-S-S-----
---S------------S--S--S-------SS-------S-------------S-S-------------------------S--------S-S--SUS-----S------SS-S-------S----SS------S----------SS---S--S-S-------------------------S--S--
SSS------------S----SS---------SS--S----------S---SS----SS-------------------S--S-------S-S-S-Q--S------S-------------S---S-----------S----------------S---------S----------S---S--------S-
-S-S-S-S------S-----SS----S---S---------S---S-----SS---S-----S----------S-----S--SS------------------S-------S-S---S---S-S----S------SS--SS------S----S-----------------------SS----------S
----------------------------------S--S--------S--------S---S-SS-----------------------------------------S----S--S-------S-S-------S-----------S-S----S---S-----------------S---------------
-----S------SS-S--S-S----S-------S---SS-------------------S----SS-------S------S---S------S-S-----S--S-S--------SS---S----S----SS-SS--S---S--------S-SS---S----------------------S-S------F
------S-----------------------------------S------------SSSS--------------------S-S---S---S---S-SS-S--S----Q---S-----------S-S--S-----------------S---S---S-----S--S---------S----S-S?-----S
---S--S--SS-------------------------S--S-------------------S----S-S-S---SS-----SS----S---S-SS------SS--------------S---S---------SSS-------S--S-------------------S----S-----S--------Q----
--M------S---S-----SSSS-----S--------------------S--S-----------S-S-----------S---------S-----S--------------------SSSSS----------------------------------------------------SS-S-----S-----
S-XX---S-S----SS-S---S-------------Q-S------------------SS-----S------SSSS-S---------SS-------S---S-SS-------------------------SS-----------S-----------------------------X--S-------S-----
--XX-------------------X----X-----X--X--------------------X--X----X-----X-X---X-----X----------X------X--------------------------------XX------------X------------X-------X--X-------------
