-------------------------------------------------------------------------------------------------------------------------------------------------------------------------------------------
--S-------SS-------S-----------S--S-------S-----S--S--------S--S-----S--------Q--SS-S-S-----S-----------S---S-S----SS-S-------S----S-----S----------SSS--S-------S----------S--------------
---S----S-S----S---S------------S---S-----S-----SS---------S-SS--------------Q-S------S------S-----------SS-----S-------S----------------S------S--------S-----S----------S--S--S--SS-S----
-S----S--S-----S--S-----S-S--------S----S-------S---S----S--SSS--S-----S---S---S---S---S------SS-S------S---------S--S---S----S---S---S-----US-S-SS-S-----------S--SU-S--------SS----------
S------SS-------SS----S-S-------SSS-S---S---S---S-------------S------S---S--------------S--S--S----------SS--------S--S-S-S---S----SS--S------S-------------S----S-S---S-------------S--S--
---S--------S---------S-----S----S--S------SS--S-S---S----------SS-----S-SS-----------S---S--------S--------S--------------S-SS-S---S----S-S---S-------------S-----------SS-SS----Q--------
--------SS---S-----S---S-S----S-S-----S-S---S----S--S----S-S--o---S-----S------S--S-----S-S----S---S----2----------S----------------------S-S--S----S----S------SS--S-SS------------S------
-------S---------------------S-S---SSS--------S-S----------S--S----S-----------S------------SS-S------------S-S----S--S-----S-----S----S--S------S-S--S---S--S------SS----------S-S-S------
---------S-----S--S------SS-----S-----SS-S-S--------------------S-------S---S-S----U-----S-S--------------S------------SS---------------------S------SSS-S------S--S-SS--S-S--------------S
S---SS-S---S--SS------------SSS-----------SSS-S------S------SS---------S----------------------S--S-S----------S-------------S-SSS--S---S---------S------SS----------S----SS------------S---
------S-------S-S--S--SS-SS---------S-SS----S--S--S---SS-----------------SS-S--------------S--------S---------------------------S----SS----S----S--S-----S------S-S--------S-S------------F
S-----S--S--S----------------SS--S-S-S---S--------S--S------------SS--S--------SS--S----SS-SS---S----S----------------S--S-S-S----S--------S----S-S---------SS--S-----S------SSSS---S-----S
S---SS---SS-----------SS----------------S---------------------S---S--S--S---S-------S-S-----S-S---------S-----------------S---------S-S---S----S---S-S--------SSS------S-S----S-S--Q-------
--M--S-------------S----S---SSS-----S-S----S---SS-------o-S----S-----S--S-----SSS-S--S----S---------S-S--------S-S-SS---S----------------------------S------S---------------------S-----S--
--X-------------S-S----------S-----S---S-SS-------SS--S-S-S---S--S--S----S------------S----------X----S---------SS--------------S-S--S--------Q-S--------SS--------S----S--Q---------------
--X--X--X-X------X-----X--X------------------------------------X-----X--X-------------X---------XX----------------X-------------------X-----------X--------X-------------------X-----------
