----------------------------------------------------------------------------------------------------------------------------------------------------------------------------------------------------
----------#------#-#-#-------------------------------------------------#------#-----#-----------------------------#----------------------------------------------#---------------#------------#-#---
------------------#-----S-----##-----S------------#-----------------------------------------------------#-----S------------------------#-------#---------------------------------#------------------
------------#--------------------------#-----#-S-------#-----------------------#-------------S-#--#--------------------#---------#----------------#----------------#---------#----------------------
---------------S-------------?----------------#-------------------------#--------Q----------------------#-------------------------------------------#--------#-#-------------#---------------##-----
----------------------##-----------------------------------#-----S-----------?-------------------S-----------------##--#---S-S-k-----------------------------------S--------------------------------
-----------#----------------------------#------------------------------------------------------------#-------------------------#-------------------S-----S------------------------------------------
-------------------S---------------#-------------------#-----#-------------K------------1---------------------------#-----------------------------#----#--------#--#----------#--#------------------
----#----------------#----------------------------------------------------------------------------------------------------#------------#-#-----#--------------------------------#---------#---------
---------------------#----------------------------#------#------------------------#-------------SC----------------------------------------------------S-----#----K--S---------------------#--S------
------------S--------------------------------------S---------------#-----S------------Q--------------?--S-------------#-------------------------------------------------------------------------S-#-
-----##--S-------------#-#---------------K-------------------------------------#--------------------------#------------------------S--------S---------------------S------------SC-------------------
------#---------------#---------------------#---#------------S-------------------------------------------------------------#-------------------------------------#--#----------------------------F-X
-M------#-----------------------------------------------------------K-S----#-------------#-----------------------------#-------#---------------------------------#-#-#-#-----------S-------------#-X
-X-----------------------------------#--------------------------------------#----X---------------------------#-S---?--#--#-------S--#-----#----#---------------------------------------------------X
-X-X---------XX-----------------X-X----XX----X----XX-------X---------------X---X-X---------X-------------------------------X---X----X----X----------------X-X---X--------------X------------X------X
