----------------------------------------------------------------------------------------------------------------------------------------------------------------------------------------
-------------------------------------------S---#-##---------------------------#---------------------------------------------------------------------------------#-##--------------------
-------US-----------------------------------------#-----#----------#--------------#-y----------------------------------#-------------------------------------------------#--------------
----------------S-------------------#----o---------------------#--------------------#-----------------------------------o-------------o------------------------#-----#----------------#-
---------#------------------------#-----------o----------#------------------------------#---------------o-----------#------------------------S------------------------------------------
-----------------------------------------#---S----o-------------------------------------#--#-------#-------------#----------------#---------#------------------#----------------------#-
-------------#------------------#-#-------------------Q---#----------------------------y------------------------------------------------------------------#----------------#------------
------#-----------------#---------##----#--------------------------------------------o-#------------#--o-------#--------------------Q-------------------------------S--#----------------
-----------------SC-----------------##-----------#----------------------------------------##----------------#------o-S------------------------------Q----#-----------------#------------
-------------------S----------------------S-#-----------------#---------------------------------------------##-----------------------------------------#--------------------------------
---------------------------#------#-------------------#-------------------------#------------------#-------------------------o---------------------------------------------------#-o-##-
---------o--------------#-----------------------------------------#---#----------------------------------------------#-----------------------#---------------------S----#-----#---------
--S----------#-S---#--#--#--------#------------#------#------o--#-------##--------------------Q------------##-----------------------#-----------o--------#----#------------#--------F---
----M----------------S-----#---------#-----------------------------#------------##-o--------Q------#---#--------#-----#-#-------------------------------------#-#-o-----------#-----#---
----X---------------------------#--------------------#---------------------#-----#-----S---#-#-------------#-----------------------#-----------S---------------S------------------------
----X-------------------------X----------X-X----X---------X--XX---X-------------X---------------------X-------------------------------X-----------------X-X---------X-----------------X-
