--------------------------------------------------------------------------------------------------------------------------------------------------------------------------------
------------------------------------------------------------------------------------------------------------------------------------------------Q------------S-#----------#---#-
------------------#------K-------------------------------------#---------------#---#----------------------------------------------------------------------S---#--S--------------
-----#-------------K----------#-------------------------------S---------------------------------------------#-------------------------------------------------------------------
--#---------------------------------------------------------------#---------------------------------------------------------------------S----------S----------------------------
---S----#-----S------------------K------------------------------S--------S-----#------------------------------------------------------------------K-----------------------------
-----------#---------------K-----S------------------------#-----------------------------------------------K------#-------------##-----------#---------------------------#-----S-
--#-----#---#-------#-----------------S------------#---------------#------------U--------#---#--#------------------------#-----------K---#-------------------#------------------
----------------------------------S-----------#--------------------#-----S--------------------#----------------------------------------#----------------------Q-------------#---
-------------------------#--S---------------------------#-----------S----------------------------------------------------------B-------------------------S----------------------
----------------------------------K------------K------------------------------------#--------------------------#---------------b------------------------------#-----------------
-------------------------------------------#-------------------#-----------------------------#-----K---------------S-----------#----------------------S-------------------------
---------------------------------------#------#-------------------------------------------S---------------------------S---------------------#---#---------------------------F---
-M----------------------U--#----------##-----------------------------S---------#---S--S-------------------------------------------------#------#------------------#-S#--#---#---
-X-------X----------------X-----------------##------#----------------------------K----------------------X------X-------------------S--------------------------S-#-#-------------
-X-------X----------------XX-X------------X-----------------X-----------------X--------X---------------XX--X---X------------X-----X------------X----XX--X--X------X-X--X--------
