-----------------------------------------------------------------------------------------------------------------------------------------------------
----%-%------%------------------------%------------------------------o----%---------------------------o-------------%---------------------%----------
---------------%----%-S--------------------S---------------------------S--------------------%----------------------%-----------------S------%%--o----
-------%----%----%-----------------%-S-%---------------------%--------%-S--%-------------------%%--%------%--%--------------------------S----------%-
--%----------o---------%-----------------------S-----------------------%--------------------S------|----%-------------------?--o-----------%---------
-----------------%------------------------%--------------%-----------------%-------------o---------%------------%--%---------%----------S------------
----R------------|-----%-r----------------------------------------------------%-%----%------------%----S-------------------%--%------------S---------
-----%-----------%-------%---------------------?-------------------------S---------------%-----o--------------------------------------%---%--%-------
-----------------------%%------------------------%-------S-------------%------------%------------------S---------%------------------------------S----
-----------%---------o-------------%---%------------------%-%--------------S-----------%%-------%----%----------------------------------%------------
----%--------%-------------o--------o------------------%----|----------%-------------%--|--------%-%--%---S-------------------------------------%-%--
---S------------%----------------------------S--------------%------------S--S-----------%%--o---------|-%---S-----%----%-------------------------%---
-----------%---------%------o------------%------------%--------------------------------------S--------%%-----------%-------------------------------F-
-M--%-%----------------S--------------S-%-------%-----------%------------------%---------%---------------------------------------o-----------------#-
-X-S------%---%--%-%%------%-----%----------%-------%---%-----%-%--%-----------|--%-----------------%-%%----%-%--------%---------%--SS--%-%-%-%----X-
-X------------|----|-------|-----|----------------------|-----|----------------|--|-----------------|-||----|----------|----------------|-|--------XX
