----------------------------------------------------------------------------------------------------------------------------------------------------------------------------------------------------
----------------------------K----------------------------------S-----S-----------------#---#-S----##-------------------S-----------------------------------#----------------------------------------
---------1----------------S----------------------------Q----------#----------------------#-#-----------------------------------------------------------------------------#---------#---S---K--------
--S------------------S--------#------------#----------------------------------------------------------S---------------------------#------#-K----------------------------------#-----------#--##-----
-----------------------------------------------------------------------------S---------------#-------#---#-----------------------------------------------S---------S-----------------------S--------
------------------#-----#---#---------#---------S------#--#--#--##----------S-----------------#------------------S-----#------------------S----Q--------S---------K-------------#---#---------------
-----------S-----------------------------#--------#--#-------#-----------------#--------#---#------------------Q----#------------------S------------------------------S-----------------#-----------
------------------------------S-------------------------------------------------------------------#--#-----g------------------#-------------------------------Q----------------------#-------#------
--------------------------------------------------#---#---------#-S---------------------#------------------#--#--#------#--------S---------------------------S----------------#---------------------
---------#------#--------------------------------------------------##----------------------S--1--------------------------------------------------------S----------------------------------#-#-------
--------------------------#--------------#--#----------#-----------------S-----------------------------------------S-----------------------------------------------------#--------------------------
------#--------------------------------------------------------------------------------#--------------------------#--------------------------------------#---------K-----------S--------------------
----#--------------------------------------------------------------#-------#--------------------------------------------##---#---#------------------------#--------------------------------k-----F--
-M----#---------------------------------------------S----Q--------------------#--------Q---------------------------#----#------------#--------------#----------------#----#-------#--------S-----#--
-X-X-------------------------------------------------#----------------S-----------------------X--------T----S----------------------------#-----##---#--------#--------------#--K-----------------#--
-X-X---X-----X---X------------------------------------X-------------X---X---------------------X--------X-X--------------------------------XX-X-X----X-X--X------X------------------X----------------
