-------------------------------------------------------------------------------------------------------------------------------------------------------------------------------------------
------S------S--------S-----------SS-------S------------S-----SS---S---S--------S-S--SS---S------------S--S---------------------S------S----SSS---S--------SS---S--S-------S------SSSS---Q-
---2--------------S---------S--------S-S-----------S-----S-SS--S-S-----S--S----S------S-----S-------S------S-------CS---S--S-----------S------S--S----S------S-------S---S----------S--S---
------------S---S---S-S-S-------S------S---------------S-----S---S----SS--------S----------S----S--S---S--S-S--SS-----S-S--------S------------------S---------S----S-----S-----------S-----
-----S-S----S-----S----S--S-----S------S--S-SS---------S---S-SS-SS-------------S-S-S-------S-S-----------------S-----S-S--S---S---S-----------S----------------S------------S---S-S----S---
S------SS-----S----S--SSSS---S-----S--------S-CS-------S----S-----------S---S--------S--SS-----S----S---------SS-S-------------S---S------SSS--S---S--------------------------------------S
-----------S-------SSS-------S--S------------S-------S----S--SS-S-----S-----------------S--S----S--S------------S-------S-------S---S---S-SSS---o---S------------------S----S--------SS----
----S-S--------S--S--S-S-S-S----S---S-----S-SS-----SS------S---S-----------S-----S-S-------SS-----S-S---S---------------------------SS--S-----S-SS-----S--S-S----S---S------S-----S--------
-----------S-S-S-SS-S----------S------S-------------------S------SS--S------------------------------SS---------SS--S-S--------------------S-----S---S-S--S---S-----------------------S-S---
--S---S-----S--------o-SS---S---S-------S----S---S-------S--S----S--------S--------SSS-S--S----o----S--------S-------------S----S------S---------S--SS-S-----S----S----SS------------------
----S-SS-----S-S----SS----S--------------S------S-SS--o--S-----------SS--------S-S-------------SSS---S------S-------------S----------S-S-S-----------S----S-S-----------------S--------Q--F
----S---------S-SS-S----S--------------------------S--S-S--S-----------------S-----------------------------S---S--SS--S-S-----S-S--S----S----S--------S----S--S-S------------S--S---------S
---------------------S-------S-S----S---------S-------------S-S-S--------S-S-S---S-----SS------S--S-----S---------S---------S--------S----------S-S----S-2--------------S------S---S------S
--M----S----------S--------S-----S-S-oS---S--S---------S----------------S---------SS----S------S-------S------S-S--S-S------S-S-----------S-SS---S----S---SS---------------S----o---S--S-S-
-XX---S----------------S---------S-SSSS---S------S----S-------X---S-S----S-SS----S-S-U----------------SS--S----------S---------X-S-----------S--S------S-----------S----S-------SS-----S---
-XX----X---------------X----------------X---------------X-----X-------------XX---X--------------------------------X----X--X----X-X---X----------------X--X--------XX---X-------------------
