----------------------------------------------------------------------------------------------------------------------------------------------------------------------------------------------------------
-----------X-------%----------------------#---o--------------------X----------------#---X-----------X---------XS------------%--X-X-----XXS--o---------------------#-----------------#--K------------------
-X------XX-----#-%--S----#--------SX---X---K-----X---------------X--#---SXX-----X-#--------X------------S---X------------------------X--------------%----------X--#----X-------------------X----XXX-#S----
---------------X-----#--------#---S-----X-S--T-------X--%------X--------------XX------%-----X----S----X---------X--------------X----%-----#----------#----X-----K------X---------------X-----%------------
---SX---X-S---#-------X-------#------C-------X-X------------T#-----------#---S---X---#-----------S--XS---------o-------X----XX---------------X-----S----Q------X--SX--------o-----------------S-X-------XS
-X---------------S-------#---------------#-------X----------X-X--SX-%------------X-#--%--#--------%--X-------XX---#--o----X--XX---X------------X-------------S--XX-----XX-----X----#--X----XX-------------
--X-S-------o----X-------------X----------------X-----------X-X-------------X-#---X--%|----XX-----------X--------S-----o-------------------X---------X----------X----X-----------------S----------X-X-XX--
---XX--X-S-%-o-------X----S--------X--------X-------X-------------%---XX--X-------X-%-%------------X-------X------------------------------#-X----X----------X-----------------XX-------S--%-----X----X----
----------X------X--o------------------S----------X---X--%--#--------------------?------X-------X----S----X-------X---------T--X-----S------X---X-------X--------X-X-X--T---%-XX----X------o------XX------
--#-----XX------------#----------X--#--------#-X------------------%--X--------#-----S-------------X---XS-------------XX-----X---#---------------------X-----S-----------XSS-------X--------------------X--
------------X-----#-#----X---X--X--XX-X---------------SX---------%|--XX----X--X---X-S---------S----#---SX--##----X--T-X---------------X---X-----X-X-----X--------X--X-------------------#-----X-S----X----
-X--X----------------------XX------X----S----------S-----X--------%-------XX----------------XSX-X----------------X--XS-----#--------o--------------X---XX--------X---XX--------X-------S---!--X-----X-----
--------------S---X------X--------SXX-------X-----o----X---X---------------------------S-----X-----------------------------------------#-X----X--X----------X------------#-----X------X--------%------F---
X--M-------%-----------X----------------------------X-------------o------X---X--X-----#----X----X-------------X----------------------X------------S--g--X--X----X-------#-------------------1-X-----S-X-#-
-XXX---X--o|---------------------------X-------------X-o----------X--S-----%---%--------X--------%---X--------X----------------%---------X------------X---X-------------------------%----%---------S------
-----------|-----XXX-X-------X---X--X---------X-X--------------------------|---|--------------X--------X--------X--------------|-----XX-----X-X-----X-------------------------------|--------------------X
