------------------------------------------------------------------------------------------------------------------------------------------------------
----------%----%--------------------------------------------------------------------------------%-----%-%----------------------------o----------------
--------S--------------------%---------------------------------------------%---------------------o-------o----------o--------------------o------------
-%%-----------------%--------------U--------o-----------------------------------------%--%---------------------o--------------------------------------
----------------------------------------------%-----%----------S----------%-----------|-------------------%--------------------%----%---------------S-
---------------%-------------------o--------------%-----------------------------------|------------------%-------------%%----------------%------------
-------------%----------------------%-S------------------%--------%--------%----------%--o------------------------------------------%-----------------
---------------------------------o------------------%--------------%---------------------%-------------------%-%---%%---------------------------%-----
-----------------------------------------------%--------------%-----------------------------------R-------------------------------------------S-------
------------%-------------------------%----------o---------------------------o-------------------%---------%-o-----%-%------------------------------o-
----------------------%------------o-----------%--------------%----------------%------%----------------r---------------------------------o------------
-----------------------%---o------%------%---------------------S--------------o---o---------o---%------%-------------------o--------------------------
---------------------------------------------%---------------------S----------%------%%---------------------%------------------o-------------------F--
-M--------------%-%%------------------------------------------------------------------------------%---------------------------------o-------%------#--
-X-------%-----------%----%-S-----%---%-------%-%-%--%-------------%----------%--%-------%-----%------%----------%-----%---%-%-o-------------%-----#--
-X-------------X-----|----|-----X-|---|-------|-|-|----X---X-------|-X--------|----------|----------X-|----------|-----|---|----------X-X----|-----X-X
