------------------------------------------------------------------------------------------------------------------------------------------------------
---------------o------------------------%----------------------------------------------------------g------------------------o--------------%----------
-----------------------------o---------------------------------------------------------S--%--------%----------------------------%-----------%-%-------
--R------------------------------------------g-----R-------%----------------%-------------------------------%---%--%-----------%----------------------
--------o-----------o------------------------%--------%----------------------------------------------------------o--%---o-----------------------%-----
---%-----------------------%-------%------------------------------------------------%--------------%--------------S------------%---%----%-------------
------------%-o----------o-----%-----%---%---%------------S---%------------------------%----------------%------%-----%----------%---------------------
----------------------------------------o--S---------------------%-------------------%---%%---o-----------%--%----------------------------------------
------%-------------------------o----------------------%--------%---------------%------%--------------------------------------------------------------
-----------%------------------------%------%-------------o--------------------------o-----------------------S------%----o-----------------------------
X-%---------------------%---------%----------------%------S---%------%-o-----%-----------------o-----------------------------%------------------------
X------------------------------%------------%--------%--------|--S-----------------r-------------------------%----o--------------%--------------------
X------%--------------%--------------------------S-------o----%-o------------------%----------o----------------------------------------------------F--
X-M-----------------------------------%--%---%------------------%---------------------o-----------------------o------------------------------------#-X
X-X----------------%--%---------------------%-----------------%--------------------%--------%-----------%---%------%--%-----%%-------------------%-X-X
X-X----------X-----|--|---------------------|-----------------|---------------X----|-X------|-----------|---|---------|-----|--------------------|-X-X
