---------------------------------------------------------------------------------------------------------------------------------------------------------------------
----------------------%---------------S--S-----------------------o--------S---------------------%-%----S---%---------oo-------------%----------------S---------------
---------S-%--------------------S------------%--------------------%-----%----------------%-----------------|--%--%-------------------------%----------%----o---------
----------%------%--------------------o-----------------S--%%-----|-----------------------------S----------%------------%----------S------%|--------S---------%------
-------------------o----------------%----------o--S---------------%--S--S-----------------------------------------%-%----------------------%-------------------------
-----------------------------------S-------------------------------%----------------------------%-----S----------------------S---o---------------%---------o---------
-------%---------%----------------%--%------S-%----------o----------------------------%-------------------%--------------%------------------------S-----%------------
--------------------------%----------|-%-------------------------------S--------------|--------S-----------------------------S--------------------------|-%---S------
--------o-o---------------|----------%-|-S-------------------%------------------------%-----------%------------------------%----------------------------%---%--------
--------------------------%-----%------%-------------S--%-------------------------%------------%-------S-------%------------S-------------%%--------------S----------
----%--------%-----------%-----------------------------------------%-----S-----------------------o----------------%---------------o------------------------------S---
------------------------------------S--------------------------------S--------------S------------S--------------------%------------------------%---------%-----------
-------------o------------------------%---------------------------S------------%---S--------------%----------------------------------S----%-%------%---------------F-
-M---------%-----------------------%---------------------------------o-----o------------------------%---------------------%------------------------------%-%-------X-
-X------%-------------%-------%------%-----------%---------oo--o---%-%------%-------%-S------%---------%-------------------------------o------%----S-------------o-X-
-X------|-------------|-------|------------------|--------X--------|----------X--------------|---------|--------------------------------------|--------------------X-
