---------------------------------------------------------------------------------------------------------------------------------------------------------------------
----------------------------o---------------------S-------------------------------------------S----------------------------------------%%---S------------------------
--%----------S----------S------%-----------------------o-------------------------S-S-----------------%-----%-------%-------------------------%------------------%----
---------------%--S--------%----------------------%----------------------------------------%-----------S-----------------------%---%%--------------------------%-----
---%---------?-------------------S-----%--%-------------------------------------------%------o----------S----------------------------------%--------S----------------
------------%-----------%----------------------------------------%---%----%------------%------------------------------------------------------------------------S-%--
---------------o---%------------------------------------------------------------------------S------------------S--------------%----------%%-------------%------------
---------o------%------%---------------------%----%-------%-----------------------------%--------------------------------------------------------------%--S---S------
-%---%----------------------%-----S-----------------------------S-------------------%-------S-------------------%---------%-----------------------%---S--------------
------------%--o--------------%---------S--------------S---------------------%--%---------------o---------------------------------%%-----------------------------S---
------------------------S-------------------------%------%-----------S--%-------------------------%---------------S----%--------------------------------S-o-----%----
-----%---S------%-----------------------------------------------o-%------o------------o--o-------------------S-------%-------%---%-----------------------------------
-------%----S------------%-------%-------------------------------------------------%----------------------------------------------------------%-------%------------F-
-M---------------------------%%-------------------------------------------------------------------------------%--%------------%------------S------------%----S-----X-
-X-%----So-----%--S------------------------------%----------------------S------------%----S----------%----------------S----------------------S---------------------X-
-X-----------------------------------------------------------------------------------------------X-----------------------------------------------------------------X-
