----------------------------------------------------------------------------------------------------------------------------------------------------------------------------------------
---#-----#--------#----------#----S--o-----#-------------#-----------------#-------------------------------------#-#-----#----------S--------------S-----------##-o--#--------------#---
-------------------------------------------------S---------#---------#--y----#--#--#--------------------#------##--------------#-----------------##-------------------------#-----------
--------------------------#---#--------------------------------------##-#--------------#---------------------------------#--------------------#--------#--------------------------------
-----------------------------------2--------S----------------------------------------#-------#------------o----------------S----------------#--#---------------S------------------------
----#-----------------S----------#-------#-----------------------------#--------------------------#-----#---------------------------------------#-----------------#-----S-S----------#--
----------------#-------------------------#-----#---------------------------------#S------------------------#---##-------#------------------------#------------#------S-----------------
---------------------#1----o---------------#----------------#---------##---#--S-S---#---------#------------------------------y-----------#----#--------------------o-#---------------o--
--------------------y----------------------------#--#--------------------------#-----------#----------------------------#----#1------------------------#----------#---------------------
--Q------#-#--------#----------#-----------#---------------------##---------------#--------------#--------------------------------------------------#--------------#---------------#----
--------------------#-----Q-#---------------------------------------#----------------S--------------------------------------#-----------#----------#---------------------------#--------
----------------------------------------#-#------------------------------------------------o--------------------------------------#------------------------------#-------------#--------
---#-----------#-#--------------------------------------#------------------------------#--------------------Q----------#----#-----#---#---#-----------------------------------------F--X
----M--#----------------#------------------Q----------###------------#---#----------Q----##------------------S-----#--#-----#-------------#----------------------#-#----------------#--X
----X------------------S-------#---------------------------------#--------------------------#-#-----------------------------#--------X----------#--------------##---------------#------X
X--XX----XX-X------------------------X-----X-----------X--------------X--X--------X-----X--------X----X-------XX------------X--------X-----X--------X-X--------X-------X---------------X
