----------------------------------------------------------------------------------------------------------------------------------------------------------------------------------------------------------
------X-------#---S-----------------X------S-----------------o--------XX-----S-------------XX------------X--S-------#-----------------#-S-------X-----S------X-------------------#---X---S------X--X--X---
-X-----------X--#----X--X-S------o--X----------------X---------#----X---------S----X-------X---XXX---X-#---------%----X--X--T----------------------X----S-X-X------XS-#----X----------X------S---X--------
-------X----------X-X-So----------X---SX----X------SXXX-------X------X---------S--%-XS--S--XX---------X----------------o-X--X-#----%--Q---X---X----X-----------------X----X--------S-------------------*--
------X------#----------------X----------XX----X--------o-X--#-----------X-------#-X--------------o-%-------------------g----SX--------XXX------X-S--S---------#--XX-XXX-X----XXX-----------%-----X-X--X--
X--S-S----------------X-----------X----X------------X-------#--X---#-%--------------X--X--------X-S-|----X----T-X------X-------#----X-----X-X------#-----g-S--X--------------X---X--#---------------X--X-X
----S---X-X--------X---X-X---------------X--------------X-X-----S------X----X-X------------X--------%-##--X---X------------X---X----------X--------------------X--XS-------------------------S------------
X-X-----------X----X--X---------------------S----X-----%-X------S----XX----X---X----XX------------g----#------------X-------------X-o------S-g-X-------------------X-X---X--X--#--------------------------
-X--S--------------X----------XS----------X--X------------SX-#-X--X---------X--------------S--------X--X--%-----------XS-%-----S---------------------X--S-X-X--X--X----X--X--------------XX--------------S
---S----#-------X---#-----S------X--------X----------S-------------XXX------------XX--------------------S-----X------X-------X--------X----o-X----------XX-U--X------X-------XXX------X---------%-T-------
----X-----S----------S----------------------------%--------X-X--------#------X-------------X-XX--SX---X---XX-S--------X-XS-------SXX---XS---o------------------X--!-S------------X----------------#-------
-S-X------------XX---------X-----------X-S-------X------------------%------------X---X-----X-----X----------#-SX-XX------SX-------X------X---X-X-----X-----S-----S------X---#-%-X-------S--X--------S-----
--X-X---------#----------------X-X---------#SX----X--X------------S--#-%------------------S---------------X-----X-----X-X----XX------X--X-------------------X------X------X-X----S----------t-----X---F---
-#-M--------X--X----------SS-#--------------X------X---------X--------o----X---------#-------------------#--X------------X--------------------X--------X-!-----S---------X---X------X----#--X-X-------#---
---X-X-X-X----------%------------------%---------Q-------@-Q-----X------------X-X-X------------------o-------------X--------k--X----------------X------X----X------%--%-------X----XX----XX--X----#-------
---X----------------|---------X--------|-------XX-X-------X------X--X---X----------X---------------------XX-XX--X----X------X----------------X-----------X---X------X-|--X----------XX-----X-X-X----------
