----------------------------------------------------------------------------------------------------------------------------------------------------------------------------------------------------------
---------------XX----------#-?-------X--------------------#S-X----X--X-------X--------------#--%-----X--S----S-X--------------%------X----------X------------------------------X-X-------X----------X-----
-------X--S---------X---%---------S----X--------X------------X-X--------X-------S--------X-------#-------X-----X-------------X-----X-----X--------------S--X----------X---------------X-----X------------X
-------------X---X--X-------------X-------X------X-X-----X-X--X-----------------X----------X-X-X-----X-SX-----#----------#-----XX-X----------------X-S--X-------#---#-----------S--------S----------o---X-
---------------Q------X-g-----X---------S-----X--X------X---X---X-------------XSX-------------U--X-S--------------S--%------K--------------------X-------X------------S--------X--o-----#---------o-X--S--
--------SX---%---------X-----#------------X----------#-#------------X--T-----S----XS------X-SX------S------------X------X--------------------------#-----------------XX-X-------X-----------X-------------
-X--------X--------------#--X----------X---X------S-----------S--#-S---X--------X------S-------------X-----X-----------#-------------XX--X--X------------XX--------------X---------XX---------X----------X
----S------X--XX---X------t--------X--o------X---------------X---XX-----------X--XX---------X--#----------X---------X-----X-X----------------X-----X--------S----Q-------X---#-XX-X--------------------X--
--X--X--------------------X------------%--X-XX-#---------------%------------g--------SX-----------#-------------------------------XXX---------X------o--X--X-o------X---------------S---------X-------X-g-
-----X---So---XX--------------XX-%-----|----------X--------X------X-X--X--X--SX----%---S-------------#--X------------X-X-----X--------S----XX--------SX-----X------------------X---------X----X---------X-
--------------------XX----X---------X--%-------X-S---X--X--XX---S-------------------X-#------------XX-------X----X---X-------X--X------X----XS------X------S------X----------SX---S---------X---S---------
------X---------------------------S----------X-X-X-S--X----X---------------------------X--------------X-X-----X-X-------SX----X----X---XX----S--XX------------X---------------X----%------X-X--X---------S
--X-S-X-------------XX----#--X----SX------X---X------X----X--------X------X----X----------X-------X-------#------------X----X----X-----X-----X-S------X------X--S------X--------------g--XX---XXX-#---F---
---M-------------#----------X-------S------%----------X-------%-------X-%----------------------------T--------------g-------------SX------X---------%---------------X--------g-XX----X---X---X-------XX---
XS-X-------X-X------S-------------------#-----%---XX-#-------#--X---------%-%---X-----------o--------X-------------------%------X--------X-----%-X------#----X------X-X---------X----X--o-----%-----------
-------------------X------X--------------X----------------X---X----X---X--|-|-------------------X-------X---------XX-----------X--X-X----X----X-X-------------------X-----------------X---X---|-----X-----
