----------------------------------------------------------------------------------------------------------------------------------------------------------------------------------------------------------
------X----------------------X------------o-------#--------X--X---------------------o-----X-----------#---------#---------------------------X---------------SX------X------X-----X---Q------------X--XX---
------X-X---#---------X----#--------X-----S---#---X-------------#------t-----------------------X---X--X-S--T------X----XX-----------T---#--#---o--XS-----#-%----?--S-SS-------X-X-XS--X---X--X-X-#-X-X----
--------------------S-------TS----X--------SS-XX-----X------------X----X-----X------o-S--%--#----T--X------XX-#-------X-------XX-X--X---------X------X--------------#-----------------X-X-------X---%-----
X-#------------X------X-X---#---------S----------#--------o--------------------------X-g--------SX-----X------X-------------------X----X------X--------#-S#-S--X-R----------------------------------------
-X---o-S-----#----X--XX------------------X---X--------X---------%---%--------------X-----S------X-----#-----------S--S--------X-------X---X----g--o----X--------S----X--X--#-------XX---#--------X--------
---X-----S------S--------X--X-----X---------------X------X------------------------------------------------X-----#--------XXX-----%---------#T----X-X------X--------#---------#--------------------#---XXX-
-#------------------X----X--------X------------g--------#---------------X------X--X-------------X-------#-----X--------------X--#-----------X-------#---X--------S----------X-------#-X-SX---------X----X-
S---X-----X--------------------#-------X------S---------#--o---------S---------X----------------------#----o------g----X-o---X--------SX-------------#---S--X-XX---g-X---%--------------------------------
-------#-----##--------X----------#--------g--------X-X-------------%---X-------X-X-#-----X----#--X-XX----X-------------X------------------------------X----X----X-------------#----S---------------#-----
-X----X------X----------------%-----------X--------------XX--------X------S-------------X---------X--------------------X----------------XX---X------------------X------------X----X------S--X--------S----
--------SX------S-----X----------X--X--X---X---X-------S-X-----X---------------X------X-----%----X--------------------------%--------%-------------X---------------XX--------------S-------------------X--
-----g-------------------X----------X-------XX---S#---Q----------####----X--#----------X------------------S----------X--------X--X--X-X---S------S-------------X------S-------------------------X-S---F---
---M--X-X----------XX------------X---------X------X-----------------X--S------X----------------X--XS--X----------S--------------S------X-----#--XX-S--X------X--------XX------%-------X----X---X---X--S---
---X---SX--------------------X------%---%----X--------R-----S------X-X--X-%-T------------X-X----%---S----------S---X--XX---------------X------------X-------------XX----X---X--S#--%----%---k---%---------
---X-X--------------X------------X--|--------X----X-----X-X-X--X----X-----|-X-X--------------XX-|------------------X----------X----------------------------------X--------X-----X--|----|---XX------------
