----------------------------------------------------------------------------------------------------------------------------------------------------------------------------------------------------------
--S------------#-S-----------X-k-----------------X--X--%-------X---T--------X-------------------------------%-------S-----XX-----o--XS-----XX-----X-#----!---------X---X---------X-S----------X--------X--
--X---X--X------X----X------#--XX----S--------XX--------S---#------XS-----XXX-----X--#----#----#-%-------------------X------------------X-S-X------X-----------X----X------TS--------------X-------X--X---
---------------X----X---X-X---------------------------X----S--X------------X--------S-X--------------X--------S----------#-----------X---------X--X-X-----XXX----X----##S--X------X---------X-X----------X
----------X---X--------------XX----------------------------X----X--------------------X----------X----X-----#------#-------------------------X----------X----------#--S---------------X----#------XX-------
X--#--X---------X---SoS-%----------#-----X-T-#---X-------%--X-------------X---------X----------X---#----X---X----------X-X---------X-#--#-------T---------SX---------X-#---X--------------X-------------X-
-----------------------o|------X--X-----T--X---X------X-----X-----------%---S-------------X------XX----XX-----------------------------------X---#-------------XXS---------X-#-------------X------X----#S--
---------------------%--%-#--#-X-%------X---------g----------X-----------------------%--------------S-o---X---X---------X--------X----y-#S-----------X---X----------X----o-X---XXX---X--------------------
----X-------------X-------X----------------SX-X----X--X--S-------X--X--X-------X----X--X---X--------X-X--------X------X-----S----X-X--X-------------XX----------X-------#----SX---X-----------X----X----X-
---X-----X-----X------XXXX-----X---XS---g--X-------X-X---------X---------------------------------------#-S------X-----------------S-----%----------S-------------XX----X-X-------X--X-------#-------------
-X---S----g-X------------X-------------------------------X-X------------------X---------------------X------X------------------X-X--o---------------X-#---S-----X---------X-X--X-X--------X--------X-------
-------X--------X-------S------------%--------X---------X-----#------------#----S-----X-------#-X-----------X----X-o------XX---X----X-X--X---------X---------#-X----------X--------%----------------------
------X-------------X-X--X-----X--#--------X---------#-----------X---%-%------------#----#--------X----------X----Q---------------------------------X----------X-----------S-XX-----------X--X------X-F---
---M-----X--X---S-------------X--#--#--X-------#----X----X----XX-------------------------X-#--------X---------X-X--S-------#----#-------------%-----------#---X---X-----X-------#---!-------------XX--#---
---X------?--#-----X-------------X----X---S----------S---------X-------%----X---X---------------------X----S---X----Q-------------XX-#----------X---X-----------X--%-XX----#------S----%-------XX-----X---
-------X------------X-----X--------X----------X----XX-----XXX-----X----|-X--X-X-X---------------------X------------X----------------X------------------X-----X-----|------X-X--X-------|--X---X-X---------
