----------------------------------------------------------------------------------------------------------------------------------------------------------------------------------------
-#-----------------------------------------------o----#------------------------------------------##---------#---#---------------#--------------#1---------------------#-----#-----------
------------#--#----------------#--#--------------------#------------------------#--------S--S----------------------------------------------------------##----Q--------------#---------X
-----------------------------#-----#--------#----------------Q---#-----------------------------------------#---------------------------------------#---------#--#-----##------#-#------X
-#-------------o--#----------------------------------------------------------------#-------------S-------------------------------------#--#-#-#---------Q------#------------------S----X
--#----------------S-------------------#--------------------------------------#-------------------------------#----------------------------------------------#---------------------#---X
----------------------y--------#-------------------------------#S---------------------#----------S----------------#------------------#-------------#------------#----------------------X
-----------#----------#---------#-----------------------------#--------#----o--#---------------------#-#----#------------------------#-----------------------#-------------------------X
--------------------------------------------------------------------#----#---#-----S-----------------#----------------------------------------------#-#-------------------Q-------#----X
-------#----------------#-----#-#----------#---------------#-------------------------------------------------#-------------#-#----------------------------------2----------------------X
--------#-----------------------------------------------#------------------------------------------------------#------#-----#----------#----S---------#-------------#---2--------#-----X
-#--------#--------------------#---#-----------------------S-----#---S---------------------o---------------#-#---------#-----------------#--------------#------o--#--------------------X
-------------------#--------#-#---#--------------------------------------------------o--#------------------------------------#----------#----#--------------------------------------F--X
----M-------------#---------------------------#---------------------------#-----------------------------------------------S-------2--------#--#-#-----------------#S----------------#--X
----X-----------------------------#-------X-----S------------------SC---------------#-------------------------------------------------------------------------------------#------X-----X
----X--------------X-------------------X--X-----------------X--X-X-------X--------X----------------------------------------X------------------------------X------------X---------X-----X
