--------------------------------------------------------------------------------------------------------------------------------------------------------------------------------------------------------
--------------------------------------------------------------------------------------------------------------------------------------------------------------------------------------------------------
--------------------------------------------------------------------------------------------------------------------------------------------------------------------------------------------------------
------------------------------------------------------------------------------------------------------------------------------------------------o----ooo------------------------------------------------
------------------------------------------------------------------------------------------------------------------------------------USSS----------------------------------------------------------------
------------------------------K-------------------------------------------------------------------ggg---------------------------------------------------------------------------------------------------
---------------------------------------------------------------------------------------------------------------------K----------------------------------------------------------------------------------
--------------------------------------------------------------------------------------------------------------------------------------------------------------------------------------------------------
-----------------------------1--------------------------------------------------------------------------------------------------------------------------------------------------------------------------
----------------------------------------------o----o----------------------------------------------------------------------------------------------------------------------------------------------------
-------------------------------------------------------------------------------------------------------------------------------------------------------TT------------------------g##--------------------
--------------------------------------------------------------------------------------------k----------------------------------------------------TT----TT-----------SS-----------###--------------------
-------------------------------------------------------------------------------------------------------------------------------------------------TT----TT----TT-----SS---------g####--SSS---------------
-M--------k---------y--y----------------------------------------------------------------------K----------------------------------y----------g-g--TT----TT--g-TT-----SS---------#####------------------F-
XXXXXXXXXXXXXXXXXXXXXXXXXXXXXXXXXXXXXXXXXXX----XXXXXXXXXXXXXXXXXXXXXXXXXXXXXXXXXXXXXXXXXXXXXXXXXXXX----XXXXXXXXXXXXXXXXXXXXXXXXXXXXXXXXXXXXXXXXXXXXXXXXXXXXXXXXXXX--XX--XXXXXXXXXXXX-------XXXXXXXX--XXX
XXXXXXXXXXXXXXXXXXXXXXXXXXXXXXXXXXXXXXXXXXX----XXXXXXXXXXXXXXXXXXXXXXXXXXXXXXXXXXXXXXXXXXXXXXXXXXXX----XXXXXXXXXXXXXXXXXXXXXXXXXXXXXXXXXXXXXXXXXXXXXXXXXXXXXXXXXXX--XX--XXXXXXXXXXXX-------XXXXXXXX--XXX
