--------------------------------------------------------------------------------------------------------------------------------------------------------------------------------------------------------
--------------------------------------------------------------------------------------------------------------------------------------------------------------------------------------------------------
--------------------------------------------------------------------------------------------------------------------------------------------------------------------------------------------------------
S-----SSSSSSSSSSSSSSSSSSSSSSSSSSSSSSSSSSSSSSSSSSSSSSSSSSSSSSSSSSSSSSSSSSSSSSSSSSSSSSSSSSSSSSSSSS--------------------------------------------------------------------------------------------------------
S-----------------------------------------------------SS--SSSSSS--SSSS------SSSS------------------------------------------------------------------------------------------------------------------------
S-----------------------------------------------------SS--SSSSSS--SSSS---g--SSSS--------------------------------------------------------------------------------------------------ooo-------------------
S-----------------------------------------ooo-------SS--------SS---S----SS----------oooooo--------------------------------------------------------------------------------------------------------------
S--------------------------------------g-g----------SS--------SS---S----SS------------------------------------------------------------------------------------------------------------------------------
S--------------------------------------S-SSSS-U-----SS--------SS---S----SS----------SSSSSS--------------------------------------------------------------------------------------------------------------
S----------------------------C---------SoS--SoS-----SS----ooooSS---SoU--SC--g-g-----SSSSSS--------------------------------------------------------------------------------------------------------------
S---------@QQQQ--------#-#-------------SSS--SSS-----SSSS--SSSSSS---SSS--SS--SSSS-----------------------------------------------------------------------TT------------------------g##--------------------
S--------------------#-#-#-#---#----------------------SS-----------------------------------------------------------------------------------------TT----TT-----------SS-----------###--------------------
S----------------g-#-#-#-#-#---#-#--------------------SS-------------o---------------------------------------------------------------------------TT----TT----TT-----SS---------g####--SSS---------------
S--M------------g#-#-#-#-#-#-E-#-#--------kk--------------------------------------------------------------------------------------k--g-g----g-g--TT----TT--g-TT-----SS---------#####---------r--------F-
XXXXXXXXXXXXXXXXXXXXXXXXXXXXXXXXXXXXXXXXXXXXXXXXXXXXXXXXXXXXXXXXXXXXXXXXXXXXXXXXXXXXX----XXXXXXXXXXXXXXXXXXXXXXXXXXXXXXXXXXXXXXXXXXXXXXXXXXXXXXXXXXXXXXXXXXXXXXXXX--XX--XXXXXXXXXXXX-------XXXXXXXX--XXX
XXXXXXXXXXXXXXXXXXXXXXXXXXXXXXXXXXXXXXXXXXXXXXXXXXXXXXXXXXXXXXXXXXXXXXXXXXXXXXXXXXXXX----XXXXXXXXXXXXXXXXXXXXXXXXXXXXXXXXXXXXXXXXXXXXXXXXXXXXXXXXXXXXXXXXXXXXXXXXX--XX--XXXXXXXXXXXX-------XXXXXXXX--XXX
