------------------------------------------------------------------------------------------------------------------------------------------------------------------------------------------------------------------
------------------------------------------------------------------------------------------------------------------------------------------------------------------------------------------------------------------
------------------------------------------------------------------------------------------------------------------------------------------------------------------------------------------------------------------
---------------------------------------------------oo-------------------------------------------------------------------------------------------------------------------------------------------------------------
------------------------------------------------------------------------------------------------------------------------------------------------------------------------------------------------------------------
------------------------------------------------------------------------------------------------------------------------------------------------------------------------------------------------------------------
---------------------LSSS-----------------------------------------------------------------------------------------------------------------------------------------------------------------------------------------
-------------------------------------------------------o----------------------------------------------------------------------------------------------------------------------------------------------------------
-----------------g------------------------------------------------------------------------------------------------------------------------------------------------------------------------------------------------
-----------------#----------------------------------------------------------------------------------------------k-ggg-----ggg-------------------------------------------------------------------------------------
--------SUS-----##---2-----#-----------TT-------------------------------------------------------------------------------------------------------------------------------------------------------------------------
---------------###---------#----K------TT-------oo------------------------oo---------------------o----------------------------------------------------------------------------------------------------------------
--------------####---------##----------TT-----------------#------------------------------------------------------------------------------------------------------------TT-----------------------------F-----------
--M----------#####----kk---##---gg-----TT-----k--g-g------#-----------K-------------------------------------------------------------------------------------y------y---TT-----------------------------#-----------
XXXXXXXXXXXXXXXXXXXXXXXXXXXXXXXXXXXXXXXXXXXXXXXXXXXXXXXXXXXXXXXX-X-XX-X-XX-XXXXXXXXXXXXXXXXX-X-X-XXXXXXXXXXXXXXXXXXXXXXXXXXXXXXXXXXXXXXXXXXXXXXXXXXXXXXXXXXXXXXXXXXXXXXXXXXXXXXXXXXXXXXXXXXXXXXXXXXXXXXXXXXXXXXXXX
XXXXXXXXXXXXXXXXXXXXXXXXXXXXXXXXXXXXXXXXXXXXXXXXXXXXXXXXXXXXXXXX-X-XX-X-XX-XXXXXXXXXXXXXXXXX-X-X-XXXXXXXXXXXXXXXXXXXXXXXXXXXXXXXXXXXXXXXXXXXXXXXXXXXXXXXXXXXXXXXXXXXXXXXXXXXXXXXXXXXXXXXXXXXXXXXXXXXXXXXXXXXXXXXXX
