--------------------------------------------------------------------------------------------------------------------------------------------------------------------------------------------------------
--------------------------------------------------------------------------------------------------------------------------------------------------------------------------------------------------------
----------------------------------------------------------------------------------------------------------------------------------------------------------------------TT--------------------------------
--------------------------------------------------------------------------------------------------------------------------------------------ggg--------gggoooo--------TT-----------g-g------------------
----------------------------------------------------------------------------------------------------------------------------------------------------------------------TT--------------------------------
-------------------------------------------------------------------------------------------------o--------------------------------oo--------------------y-------------TT--------------------------------
---------------------------------------------------------------------------------------------------------------------------------------------------------o------------TT--------------------------------
----------------------------------------------------------------------------------------------------------------------------------------------------------oooo--------TT--------------------------------
----------------------------------------------------------------------------------------------------------------------------------------------------------------------TT--------------------------------
----------------------------------------------------------------------------------------k----------------------------------------------------oo---oo------------------TT--------------------------------
----------------------------------------------------------------------------------------------------------------------------------------------------------------------TT--------------------------------
------------------------------------------------------------------------------------------------------------------------------------------------k--g-g----oooo--------TT-----------ggg------------------
------------------------------------------------------------------------#---#-----------------------------------------------------------------------------------------TT------------------------------F-
-M------------ggg-------------------------------------------------------#-k-#-----------------------------------------------------------------------K-----------------TT------------------------------#-
XXXXXXXXXXXXXXXXXXXXXXXXXXXXXX--XXXXXXXXXXXXXXXXXXXXXXXXXXXXXXXXXXXXXXXXXXXXXXXXXXX--XXXXXXXXXXXXXXXXXXXXXXXXXXXXXXXXXXXXXXXXXXXXXXXXXXXXXXXXXXXXXXXXXXXXXXXXXXXXXXXXXXXXXXXXXXXXXXXXXXXXXXXXXXXXXXXXXXX
XXXXXXXXXXXXXXXXXXXXXXXXXXXXXX--XXXXXXXXXXXXXXXXXXXXXXXXXXXXXXXXXXXXXXXXXXXXXXXXXXX--XXXXXXXXXXXXXXXXXXXXXXXXXXXXXXXXXXXXXXXXXXXXXXXXXXXXXXXXXXXXXXXXXXXXXXXXXXXXXXXXXXXXXXXXXXXXXXXXXXXXXXXXXXXXXXXXXXX
