------------------------------------------------------------------------------------------------------------------------------------------------------------------------------------------------------------------
------------------------------------------------------------------------------------------------------------------------------------------------------------------------------------------------------------------
------------------------------------------------------------------------------------------------------------------------------------------------------------------------------------------------------------------
---------------------------------------ggg----oo-------------------------------------------------------------------------------------------------------------------------------------------ggg--------------------
------------------------------------------------------------------------------------------------------------------------------------------------------------------------------------------------------------------
------------------------------------------------------------------------------------------------------------------------------------------------------------------------------------------------------------------
---------------------LSSS-----------------------------------------------------------------------------------------------------------------------------------------------------------------------------------------
---------------------------------------------------------ggg-----------------------------------------------------------------------------------------------------g------------------------------------------------
-----------------g------------------------------------------------------------------------------------------------------------------------------------------------------------------------------------------------
-----------------#----------------------------oo--oo-------------oo-----------------------------------------------------------------------------------------------------------------------------------------------
--------SUS-----##---2-----#-----------TT-------------------------------------------------------------------------------------------------------------------------------------------------------------------------
---------------###---------#-----------TT----------------------------------------------------------o---------------------------------------------------------------------------o----------------------------------
--------------####---------##----------TT----------------------------------------------------------------------------------------------------------------------------------------------XX--------F----------------
--M----------#####----kk---##---gg-----TT--------g--------------------K----------------------------------------------------------------------------------------------------------------XX--------X----------------
XXXXXXXXXXXXXXXXXXXXXXXXXXXXXXXXXXXXXXXXXXXXXXXXXXXXXXXXXXXXXXXXXXXXXXXXXXXXXXXXXXXXXXXXXXXXXXXXXXXXXXXXXXXXXXXXXXXXXXXXXXXXXXXXXXXXXXXXXXXXXXXXXXXXXXXXXXXXXXXXXXXXXXXXXXXXXXXXXXXXXXXXXXXXXXXXXXXXXXXXXXXXXXXXXX
XXXXXXXXXXXXXXXXXXXXXXXXXXXXXXXXXXXXXXXXXXXXXXXXXXXXXXXXXXXXXXXXXXXXXXXXXXXXXXXXXXXXXXXXXXXXXXXXXXXXXXXXXXXXXXXXXXXXXXXXXXXXXXXXXXXXXXXXXXXXXXXXXXXXXXXXXXXXXXXXXXXXXXXXXXXXXXXXXXXXXXXXXXXXXXXXXXXXXXXXXXXXXXXXXX
