-------------------------------------------------------------------------------------------------------------------------------------------------------------------------------------------------------------------------------------------------------------------------------------------------------------------------------------------------------------------------------------
-------------------------------------------------------------------------------------------------------------------------------------------------------------------------------------------------------------------------------------------------------------------------------------------------------------------------------------------------------------------------------------
-------------------------------------------------------------------------------------------------------------------------------------------------------------------------------------------------------------------------------------------------------------------------------------------------------------------------------------------------------------------------------------
-------------------------------------------------------------------------------------------------------------------------------------------------------------------------------------------------------------------------------------------------------------------------------------------------------------------------------------------------------------------------------------
-------------------------------------------------------------------------------------------------------------------------------------------------------------------------------------------------------------------------------------------------------------------------------------------------------------------------------------------------------------------------------------
-------------------------------------------------------------------------------------------------------------------------------------------------------------------------------------------------------------------------------------------------------------------------------------------------------------------------------------------------------------------------------------
-----------------------------------------------------------------------------------------------------------------------------------------------------------------------------------------------------------------------------------------------------------------------------------------------------------------------------------------------------------------------##------------
-----------------------------------------------------------------------------------------------------------------------------------------------------------------------------------------------------------------------------------------------------------------------------------------------------------------------------------------------------------------------##------------
---------------------------------------------------------------------------------------------------------------------------------------------------------------------------------------------------------------------------------------------------------------------------------#-----------------------------------------------------------------------------------#-##------------
---------------------------------------------------SSUSSSSS---------------------------------------------------------------------------o---------------1--------o--------------------------------------------------------oo---------------------tt-------------------------------##--oo------o----o-------------------oo---oo-----------------------------------------#-##------------
---------------------------------------------------------------------------------------------------------TT---------------------------------------TT---------------------------------------------------------------------------------------TT--tt------------------------------###---------------------------------------------------------------------------------#-#-##------------
---------------------------------------------------------------------------------------------------------TT---------------------------------------TT----TT-----------------------------------------------------------------------------TT--TT--tt-----------------------------####---------------------------------------------------------------TT----------------#-#-##------------
---------------------------------------------------------------------------------------------------------TT---------------------------------------TT----TT-------------------------------------------------#---------------------------TT--TT--tt----------------------------#####----------------------#---#------------------------------------TT---------TT---#-#-#-##--------F---
-M-----------------------------------------------------------------------------------------k-ggg-----ggg-TT----k-k---------------k---------ggg----TT---kTT-----------------------------------------------kk#----------------------ggg--TT--TT--tt-----k--ggg-----ggg------gg######--k-------------------#-k-#-----------------------k------kkk---TT---------TT---#-#-#-##--------#---
XXXXXXXXXXXXXXXXXXXXXXXXXXXXXXXXXXXXXXXXXXXXXXXXXXXXXXXXXXXXXXXXXXXXXXXXXXXXXXXXXXXXXXXXXXXXXXXXXXXXXXXXXXXXXXXXXXXX-X-XX-XX-XX-XXXXXXXXXXXXXXXXXXXXXXXXXXXXXXXXXXXXXXXXXXXXXXXXXXXXXXXXXXXXXX-X-X-XXXXXXXXXXXXXXXXXXX------XXXXXXXXXX-XX--XX--XXXXXXXXXXXXXXXXXXXXXXXXXXXXXXXXXXXXXXXXXXXX---XX---XXXXXXXXXXXXXXXX-----X----XXXXXXXXXXXXXXXXXXXXXXXXXXXXXXXXXXX-X-X-X-XXXXXXXXXXXXXX
XXXXXXXXXXXXXXXXXXXXXXXXXXXXXXXXXXXXXXXXXXXXXXXXXXXXXXXXXXXXXXXXXXXXXXXXXXXXXXXXXXXXXXXXXXXXXXXXXXXXXXXXXXXXXXXXXXXX-X-XX-XX-XX-XXXXXXXXXXXXXXXXXXXXXXXXXXXXXXXXXXXXXXXXXXXXXXXXXXXXXXXXXXXXXX-X-X-XXXXXXXXXXXXXXXXXXX------XXXXXXXXXX-XX--XX--XXXXXXXXXXXXXXXXXXXXXXXXXXXXXXXXXXXXXXXXXXXX---XX---XXXXXXXXXXXXXXXX-----X----XXXXXXXXXXXXXXXXXXXXXXXXXXXXXXXXXXX-X-X-X-XXXXXXXXXXXXXX
