--------------------------------------------------------------------------------------------------------------------------------------------------------------------------------
--------------------------------------------------------------------------------------------------------------------------------------------------------------------------------
----------------------1-------------------------------------------------------------------------SS------------------------------------SS----------------------------------------
---------------------------K----------------------------------------------------------------------------------------------------------------------------------------------------
--------------SS----------------------------------------------------------------------------------------------------------------------------------------------------------------
-------------------------------------------------K------------------------------------------------------------------------------------------------------------------------------
--------------------------------------------------------------------------------------------------------------------------------------------------------------------------------
---------------------------------------------------------------------------------------K--------------K-------------------------------------------------------------------------
------------------------------------------------SS-------------------B----SS------------SS------------SS---------------------------------------------------------B--------------
---------------------------------------------------------------------b--------------------------------------k-----------------------------------------U----------b--------------
-------------------------------------------------------------------SS#CS-----------------------------------###-------------------------------------------------SS#CS------------
-----------------------------------------K----------K-----------------------------------------------------####----------------TT-------------------B----------------------------
----------------------------------------------------SS-----------------K-B--------------------------------####----------------TT-------------------b-----#---------K-B------F---
-M-----------------------------------------------------------------------b-------------------------------#####----------------TT-------------------B----##-----------b------#---
XX----------------------XX----------XX--------------------XXXX--------XXXX------------------XX----XX----XXXXXXXX----------XX--XX----XXXXXX--------XX--XXXX--------XXXX----XXXX--
XX----------------------XX----------XX--------------------XXXX--------XXXX------------------XX----XX----XXXXXXXX----------XX--XX----XXXXXX--------XX--XXXX--------XXXX----XXXX--
