----------------------------------------------------------------------------------------------------------------------------------------------------------------------------------------------------------
----------------------------------------------------------------------------------------------------------------------------------------------------------------------------------------------------------
--------------------------------------------------------SS--------------SS--------------------------%%%-----------------##--------------------------!-----------------QQ----------------------------------
--------------------------------------------------------SS----SS-------------------------------------|------------------##------SS------------------------------------------------------------------SS----
----##------CS--##----------------------------------------------------------------SS-----------------|------------SS--CS------------------##----------------------SS----------------------##--------------
----##----------##--------SS------------------SS---------------------o-------------------------------|----o-------SS----------------------##----------------------SS----------------------##--SS--SS------
------------------------S------------------------------o---------------------------------------------|------------SS--2---------------------------------------------------------------SS------------------
--------------------------------------------------------------SS-------------------------------------|---------------2-2--------------------------------------------------------------SS------------------
-----------------------------------------------------------------------------------------------------|--------------------------------------------------------------------------SS------------------------
--------------------------SS----------------SS-------------------------------------------------------|--------------------------------------------------------------------------SS--------SSS-------------
------------##---------------------------------------------------------------------------------------|------------------------##--------------------------------------------------------------------------
------------##-----------------------------------------------------o---------------------------------|------------------------##--------------------------------------------------------------------------
--------##------------------------------------------------##-----------------------------------------|----------------------SS--oo---------------------------------------------------------#----------F---
---M----##------------------------------------%%----------##--------------------SS-------------------|----------------------SS----------------------------SS----------%%------------------##----SS----#---
XXXX----XXXX----------------------------------||--------XX------------%%%-------------XX-------%%%---|----XX----XXXX--------------------XX------XX--------------------|-----------XX------XX----------XX--
XXXX----XXXX----------------------------------||--------XX-------------|--------------XX--------|----|----XX----XXXX--------------------XX------XX--------------------|-----------XX------XX----------XX--
