----------------------------------------------------------------------------------------------------------------------------------------------------------------------------------------------------------
----------------------------------------------------------------------------------------------------------------------------------------------------------------------------------------------------------
------------------------------SS--------------------------------------------------------------------------------------!-------------------------------------------------!---------------------------------
----------------------------------------------------------------------------------------------------------------------------------------------------------------------------------------------------------
------------------------------------------------!----------SS-------------------------------------------------------------------------------!---------------------!-----------------SS--------------------
----------------------------------------------------------------------------------------------------------------------------------------------------------------------------------------------------------
------------------------------------------------------------------------S-----------------------------------------------!---------------------------------------------------------------------------------
----------------------------------------------------------------------------------------------------------------------------------------------------------------------------------------------------------
--------SS----------------------!-------------------------------------------------SS----------------------------------------------------------------------------------------------------------------------
----------------------------------------------------------------------------------------------------------------------------------------------------------------------------------------------------------
-----------------------------------------------------------------SSS--------------------------!----------SS-------------------------------------------------------------------!---------------------------
----------------------------------------------------------------------------------------------------------------------------------------------------------------------------------------------------------
------##-------#--------------------------------##-----------------------------------tt---tt---------------------tt-----##----##-------------------------------------------------------tt-------------F---
---M--##------##--------------------------------##-----------------------------------tt---tt---------------------tt-----##----##-------------------------------------------------------tt-------------#---
XXXXXXXXXXXXXXXXXXXXXXXXXXXXXXXXXXXXXXXXXXXXXXXXXXXXXX---XXXXXXXXXXXXXXXXXXXXXXXXXXXXXXXXXXXXXXXXXXXXXXXXXXX---XXXXXXXXXXXXXXXXXXXXXXXXXXXXXXX-----------------------XXXXXXXXXXXXXXXXXXXXX-------XXXXXXX--
XXXXXXXXXXXXXXXXXXXXXXXXXXXXXXXXXXXXXXXXXXXXXXXXXXXXXX---XXXXXXXXXXXXXXXXXXXXXXXXXXXXXXXXXXXXXXXXXXXXXXXXXXX---XXXXXXXXXXXXXXXXXXXXXXXXXXXXXXX-----------------------XXXXXXXXXXXXXXXXXXXXX-------XXXXXXX--
