----------------------------------------------------------------------------------------------------------------------------------------------------------------------------------------------------
----------------------------------------------------------------------------------------------------------------------------------------------------------------------------------------------------
--------------------------------------------------#---SS------#-------------------------------------------------------------#-----------------------------------------------SS--#-------------------
----------------------------k---------------------#-----------#-----------------------------------k-------------------------#---------------------------------------------------#-------------------
---Q------------------------SS--------------------##----------#---------TT--------#---------#-----SS------------------------#----SSS------------SS----------------------SS------#---SS--------------
--------------------k-----------------------------##----------#---------TT--------#---------#-------------------------------#------K--------------------------------------------#-------------------
--------------------SS----------------------------##----------#---------TT--------#---------#---------SS--------------------#-----------------------SS------#-------------------##------------------
--------------------------------------------------##----------#---------TT--------#---------#-------------------------------#-------------------------------#-------------------##------------------
---------------------------------------------SSS--##----------#---------TT--------#---------#-------------------------------#-----------SSQS----------------#-------------------##-----SSS----------
-----------------------------------------------K--##----------#---------TT--------#---------#-------------------------------#-------------------------------#-------------------##-------K----------
-------------------------SSS------SSC-------------##----------#---------TT--------#---------#-------------------------------#-------------------------------##--------------SS--##------------------
---------------------------K----------------------##----------#---------TT--------#---------#-------------------------------#-------------------------------##------------------##------------------
--------------------------------------------------##----------#---------TT--------##--------##----------------SS------------#-------------------------------##------------------##---------------F--
-M--------------------------------SSS-------------##----------#---------TT--------##--------##------------------------------#-------------------------------##------------------##---------------#--
XX--------------------------XX--------------------XX--XX------XX----XX--XX------XXXX--------XX----XX------------------------XX--------------------------XXXXXX----------------XXXX------------XXXX--
XX--------------------------XX--------------------XX--XX------XX----XX--XX------XXXX--------XX----XX------------------------XX--------------------------XXXXXX----------------XXXX------------XXXX--
