--------------------------------------------------------------------------------------------------------------------------------------------------------------------------------
--------------------------------------------------------------------------------------------------------------------------------------------------------------------------------
----------------------------------------------------------------------------------------------------SSSS------------------------------------------------------------------------
--------------------------------k---------------------------------------------------------------------K-------------------------------------------------------------------------
-------------------------------###----------------------SS----------------------------------------------------------------------------------------------------------------------
------------------------------####----------------------------k------------K--------------------------------------------------------------------K-------------------------------
--------------SS--------------####---------------------------###--------------------------------------------------------------------------------SS--SS----------SS--------------
-----------------------------#####--------k-----------------####--------------------------------------------------------------------K-------------------------------------------
---------------------------#######-------###---------------#####-----------------B--------------------------------------------------SS-------#--------------USS-----------------
--------------------------########------####--------------######----------SS-----b-------------------------K--------------------------------##----------------------------------
-------------------------#########-----#####-------------#######---------------SS#CS-------------------------------------------------------###----------------------------------
------------------------##########----######------------########------------------------TT----------TT------------------------------------####----------------------------------
------------------------##########----######-----------#########-------------------K-B--TT----------TT--------------------USS-------------####------------------------------F---
-M-------K-------------###########---#######----------##########---------------------b--TT----------TT-----------------------------------#####------------------------------#---
XX--------XX----XX----XXXXXXXXXXXX--XXXXXXXX--XX------XXXXXXXXXXXX----------XXXX--XXXX--XX--------XXXXXXXX------------------------------XXXXXX------------------XX----------XX--
XX--------XX----XX----XXXXXXXXXXXX--XXXXXXXX--XX------XXXXXXXXXXXX----------XXXX--XXXX--XX--------XXXXXXXX------------------------------XXXXXX------------------XX----------XX--
