-------------------------------------------------------------------------------------------------------------------------------------------------------------------------------------------
-------------------------------------------------------------------------------------------------------------------------------------------------------------------------------------------
------SS----------------------S---------------------------------------------------------------SS----------SS------------------------------SS----------------QQ------------SS---------------
--SS--------SS------------------------SSSS---S--------------------SS-----------S----------SS--------------------------------------------------------SS--------------------------------SS---
----------------------------SS--------------------------------S-------------------------------------------------------------------------------------------SS-------------------------------
----------------------SS----------------------------------------------------SS--------------------------SS----------SS--------SS--------------------------------------------SS------SS-----
--------------------------------------------------------------------------------SS--------------SS-----------------------------------------------------------------------------------------
--SS------SS----SS----------------SS-------------S----------------------SS----------------------------------------SS----SS----------------------------SSSS----SS----------SS------SS----SS-
------------------SS----------------------------------------------2-------------------------------------------------SSSS--S---SS-----------------------------------------------------------
--------SS--------------SSSS--------------------------------------------------SS----SS--------SS------------SS------------------------------SS------------------SSSS--SS-------------------
----SS----------TT------------------SS----------SS--------------------------------------SS----------SS--SS------SS------------------------------------------------------------------------F
S---------------TT------------------------SS---------S-----------------------------S----------------------------------------------------------SSSS---------------------------------------SS
S---------------TT------------SS--------------2-------------------------------------SS----S-----SS-------------------------------------SSS--------------SS--SS----SS---------------------SS
S-M---------SS--TT----------------SS--SS----------------------SS------------SS----------------------------------------------------SS-----------------------------------------------------SS
XXXX------------XX----XX------------------------XX-------------------------X-----------------------X------------XXXX--XX----XX-------X------XX------------------------------XX------XX---XX
XXXX------------XX----XX------------------------XX-------------------------X-----------------------X------------XXXX--XX----XX-------X------XX------------------------------XX------XX---XX
