----------------------------------------------------------------------------------------------------------------------------------------------------------------------------------------------------------
----------------------------------------------------------------------------------------------------------------------------------------------------------------------------------------------------------
----------------------------------------------------------##------------------------##--------------------------------------------------------------------------------------------------------------------
-----------------------------------------------SS---SS----##------------------------##------------------------------------------------------------------SS------------------------------------SS----------
----------oo--------------------------------------##---------------------------------------------------------------S------------------------------------------------------------------------------##------
--------------------------------------SS----------##------------------------------------oo-----------------------------S-----------------------------------------------g--------------------------##------
--------------------------------------------------------------------------##--------SSQS------------------------------------------------------------------------------SS----------------------------------
--SS--------------------------------K-------------------------------------##-------------------------------------------------------------------o----------------------SS------------------SS--------------
------SS--------SS------------------------SS-----------------------g------------------------o-----------------------------------------------------##----SS------------------##----------------------------
--------------------------------------------------------------------------------------------------------------------------------------------------##------------------------##----------------------------
-------------------------------o---------------------------------S@S----------------------SS----------------------------------------SS--------------------%%%---------------------------------SS----------
------------------------------------------------------------------------------------------SS------SS--------------oo---------------------------------------|----------------------%%%---------------------
--------------------------------------XX--------##------------------SS----------------Q-----------------------------------------------##-------------------|----------------------||------SS----------F---
---M--%%------------------------SS----XX--------##--------------------------%%--------------------------------------------------------##--%%---------------|-------------S--------||------SS----------#---
--XX--|-------XX--------------------X-XX----------XX------------------XX----|-----------------------------XX------------------XX----XX-----|----XX---------|----------------------||------------------XX--
--XX--|-------XX--------------------X-XX----------XX------------------XX----|-----------------------------XX------------------XX----XX-----|----XX---------|----------------------||------------------XX--
