------------------------------------------------------------------------------------------------------------------------------------------------------
------------------------------------------------------------------------------------------------------------------------------------------------------
---------------------------------------------------------------------------------SSS------------------------------------------------------------------
-------------------------------------------------------------R--------------------------------------------------oo------------------------------------
------------------------------------------------------------------------------------------------------------------------------------------------------
------oo------------------------------%%%-----------------------------------------------%%%-------------------SS--------------------ooo---------------
--------------------------------------||-------------------------%%%%-------------------||---------------%%%%-----------------------------------------
--------------------------------------||--------------------------||--------------------||----------SS----||---------ooo------------------------------
-----------------------------%%%%-----||--------------------------||--------------------||----------------||---------%%%%-----------------------------
------------------------------||------||--------------------------||----------------SS--||----------------||----------||------------oo-------------R--
-------------------%%%%-------||------||---%%%%-------------------||--------------------||---------------%%%%%%%------||---------R--------------------
--------------------||--------||------||----||-----------------R--||-----------oo-------||----------------|||||-------||--SS------------------oo------
--------------------||-----R--||------||----||--------------------||--------------------||---%%%%---------|||||-------||---------------------------F--
--M-----------------||--------||------||----||-------oo-----------||----oo--------------||----||----------|||||-------||--------------SS-----------#--
--XXX---------------||--------||------||----||--------------------||--------------------||----||----------|||||-------||--------------------------XXXX
--XXX---------------||--------||------||----||--------------------||--------------------||----||----------|||||-------||--------------------------XXXX
