----------------------------------------------------------------------------------------------------------------------------------------------------------------------------------------------------
----------------------------------------------------------------------------------------------------------------------------------------------------------------------------------------------------
------------------------------------------------------------------------TT----------SS----------------------SS-----------------------------------------------------SSS------------------------------
------------------------------------------------------------------------TT-------------------------------------------------------------------------------------------K------------------------------
------TT----------------SS----------------------------------SS----------TT-----------------------------------------------1--------------------#-----------------------------------------------------
------TT----------------------------------------------------------------TT--------------------------------------------------------------------#-----------------------------------------------------
------TT------------------------------------------------------S---------TT------------S-------------------------------------------------------#-------------------------SS----S---------------------
------TT----------------------------------------------------------------TT-----------------------------------------------ggg------------------#-----------------------------------------------------
------TT----------------------------------------------------------------TT---------------------------------------------######---------SS------#---------------#-------SS----------------------------
------TT----------------------------------------------------------------TT--------------------------------------------##----#-----------------#---------------#-------------------------------------
------TT----------------------------------------------------------------TT------------------------SSQS----------------##----##----------------#---------------##------------------------------------
------TT----------------------------------------------------------------TT--k-----------------------------------------##----##----------Q--?--#---------------##------------------------------------
------TT---------------SQS----------------------------------------------TT--#-----------------------------------------##----##----------------##--------------##---------------------------------F--
-M----TT----------------------------------------------------------------TT--#-----------------------------------------##----##----------------##--------------##---------------------------------#--
XX----XX------------------XX--------XXXX--------------------------------XX--XX----------------XX----------XX----------XX--XXXX----------------XX----XX--------XX--XXXX--------------------X-----XX--
XX----XX------------------XX--------XXXX--------------------------------XX--XX----------------XX----------XX----------XX--XXXX----------------XX----XX--------XX--XXXX--------------------X-----XX--
