--------------------------------------------------------------------------------------------------------------------------------------------------------------------------------
--------------------------------------------------------------------------------------------------------------------------------------------------------------------------------
--------------------------------------------------------------------------------------------------------------------------------------------------------------------------------
--------------------------------------------------------------------------------------------------------------------------------------------------------------------------------
----------------------------------------------------------SS--------------------------------------------------------------------------------------------------------------------
----SS--------------------------------------------------------------------------------------------------------------------------------------------------------------------------
---------------------------------------------------------------#--------------------------SS------------------------------------------------------------------------------------
--------------------------SS----------------------------------##----------------------------------------------------------------------------------------------------------------
------------SS--SS--------------------------------------------##------------SS----------------USS---SS--------------------------------------------------------------------------
-------------------------------------------------------------###-------------------------------------------------K--------------------------------------------------------------
------------------------------------------------------------####--------------------------------------------------------------------------------------1-------------------------
-----------------------------------------------------------#####-------B--------------------------------------------------------------------------------------------------------
--------TT---B-------------------------------------------#######-------b----------------------------------------------------------------SS----------------------------------F---
-M------TT---b------------------------------------SS----########-------b----------------------------------------------------------------------------------------------------#---
XX------XX--XX----------------------------------XX------XXXXXXXX------XX------XX--------------XX--XX--------------XX------XX----------XX----XX--------------XX------------XXXX--
XX------XX--XX----------------------------------XX------XXXXXXXX------XX------XX--------------XX--XX--------------XX------XX----------XX----XX--------------XX------------XXXX--
