------------------------------------------------------------------------------------------------------------------------------------------------------------------------------------------------------------------------------
------------------------------------------------------------------------------------------------------------------------------------------------------------------------------------------------------------------------------
---------------------------------------------------------------------------------------------------------Q--------------------------------------------------------------------------------------------------------------------
------------------------------------y--------------------oo-----------------------------------y-------------------------------------------------------------------------------------------------------------------------------
------------------------------------##------------------o--o----------------------------------##------------------------------------------------------------------------------------------------------------------------------
--------------oo------------------y###-------------------------------------------------------###------oo----------------------------------------------------------------------------------------------------------------------
----------------------------------####-----------------------------------Q------------------####------------------------------------------------------------------------------------------------------------------------------
--------------------------------y#####-----------------------------------------------------#####-----------------------y--------------------oo--------------------------------------------------------------------------------
--------------------------------######-------Q----?---------------------------------------######-------------------QQ?SSQQQ-----Q---------------------------------------------------------------------------------------------
-------------------------------#######--------------------------------oo-----------------#######------------------------------------------------------------------------------------------------------------------------------
------------------------------########--------------------------------------------------########-------TT--------------------------------Q-------------------------------------------------------------------------------Q----
-----------------------------#########--------------------------#----------------------#########-------TT-----------------------------------------------------oo--------------------------------------------------------------
----------------------------##########--------------------------#---------------------##########-------TT--------------------------------------------Q----------------------------------------?---------------------------F---
-M-------------------------###########--------------------------#--------------------###########-------TT-----------------------y-----------------------------------------------------------------------------------------#---
XX------------XX----XX----XXXXXXXXXXXX----XX------XX------XX----XX------XX----------XXXXXXXXXXXX------XXXX--------------XX--XX--XX------XX------XX----------------XX----------------------------------------------------XXXX--
XX------------XX----XX----XXXXXXXXXXXX----XX------XX------XX----XX------XX----------XXXXXXXXXXXX------XXXX--------------XX--XX--XX------XX------XX----------------XX----------------------------------------------------XXXX--
