-------------------------------------------------------------------------------------------------------------------------------------------------------------------------------------------------------------------------------------------------------------------------------------------------------------------------------------------------------------------------------------
-------------------------------------------------------------------------------------------------------------------------------------------------------------------------------------------------------------------------------------------------------------------------------------------------------------------------------------------------------------------------------------
---------------TT--------------SSSS----------------#--------------------------------------------------------------------------------------------------------------------------------------------------------------------------------------------------------------------------------------------------------------------#----------------------TT------------------------------------
---------------TT---------------------------------##----------------------------------------------------------------------------------------------K--------------------------TT-------------------------------------------------------------------------oo---------------------------------------------------------o----#----------------------TT------------------------------------
---------------TT--------------------------------###--------------------------------------------------------------------------------------#----------------------------------TT------------TT---------------------------------------------------------------------------------------------------------------------------#----------------------TT------------------------------------
---------------TT-------------------------------####--------------------------------------------------------------------------------------#----------------------------------TT------------TT---------------------------------------------------------------------------------------------------------------------------#----------------------TT------------------------------------
---------------TT------------------------------#####--------------------------------------------------------------------------------------#----------------------------------TT------------TT--------------------------------------------------------------------------------------------------------------------TT-----#----------------------TT------------------------------------
---------------TT-----------------------------######----------------------------------K---------------------------------------------------#----------------------------------TT------------TT------------------------------------------TT---------------------------------oo---TT-------------------o------------TT-----#----------------------TT--------------------TT--------------
------TT-------TT----------------------------#######--------------------------------------#----------------------------------SSSS---------#----------------------------------TT------------TT------------------------------------------TT--------------------------------------TT------------------------#-------TT-----#----------------------TT-------------#------TT--------------
------TT-------TT----SSUSSS-----------------########--------------------------------------#-----------------------------------------------#------------------------TT--------TT------------TT------------------------------------------TT--------------------------------------TT-----------------------##-------TT-----#----------------------TT-------------#------TT--------------
------TT-------TT-----------------#--------#########--------------------------------------#-----------------------------------------------#------------------------TT--------TT------------TT------------------------------------------TT--------------------------------------TT----------------------###-------TT-----#----------------------TT-------------#------TT--------------
------TT-------TT-----------------#-------##########---------------------------------o----#-----------o-----------------------------------#------------------------TT--------TT------------TT-------------------------------oo---------TT---------------------------oo---------TT---------------------####-------TT-----#---------------oo-----TT-------------#------TT-----oo-------
------TT-------TT-----------------#------###########--------------------------------------#-----------------------------------------------#----------------TT------TT--------TT------------TT------------------------------------------TT------------------TT------------------TT--------------------#####-------TT-----#----------------------TT-------------#------TT----------F---
-M----TT-------TT-----------------#-----############--------------------gg--------gg------#-----------------------------------kk----------#----------------TT------TT--------TT------------TT------------------------------------------TT------------------TT------------------TT-------------------######-------TT-----#----------------------TT-------------#------TT----------#---
XX----XX------XXXX--XX----------XXXX----XXXXXXXXXXXX----------------XX--XX--------XXXX----XX------------------------XX---XXX--XX----------XX--------------XXXX----XXXX------XXXX----------XXXX--------------------------------------XXXXXX----------------XXX-------------XX--XXXXXXXX--------------XXXXXX------XXXXXX--XX--------------XX----XXXXXX--XX------XXXX--XXXX------XXXX---
XX----XX------XXXX--XX----------XXXX----XXXXXXXXXXXX----------------XX--XX--------XXXX----XX------------------------XX---XXX--XX----------XX--------------XXXX----XXXX------XXXX----------XXXX--------------------------------------XXXXXX----------------XXX-------------XX--XXXXXXXX--------------XXXXXX------XXXXXX--XX--------------XX----XXXXXX--XX------XXXX--XXXX------XXXX---
