------------------------------------------------------------------------------------------------------------------------------------------------------
------------------------------------------------------------------------------------------------------------------------------------------------------
-----------------------SS----------------------------%%%%------------------------------------R-----oo-------------------------------------------------
----------------------------------------oo------------||----------------------------------------------------------------------oo----------------------
-------------SS---------------------------------------||-------------------------------------------------------------------------------oo-------------
----------------------------------ooo-----------------||--------------------------------------------------------ooo-------------------------%%--------
------------------------------------------------------||------------------------------------------------------------------------------------||--------
----------------------------%%------------------------||----------------------------------oo------------------------------------------------||--------
----------------------------||------------------------||---%%%-------------------------------------------------------------------%%%--------||--------
----------------------------||------------------------||----|---------SSS-----------ooor------------------------------------------|-----oo--||--------
-----------------------%%%%-||------------------------||----|----------------------%%%%%------------------SSS---------------------|---------||--------
------------------------||--||------------------------||----|-----------------------|||-------------------------------------------|---------||--oo----
------------------------||--||------------------------||----|----------R------------|||-------------------------------------------|---------||-----F--
-M------------------oo--||--||------------------------||----|-----------------------|||---------------SSS-----------%%%-----------|---------||-----#--
XXX---------------------||--||------------------------||----|-----------------------|||-----------------------------||------------|---------||----XXXX
XXX---------------------||--||------------------------||----|-----------------------|||-----------------------------||------------|---------||----XXXX
