-------------------------------------------------------------------------------------------------------------------------------------------------------------------------------------------------------------------------------------------------------------------------------------------------------------------------------------------------------------------------------------
-------------------------------------------------------------------------------------------------------------------------------------------------------------------------------------------------------------------------------------------------------------------------------------------------------------------------------------------------------------------------------------
-------------------------------------------------------------------------------------------------------------------------------------------------------------------------------------------------------------------------------------------------------------------------------------------------------------------------------------------------------------------------------------
---------------------------------TT----------------------------------------------TT-----------------------------------------------------------------------------------------------------------------------------------------------------------------------------------o------SSUSSS--------------------------------------------------------------------------------------------------
-------------TT------------------TT----------------------------------------------TT----------TT--------------------------------2-------------------------------------------------------------------------------------#---------------------------------------------------------------------------------------------------------------------------------------------------------------
-------------TT------------------TT----------------------------------------------TT----------TT----------------------------------K----------------------------------------------------------------------------------##---------------------------------------------------------------------------------------------------------------------------------------------------------------
-------------TT------------------TT----------------------------------------------TT----------TT----------TT------------------------TT---#--------------------------------------------------------------------------###----------------------------------------------------------------------#----------------------------------------------------------------------------------------
-------------TT------------------TT----------------------------------------------TT----------TT----------TT------------------------TT---#-------------------------------------------------------------------------####-----------------------------------------tt---------------------------#----------------------------------------------------------------------------------------
-------------TT------------------TT----------------------------------------------TT---#------TT----------TT------------------------TT---#-------------------------------#----------------------------------------#####-------------------------------------TT--tt---------------------------#-----------------------TT---------------------------------------------------------------
-------------TT------------------TT----------------------------------------------TT---#------TT----------TT------------------------TT---#-------------------------------#---------------------------------------######---o-----SSUSSS----------------------TT--tt--------------SSUSSS-------#-----------------------TT---------------------------------------------------------------
-------------TT------------------TT----------------------------------------------TT---#------TT----------TT------------------------TT---#--------------TT---------------#--------------------------------------#######-------------------------------------TT--tt---------------------------#-----------------------TT-------------------2-----------TT------------------------------
-------------TT------------------TT------------o------------------------oo-------TT---#------TT----------TT------------------------TT---#--------------TT---------------#-------------------------o-----------########-------------------------------------TT--tt---------------------------#-----------------------TT---------------------K---------TT-----------------oo-----------
-------------TT------------------TT-------------#--------------------------------TT---#------TT----------TT------------------------TT---#--------------TT---------------#------------------------------------#########-------------------------------------TT--tt---------------------------#----TT-----------------TT-------------------------------TT--------------------------F---
-M-----------TT------------------TT-------------#-------------------gg-----------TT---#------TT----------TT------------------------TT---#--------------TT---------------#-----------------------------------##########-------------------------------------TT--tt-----oo----------------gg--#----TT-----------------TT-------------------------------TT--------------------------#---
XX----------XXXX----XX--------XXXXXX----------XXXXXX--XX------------XX----------XXXX--XX----XXXX--------XXXX----------------------XXXX--XX------------XXXX----------XX--XX----------------------------------XXXXXXXXXX----------------------XX------------XXXX-XXX--------------XX-----XXXXXXX--XXXX----------XX----XX------------------------XX----XXXX------------------------XX---
XX----------XXXX----XX--------XXXXXX----------XXXXXX--XX------------XX----------XXXX--XX----XXXX--------XXXX----------------------XXXX--XX------------XXXX----------XX--XX----------------------------------XXXXXXXXXX----------------------XX------------XXXX-XXX--------------XX-----XXXXXXX--XXXX----------XX----XX------------------------XX----XXXX------------------------XX---
