------------------------------------------------------------------------------------------------------------------------------------------------------------------------------------------------------------------------------
------------------------------------------------------------------------------------------------------------------------------------------------------------------------------------------------------------------------------
--------Q------------------------------------------------------------------TT----------------1-----------------------TT----------------------------------------------Q--------------------------------------------------------
------------------------y---------------------------oo---------------------TT----------------------------------------TT-------------------------------------------------------------------------------------------------------
------------------------##---------------------------------------------Q---TT----------------------------------------TT------------------------TT-----------------------------------------------------------------------------
-----------------------###-------------------------------------------------TT----------------------------------------TT------------------------TT-----------------------------------------------------------------------------
----------------------####----Q-------------Q-------Q----------------------TT----------------------------------------TT---------------Q--------TT----------------------------------------C-------------------------TT---------
----------oo---------#####-------------------------------------------------TT----------------------------------------TT------------------------TT----------------------y-------------------------------------------TT---------
--------------------######---------Q-------------------------Q-------------TT----------------------------------------TT-------------------Q----TT------------------QQ?SSQQQ---------------------Q------------------TT---------
-------------------#######-------------------------------------------------TT---------------------oo-----------------TT------------------------TT------------------------------------------------------------------TT---------
-----TT-----------########-------------------------------------------------TT----------------------------------------TT------------------------TT------1-----------------------------------------------------------TT---------
-----TT----------#########-------------------------------------------------TT----------------------------------------TT------------------------TT----------------------------------y-------------------------------TT---------
-----TT---------##########-----------------------Q-------------------------TT----------------------------------------TT------------------------TT--------1---------------------QQ?SSQQQ----------------------------TT-----F---
-M---TT--------###########-------------------------------------------------TT----------------------------------------TT------------------------TT------------------------------------------------------------------TT-----#---
XX--XXXXXXX---XXXXXXXXXXXX----XX--------------------------------XX--XX----XXXX--------------------------------------XXXX----XX------------XX--XXXX--------------------------------------------XX----XX------------XXXXXXXXXX--
XX--XXXXXXX---XXXXXXXXXXXX----XX--------------------------------XX--XX----XXXX--------------------------------------XXXX----XX------------XX--XXXX--------------------------------------------XX----XX------------XXXXXXXXXX--
