--------------------------------------------------------------------------------------------------------------------------------------------------------------
--------------------------------------------------------------------------------------------------------------------------------------------------------------
------------SS------------------------------------------------------------------------------------SS----------------------------------------------------------
------------SS--------------SS--------SS------------------SS--------------SS------SS----------SS--SS----------SS--------------------------SS----SSSS--SS------
------------------------------------------------SS----------------------SS------------------------SS------------------SS---S----------------------------------
------SS----------------------------------SS----SS------------SS--------SS----------------SS------SS----SS-----------------S----------------------------------
--------------------------------------SS------------------------------------------------------------SS---------------------SSS--------------------------------
--------------SS----SS--SS----SS--SS------------------------SS------------------------SS----SS----------------------SS--------------SS--SS--SS--------SS------
----SS--------------------------------------------------------------------------------------------------SS------SS------------------------------SS------------
----SS------SS------------------------------SS--SS----------------------SS----------------------SSSS----SS------SS------------------------------SS------------
------SS----------------------------SS--------SS--SS--SS--------------------------------------------------------------------------------------SS--------------
S-----------------------------------SS------------SS--SS--------SS--SS------SS--SS------------------------SS------SS----------SS--SSSS------------------SS----
S---------SS--------------------------------SS--------------------------------SS--SS------------------------SS----SS--SS--------------------------------------
S--M------------SS----SS------SS--------------------SS--------------------SS--SS--------SSSS--SS------SS----SS----SS--SS--SS--------------------SS----------F-
XXXX----------XX----------------XX------XX--XXXX------------------XX----------------------------------------------------XX--XX----------XX----XX--------XX--XX
XXXX----------XX----------------XX------XX--XXXX------------------XX----------------------------------------------------XX--XX----------XX----XX--------XX--XX
