---------------------------------------------------------------------------------------------------------------------------------------------------------------------
---------------------------------------------------------------------------------------------------------------------------------------------------------------------
------------------------------------------------SSoo--------oo---------------------%%%%-----------------SSoo---------------------------------------------------------
----------ooo----------oo-----------------------------------SS----------------------||------------------------ooo----------------------------------------------------
----------------------------%%%-----------------------------------------%%%---------||------------------------------------------------------------------SSS----------
-----------------------------|-------------------------------------------|----------||------------SS--SS-------------------------------------------------------------
------------SS---------------|-------------------------------------------|----------||-------------------------------------------------------------------------------
--------------------ooo------|------------SS------SS---------------------|----------||-------------------------------------------------------------------------------
-----------------------------|-------------------------------------------|----------||--------------------------------------------SS---------------------------------
-----------------------------|-------------------------------------------|----------||----------------------------------------------------------------------ooo------
-----------------------------|------------------------------------SSS----|--%%%-----||-------------------------------------------------------------------------------
---oooooo-------ooo----------|-------------------------------------------|---|------||------------------------------SS-----------------------------------------------
--------------------%%%%-----|-------------------------------------------|---|------||-----------------------------------------------------------------------------F-
-M-------------------||------|-------------------------------------------|---|------||-----------------------------------------------------------------------------X-
XXX--%%%%------------||------|--------------------------%%%%-------------|---|------||-XXXXXXXXXXXXXXXXXXXXXXXXXXXXXXXXXXXXXXXXXXXXXXXXXXXXXXXXXXXXXXXXXXXXXXXXXXXXXX
XXX---||-------------||------|---------------------------||--------------|---|------||-XXXXXXXXXXXXXXXXXXXXXXXXXXXXXXXXXXXXXXXXXXXXXXXXXXXXXXXXXXXXXXXXXXXXXXXXXXXXXX
