------------------------------------------------------------------------------------------------------------------------------------------------------------------------------------------------------------------------------
------------------------------------------------------------------------------------------------------------------------------------------------------------------------------------------------------------------------------
-------TT------------------------------------------Q---Q---------------------------------------------------------------------------------------------------------------------------------------------------------TT------Q----
-------TT-------------------------------------------------------------------------------y------------------------------------------------------------------------------------------------------------------------TT-----------
-------TT-------------------------------------------------------------------------------##-------------------------------C---------------------------------------TT----------------------------------------------TT-----------
-------TT----------------------------------------------------y-------------------------###--------------oo-------------------------------------------------------TT----------------------------------------------TT-----------
-------TT--------C---TT-----------Q----------------------QQ?SSQQQ---------------------####-------Q---------------------------------------------------------------TT----------------------------------------------TT-----------
-------TT------------TT--------------------------------------------------------------#####-------------------------y--------------------------------------y------TT----------------------------------------------TT-----------
-------TT------------TT-------------------------------------------------------------######---------------------QQ?SSQQQ-------------------------Q---------##-----TT----------------------------------------------TT-----------
-------TT------------TT-----------------------------oo-----------------------------#######--------oo-----------------------------------------------------###-----TT----------------------------------------------TT-----------
-------TT------------TT--------------------C--------------------------------------########--------------------------------------------------------------####-----TT------------------------------------------Q---TT-----------
-------TT------------TT----------------------------------------------------------#########-------------------------------------------------------------#####-----TT----------------------------------------------TT-----------
-------TT------------TT------------------------------------------------C--------##########-----Q------------------------------------------------------######-----TT----------------------------------------------TT-------F---
-M-----TT------------TT--------------------------------------------------------###########-----------------------------------------------------------#######-----TT---------------------------------y------------TT-------#---
XX----XXXX----------XXXX------XX--------------------XX----------------------XXXXXXXXXXXXXX----------------------------XX--XX--XX----XX--XXXX--------XXXXXXXX----XXXXXX------------------------------XX----------XXXX------XX--
XX----XXXX----------XXXX------XX--------------------XX----------------------XXXXXXXXXXXXXX----------------------------XX--XX--XX----XX--XXXX--------XXXXXXXX----XXXXXX------------------------------XX----------XXXX------XX--
