----------------------------------------------------------------------------------------------------------------------------------------------------------------------------------------------------------
----------------------------------------------------------------------------------------------------------------------------------------------------------------------------------------------------------
------------------------!-----------------------------------------------------------SS-----------------------------SS-------SS------------------------------------------------------------------!---------
----------------------------------------------------------------------------------------------------------------------------------------------------------------------------------------------------------
----------------------------------------------SS--SS----------------------!-------------------------------------------------------------------------------------------------------------------------------
----------------------------------------------------------------------------------------------------------------------------------------------------------------------------------------------------------
----------------------------------------------------------S!!S----------------------------------------------------------------------------S!S-------------------------------------------------------------
----------------------------------------------------------------------1-----------------------------------------------------------------------------------------------------------------------------------
--------!-----------------------------------------------SS----------SS----------------------------------------S-------------------------------------------------------------------------------SS----------
----------------------------------------------------------------------------------------------------------------------------------------------------------------------------------------------------------
------------------S---------SS------------------------------!---!-----------------------------------------------------------------------------------------------------------------------!-----------------
----------------------------------------------------------------------------------------------------------------------------------------------------------------------------------------------------------
--------------------------------------------------------------------##--------------------------------------------------------------------------------tt-------tt---##--------------------------------F---
---M-----------------------------g----------------------------------##-----------g--------------------------------------------------------------------tt-------tt---##--------------------------gg----#---
XXXXXXXXXXXXXXXXXXXXXXXXXXXXXXXXXXXXXXXXXXXXXXXXXXXXXXXXXXXXXXXXXXXXXXXXXXXXXXXXXXXXXXXXXXXXXXXXXXXXXXXXXXXXXXXXXXXXXXXXXXXXXXXX-----XXXXXXXXXXXXXXXXXXXXXXXXXXXXXXXXX-------------------XXXXXXXXXXXXXXX--
XXXXXXXXXXXXXXXXXXXXXXXXXXXXXXXXXXXXXXXXXXXXXXXXXXXXXXXXXXXXXXXXXXXXXXXXXXXXXXXXXXXXXXXXXXXXXXXXXXXXXXXXXXXXXXXXXXXXXXXXXXXXXXXX-----XXXXXXXXXXXXXXXXXXXXXXXXXXXXXXXXX-------------------XXXXXXXXXXXXXXX--
