-----------------------------------------------------------------------------------------------------------------------------------------------------
-----------------------------------------------------------------------------------------------------------------------------------------------------
----------------------------------------------------------------------------------------------------------SS-----------------------------------------
--------------oo-----------------o-------------o------------------------o----------------------------------------------------------------------------
------------------------------------------SS--------------------------------------------------------------------------------SS--------SSS------------
------oo----o-----------------------o---------------SS--------------o-----------------------------SS------------SSS-----------------------------SS---
-----------------------------------------------------------------------------------------------------------------------------------------------------
-----------------------------------------o----------------------------o--------------R----------------------------------------SS---------------------
-----------------------------------%%%%-------SS-------------------%%%%%----------------------------------------SS--%%%------------------------------
--------------------SS--------------||------------------------------|||-----------------------------o-------SS-------|-------------------------------
----------------------o-------------||------------------------------|||----------------------------------------------|------------%%%----------------
----------------------SSSS-------%%%||------------------------------|||---------------------------------SS-----------|-------------|-----------------
---------------------------%%%%----|||------------------------------|||-----------------------------------------r----|-------------|---------------F-
-M--------------------------||-----|||---------------SSS------------|||---o-------%%--%%%%--SS------%%--------%%%%%%-|-------------|---------------#-
XXX------%%%----------------||-----|||------------------------------|||-----------||---|||-----------|---------|||||-|-------------|-------------XXXX
XXX-------|-----------------||-----|||------------------------------|||-----------||---|||-----------|---------|||||-|-------------|-------------XXXX
