----------------------------------------------------------------------------------------------------------------------------------------------------------------------------------------------------------
----------------------------------------------------------------------------------------------------------------------------------------------------------------------------------------------------------
--------------------------------SS-------------------------------------------------------------------------------------------------------------------------------------SSS--------------------!-----------
----------------------------------------------------------------------------------------------------------------------------------------------------------------------------------------------------------
--S-----------------------------------------------------------------------------SS--------------------------------------------------------------------------S---------------------------------------------
----------------------------------------------------------------------------------------------------------------------------------------------------------------------------------------------------------
------------------------------SS----------------------------!-------------------------------------------------------------------------------------------SS---------@--------------------------------------
----------------------------------------------------------------------------------------------------------------------------------------------------------------------------------------------------------
----------------------------------------------------------------------------S-----------------------------------------------------------------------------------------------------------------------------
----------------------------------------------------------------------------------------------------------------------------------------------------------------------------------------------------------
---------------SS-------------------SS----------------------------SS--------------------------------------SS------------------------!---------------------------------------------------------------------
----------------------------------------------------------------------------------------------------------------------------------------------------------------------------------------------------------
--------------------------------------------------------------------------------------------------------------------------##--------------------------------------------------------------------------F---
---M----------------------------------------------------------------------------------------------------------------------##-------------------------------g------------------------------------------#---
XXXXXXXXXXXXXXXXXX-----------------------------------------------XXXXXXXXXXXXXXX---------------XXXXXXXXXXXXXXXXXXXXXXXXXXXXXXXXXXXXXXXXXXXXXXXXXXXXXXXXXXXXXXXXXXXXXXXXXXXXXXXXXXXXXXXXXXXXXXXXXXXXXXXXX--
XXXXXXXXXXXXXXXXXX-----------------------------------------------XXXXXXXXXXXXXXX---------------XXXXXXXXXXXXXXXXXXXXXXXXXXXXXXXXXXXXXXXXXXXXXXXXXXXXXXXXXXXXXXXXXXXXXXXXXXXXXXXXXXXXXXXXXXXXXXXXXXXXXXXXX--
