------------------------------------------------------------------------------------------------------------------------------------------------------
------------------------------------------------------------------------------------------------------------------------------------------------------
---------%%%%%%%-------------------------------------------------------%%%%--------------------------------%%%-------------------------%%%%-----------
----------|||||---------------------------------------------------------||----------------------------------|-----------------SS--------||------------
----------|||||--------g------------------------------------------------||-----------------------%%%%-------|---------------------------||------------
----------|||||-----%%%%---------------------------------oo-------------||------------------------||--------|---------------------------||------------
----------|||||-----|||-------------------------------------------------||------------------------||--------|---------------------------||------------
----------|||||-----|||-------ooor--------------------------------------||------SS----------------||--------|---------------------------||------------
----------|||||-----|||------%%%%%--------------------------------------||------------------------||--------|---------------------------||------------
----------|||||-----|||-------|||---------------------------------------||------------------------||--------|---------------------------||----oo------
----------|||||-----|||-------|||---------------------------------------||------------------------||--------|--------SSS----------------||------------
----------|||||-----|||-------|||-----------------------------------SS--||------------------------||--------|-----------------SS--------||------------
----------|||||-----|||-------|||---------------------------------------||-----------------oo-----||--------|---------------------------||---------F--
--M-------|||||-----|||-------|||-------------------oo------------------||------------------------||--------|---------------------------||---------#--
--XXX-----|||||-----|||-------|||-----------%%%-------------------------||------------------------||--------|---------------------------||--------XXXX
--XXX-----|||||-----|||-------|||------------|--------------------------||------------------------||--------|---------------------------||--------XXXX
