-------------------------------------------------------------------------------------------------------------------------------------------------------------------------------------------------------------------------------------------------------------------------------------------------------------------------------------------------------------------------------------
-------------------------------------------------------------------------------------------------------------------------------------------------------------------------------------------------------------------------------------------------------------------------------------------------------------------------------------------------------------------------------------
--------------------------------------------------------------------------------#------------------------------------#-------------------------------------------------------------------------------------------------------------------------------------------TT----TT------TT----------------------------------------------------------------------------------------------------
--------------------------------------------------------------------------------#-----------------------------------##---------------o---------------------------------------------------------------------------------------------------------------------------TT----TT------TT----------------------------------o---------o---------------------------------------o---------------
------------------------------------------#-------------------------------------#----------------------------------###-----------------------TT--------------------------------------2-------------TT-----------#----------------------TT------------------------TT----TT------TT-------------------------#--------------------------------------------------------------------------
------------------------------------------#-------------------------------------#---------------------------------####-----------------------TT----------------------------------------K-----------TT-----------#----------------------TT------------------------TT----TT------TT------o------------------#----------------------------------------TT--------------------------------
------------------------------------------#-----------------------------#-------#--------------------------------#####-----------------------TT----------------------------------------------------TT-----------#----------------------TT---------------#--------TT----TT------TT-------------------------#----------------------------------------TT----------------------------2---
------------------------------------------#-----------------------------#-------#---------------------o---------######---------o-------------TT----1-------------------------o-----o---------------TT-----------#----------------------TT---------------#--------TT----TT------TT-------------------------#----------------------------------------TT------------------------------K-
------------------------------------------#-----------------------------#-------#------------------------------#######-----------------------TT----------------------------------------------------TT-----------#----------------------TT---------------#--------TT----TT------TT-------------------------#----------------------------------------TT--------------------------------
------oo----------------------------------#-----------------------------#-------#-----------------------------########-----------------------TT----------------------------------------------------TT-----------#----------------------TT---------------#--------TT----TT------TT-------------------------#----------------------------------------TT--------------------------------
--------------------------------------#---#------TT----------------TT---#-------#----------------------------#########-----------------------TT----------------------------------------------------TT-----------#----------------------TT---------------#--------TT----TT------TT-------------------------#----------------------------------------TT--------------------------------
--------------------------------------#---#------TT----------------TT---#-------#---------------------------##########-----------------------TT----------------------------------------------------TT-----------#----------------------TT---------------#--------TT----TT------TT-------------------------#----------------------------------------TT--------------------------------
--------------------------------------#---#------TT----------------TT---#-------#----------TT--------------###########-----------------------TT----------------------------------------------------TT-----------#------TT--------------TT---------------#--------TT----TT------TT------------2------------#----------------------------------------TT----------------------------F---
-M------------------------------------#---#------TT----------------TT---#-------#----------TT-------------############-----------------------TT-------------------------------ggg---gg-------------TT-----------#------TT---------gg---TT---------------#--------TT----TT------TT--------------K----------#-----------------k----------------------TT----------------------------#---
XX------------XX------X-------XX------XX--XX----XXXXXX------------XXX---XX------XX--------XXXX------------XXXXXXXXXXXX------------------X---XXXX----------XX--------------XX--XXXXXXXX-------------XX-----------XX----XXX---------XX--XXXX----XX--------XX--XX--XXXX---XXXXX---XXX------------------------XX------XX--XXXX--XX---------------------XXX--------------XX----XXXX--XX---
XX------------XX------X-------XX------XX--XX----XXXXXX------------XXX---XX------XX--------XXXX------------XXXXXXXXXXXX------------------X---XXXX----------XX--------------XX--XXXXXXXX-------------XX-----------XX----XXX---------XX--XXXX----XX--------XX--XX--XXXX---XXXXX---XXX------------------------XX------XX--XXXX--XX---------------------XXX--------------XX----XXXX--XX---
