------------------------------------------------------------------------------------------------------------------------------------------------------
------------------------------------------------------------------------------------------------------------------------------------------------------
-----------------------------------------------------------------------------------------------------oo-----------------------------------------------
--------------------------------------------------------------------------------------------------------------------------------------ooo-------------
-----------------------------------------------------------------------------------------------SSS-----------------------%%%%----%%%%-----------------
------------------------------------------------ooo---%%%-------------------------------SS--------------------------------||------||------------------
------------------------------------------------------||------------------------------------------------------------------||------||------------------
--------------------oo--------------------------------||------------------------------------SS----------------SS----------||------||------------------
---------------------------%%%%----------------g------||-----------------------------%%%%------------R--------------------||------||-------SSS---R----
----------------------------||--------------%%%%------||----------------oo------------||----------------------------------||------||------------------
----------------------------||--------------||||------||---------------------g--------||----------------------------------||------||------------------
--------------oo------------||--------------||||------||------------------%%%%----oo--||----------------------------------||------||----SS------------
-------------------------g--||---------%%%%-||||------||------------------||||--------||----------------------------------||------||---------------F--
--M----SSS------------%%%%--||----------||--||||------||------------------||||--------||----------------------------------||------||---------------#--
--XXX------%%%%-------||||--||--%%%-----||--||||------||------------------||||--------||----------------------------------||------||--------------XXXX
--XXX-------||--------||||--||---|------||--||||------||------------------||||--------||----------------------------------||------||--------------XXXX
