-----------------------------------------------------------------------------------------------------------------------------------------------------
-----------------------------------------------------------------------------------------------------------------------------------------------------
-------------------------------%%%%-------------------------?----------------%%%%--------------------------------------------------------------------
----------------o--------SSS----||--------------------SS----------------------||--------------------------------------------------SS-----------------
--------------------------------||--------------------------------------------||---------------------------------------------------------------------
---------o----------SS----------||--------------------------------------------||---------------------------------------------------------------------
------------------------SS------||--------------------------------------------||-------------------------SSS-----------------------------------------
----SS-----SSS----SS------------||--------SS-----o-------------SSS--------SS--||---------------------------------------------------------------------
--------------------------------||--------------------------------------------||%%%------------------------------------------------------------------
--------------------------------||-------------o------------------------------||-|-----------------------------------------%%%-----------------------
---SSS--------------------------||--------------------------------------------||-|------------------------------------------||--------SS-------------
--------------------------------||-----------------------------------%%%------||-|------SS------------------o---SS----------||----SS-----------------
-------------------%%%%---------||------------------------------------||------||-|------------------------------------------||%%%------------------F-
-M------SS--%%------||-------o--||------------------------------------||------||-|----%%-------SSS------------------SS--%%--||-|-------------------#-
XXX---------||------||--%%%%----||-%%%--------------------------------||------||-|----||--------------------------------||--||-|-----%%%---------XXXX
XXX---------||------||---||-----||--|---------------------------------||------||-|----||--------------------------------||--||-|------|----------XXXX
