----------------------------------------------------------------------------------------------------------------------------------------------------------------------------------------
----------------------------------------------------------------------------------------------------------------------------------------------------------------------------------------
-----------------ooo---------------------------------------QQ-------------------------------------------------------------------2-------------------------------------------------------
----------------------------------------------------------------------------------------------------------------------------------------------------------------------------------------
----------------------------------------------------------------------------------------------------------------------------------------------------------------------------------------
-----------------------y----------------------------------------------------------------------------------------------------------------------------------------------------------------
-------------------###############################################------------------------2------------------------------------------------------------###############------------------
------------------################################################------------------------------------------------------------------------------------################------------------
------------------XX------------------------------------------------SS--------------------------------------------------------------------------------XX---------------------------US---
------------------XX----------------------------------------------------------------------------------------------------------------------------------XX--------------------------------
-----------###----XX----------------------------------SS--------------------------------------------------------------------------o-------------------XX--------------------------------
----------####----XX----------------------------------------------------------------------------------------------------------------------------------XX--------------------------------
----------XX------XX------------------------------------------------------------------------------------------------------------------------------XX--XX----------------------------F---
----M-----XX------XX------------------------------------------------------------------------------------------------------------------------------XX--XX----------------------------#---
----XX----XX----XXXX--------------------------------------------------------------------------------------------------XX------XX--XXXX----XX------XX--XX--------------------------XXXX--
----XX----XX----XXXX--------------------------------------------------------------------------------------------------XX------XX--XXXX----XX------XX--XX--------------------------XXXX--
