------------------------------------------------------------------------------------------------------------------------------------------------------
------------------------------------------------------------------------------------------------------------------------------------------------------
-----------------------------------------------------------%%%%--------%%%%----------------------------------------------SSS--------------------------
----------------------------------------------oo------------||----------||----------------------------------SS----ooo-----------------------------SS--
---------------------------------------------------------g--||----------||----------------------------------------------------------------------------
------------------------------------------------------%%%%--||------ooo-||------------------------------------ooo-----------------------------SS------
------------------------------------------------------|||---||----------||-------------------R--------------------------------------------------------
------------------------------------------------------|||---||----------||----------------------------------------------------------------------------
---------------------------g-----------------------g--|||---||----------||-----------------------------------------------------------------%%%%-------
------------------------%%%%--------------------%%%%--|||---||------oo--||---oo-----------------------------oo----------------oo------------||--------
------------------------||||--------------------||||--|||---||----------||-------%%%%-------------------------------------------------------||--------
------------------------||||--------SS--%%%-----||||--|||---||----------||--------||------oo------------------------------------------------||--------
------------------------||||------------||------||||--|||---||----------||--------||--------------------------------------------------------||-----F--
--M---------------------||||------------||------||||--|||---||---oo-----||--------||--------------------------------------------SS----------||-----#--
--XXX---%%%-------------||||------------||------||||--|||---||----------||--------||------------------------------------%%%-----------------||----XXXX
--XXX----|--------------||||------------||------||||--|||---||----------||--------||-------------------------------------|------------------||----XXXX
