---------------------------------------------------------------------------------------------------------------------------------------------------------------------
---------------------------------------------------------------------------------------------------------------------------------------------------------------------
------------------------------------------------------SS--------------%%%-------------------------------------------SS----------------SSS----------------%%%%--------
-----------------------------------------------------------------------|----------------------------------------------------------------------------------||---------
------------------------SS---------------------------------------------|----------------------------------------------------------------------------------||---------
--------------------------------------ooo------------------------------|---------------------------------------%%%%---------------------------------------||---------
----------------------------SSS----------------------------------------|--------------------SS------------------||--------------------------SS------------||---------
-----------------------------------------------------------------------|-----------------------------------%%%%%||----------------------------------------||---------
-----------------------------------------------------------------------|------------------------------------|||-||---SS-----------------------------------||--SSS----
--------------------------------------------------SS-------------------|-------------------------------%%%%%|||-||----------------------------------------||---------
------------------------------------SSoo-------------------------------|--------------------------------|||-|||-||----------------------------%%%---------||---------
-----------------------------------------------------------------------|---------------------------%%%%%|||-|||-||------------SS---------------|----------||---------
----------------------%%%------SS---------------------SSoo--------SSS--|----------------------------|||-|||-|||-||--------------SS--------oo---|----------||-------F-
-M---------------------|----------------------------------------------%%%%%%%%%%%%%%%%%%%%%%%%%%%%%%|||-|||-|||-||------------------------SS---|----------||-------X-
XXX--%%%%--------------|-----------------------------------------------||||-|||-|||-|||-|||-|||-|||-|||-|||-|||-||-----------------------------|----------||-XXXXXXXX
XXX---||---------------|-----------------------------------------------||||-|||-|||-|||-|||-|||-|||-|||-|||-|||-||-----------------------------|----------||-XXXXXXXX
