-----------------------------------------------------------------------------------------------------------------------------------------------------
-----------------------------------------------------------------------------------------------------------------------------------------------------
-----------------------------------------------------------------------------SSS---------------------------------------------------------------------
---------------------SSS--------------------------------------------------------------SS--------------------------o----------SSS---o---SSS-----------
-------------------------------------------------%%%%----------------%%%%----------------SSS---------------------------------------------------------
------------------o----------------o--------------||------------------||---------------------------------o----------------------------------%%-------
--------------------------------------------------||------------------||---------------------------------------------------------------------|-------
--------------------------------------------------||------------------||------------------------------------------------------o--------------|--SS---
-------------------------------------------%%%%---||------------------||---------------------------------------------------------------------|-------
-------------------SSS-----o-----------o----||----||------------o-----||---------------------------------SSS----------oo----------SS-----o---|-------
--------------------------------------------||----||------------------||---------------------------------------------------------------------|-------
--------------------------------SS----------||----||--SS------SS------||--oo--------------------------------------%%-------------------------|-------
--------------------------------------------||----||------------------||-------------------------------------------|-------------------------|-----F-
-M---------%%%------------%%----------------||----||------------%%----||----------------------------------%%---%%%-|--------%%----o----------|-----#-
XXX----------|-------------|----------------||----||--%%%%------||----||-----------------------------------|----||-|--------||---------------|---XXXX
XXX----------|-------------|----------------||----||---||-------||----||-----------------------------------|----||-|--------||---------------|---XXXX
