--------------------------------------------------------------------------------------------------------------------------------------------------------------
--------------------------------------------------------------------------------------------------------------------------------------------------------------
----------------------------------SS------------------------------------SS----------------SS------------------------------------------------------------------
------------------------------------------------------SS--SS------------SS------SS----SS----------------------SS----------------------------------------------
------------SS--------------------------SS---------S--------------------------SS--------------------------SS------------------------SS------------------------
--SS----------------SS----SS------------SS----SS---S-----------------------C--SS----------------------------------------------------SS--------SSSS------------
------SS------------------------SS--------SS-------SSS-----------------S--------------------------------------------------------------------------------SS----
------SS------------------------SS-------------------------------------S--------SS-----------------C----------SS--SS--SSSSSS----------------SS----------------
----------------------------------SS-----------------------------------SSS----------------------------------------------------------SS------------------------
----SS--------SS--------------SS--SS------------SS--------SSSS--------------------SS--------------------------------------------SS--SS--------------SS--------
----SS--------------------SS--SS--SSSS------------SS------------SS------------------------SS------------------------------------------------------------------
S---SS------SS------SS--------SS----SS--------------------------SS----------SS------SS----SS--------SS----------------------SS------------SS------------------
S-------------------------------------------SS------------------------------------------------------------------------------------------------SS--------------
S--M------SS----SSSS------------------------SS--------SS------------------------------SS----SS--------------------SS--SS----------------------SS------------F-
XXXX----------------------------XX----------XX---XXX--------XX------XX----------XX--XX--XX----XX------------------------------XX----XX----------XX--------XXXX
XXXX----------------------------XX----------XX---XXX--------XX------XX----------XX--XX--XX----XX------------------------------XX----XX----------XX--------XXXX
