------------------------------------------------------------------------------------------------------------------------------------------------------
------------------------------------------------------------------------------------------------------------------------------------------------------
------------------------------------------------------------------------------------------------------------------------------------------------------
--------------------------------------------------------------------------------------------------------------------------%%%-------------------------
-----------------------------------------------------%%%%------------------------oo----------------------%%%%%%-----------||--------------------------
------------------------------------------------------||----------------------------------ooo-------------||||------------||--------------------------
-------------------------------------%%%%----%%%%-----||-------%%%%---------------------------------------||||-----------%%%%-------------------------
-------R------------------------------||------||------||--------||----------------------------------------||||------------||--------------------------
--------------------------------------||------||------||--------||-------------------------------%%%%-----||||------------||-------%%%%---------------
--------------------------------------||------||------||--------||--------------------------------||------||||------------||--------||----------------
-------------oo----------R------------||------||------||--------||---%%%%-------------------------||------||||------------||--------||----------------
--------------------------------------||------||------||--------||----||--------------------------||---R--||||------------||--------||----------------
--------------------------------------||------||------||--------||----||--------------------------||-----%%%%%%-----------||--------||-------------F--
-M------------------------------------||------||------||--------||----||--------------------------||------||||----oo------||--------||--oo---------#--
XXX---------------------%%%-----------||------||------||--------||----||--------------------------||------||||------------||--------||------------XXXX
XXX----------------------|------------||------||------||--------||----||--------------------------||------||||------------||--------||------------XXXX
