-------------------------------------------------------------------------------------------------------------------------------------------------------------------------------------------------------------------------------------------------------------------------------------------------------------------------------------------------------------------------------------
-------------------------------------------------------------------------------------------------------------------------------------------------------------------------------------------------------------------------------------------------------------------------------------------------------------------------------------------------------------------------------------
-----------------------------------------------------------------------TT---------#---------TT--------------------------------------------#-------------TT------------------------------------------------------------------------------------------------------------------------------#----------TT--------------------------------------------------------------------------------
-----------------------------------------------------------------------TT---------#---------TT--------------------------------------------#-------------TT--------------------------------------------------------------------------------------------K---------------------------------#----------TT--------------TT----------------------TT----------------------------------------
-----------------------------------------------------------------------TT---------#---------TT--------------------------------------------#-------------TT------------------------------------------------------------------------------------------------------------------------------#----------TT--------------TT----------------------TT----------------------------------------
-----------------------------------------------------------------------TT---------#---------TT--------------------------------------------#-------------TT------------------------------------------------------------------------------------------------------------------------------#----------TT--------------TT----------------------TT---K------------------------------------
-----------------------------------------------------------------------TT---------#---------TT--------------------------------------------#-------------TT-----------------------SSSS--------------------------------------------------------------------------------------------TT-----#----------TT--------------TT----------------------TT----------------------------------------
-------------------o----oo---------------------------------------------TT---------#---------TT--------------------------------------------#-------------TT---------------------------------------------------------------------------------------------TT------------------------TT-----#----------TT--------------TT----------------------TT-----------------------o----------------
------------------------------------------------------------------#----TT---------#---------TT--------------------------------------------#-------------TT-----------------------------------------------------------------------------------#---------TT------------------------TT-----#----------TT--------------TT-----#----------------TT-----#----------------------------------
-------TT---------------------------------------------------------#----TT---------#---------TT--------------------------------------------#-------------TT------------------------------o---------------------------------------------------##---------TT------------------------TT-----#----------TT--------------TT-----#----------------TT-----#----------------------------------
-------TT---------------------------------------------------------#----TT---------#---------TT--------------------------------------------#-------------TT---------------------------------------------------------------------------------###---------TT------------------------TT-----#----------TT--------------TT-----#----------------TT-----#----------------------------------
-------TT---------------------------------------------------------#----TT---------#---------TT-------------------------------------1------#-------------TT-----------------------------------------------------------SSUSSS---------------####---------TT------------------------TT-----#----------TT--------------TT-----#----------------TT-----#----------------------------------
-------TT------------#--------------------------------------------#----TT---------#---------TT--------------------------------------------#-------------TT-------------------------------------------------------------------------------#####---------TT------------------------TT-----#----------TT--------------TT-----#----------------TT-----#------------------------------F---
-M-----TT-----------##--------------------------------------------#----TT---------#---------TT----------------------------------k---------#-------------TT------------------------------------------------------------------------------######---------TT-----o------------------TT-----#----------TT--------------TT-----#----------------TT-----#------------------------------#---
XX----XXXX----------XX------------------------------------------XXXXXXXXXX--XX----XX--------XX--------------XX--XX--------------XX--------XX------------XX--------XXXX--------XX--------------XX-XXX----------------------XXXXXX----XX--XXXXXX------XXXXXX--------XX------------XXXX----XX------XX-XX-----XX------XXXX---XXX------XX------XXXX----XX----------------------------XX---
XX----XXXX----------XX------------------------------------------XXXXXXXXXX--XX----XX--------XX--------------XX--XX--------------XX--------XX------------XX--------XXXX--------XX--------------XX-XXX----------------------XXXXXX----XX--XXXXXX------XXXXXX--------XX------------XXXX----XX------XX-XX-----XX------XXXX---XXX------XX------XXXX----XX----------------------------XX---
