------------------------------------------------------------------------------------------------------------------------------------------------------
------------------------------------------------------------------------------------------------------------------------------------------------------
------------------------------------------------------------------------------------------------------------------------------------------------------
----------------------------------------SS-------------------------------r----------------------------oo----------------------------------------------
---------------------------------%%%%%%------------------oo------------%%%%----------------------------------------------------SSS--------------------
----------------------------------||||----------------------------------||----------------------------------------------------------------------------
----------------------------------||||----------------------------------||-------------------------%%%%----------------%%%%--------------%%%%%%-------
----------------------oo----------||||----------------------%%%---------||--%%%---------------------||------------------||----------------||||--------
----------------------------------||||----------------------||---------%%%%-||----------------------||------------------||----------------||||--------
--------------------oo------------||||----------------------||----------||--||----------------------||--------oo----oo--||----------------||||--------
-----------%%%--------------------||||----------------------||----------||--||----------------------||------------------||----------------||||--------
----oo------|---------------------||||---R------------------||--SS------||--||----oo----------------||------------------||----------oo----||||--------
------------|--------%%%%%%-------||||----------------------||----------||--||----------------------||------------------||----------------||||-----F--
--M---------|---------||||--------||||----------%%%---------||----------||--||----------------------||------------------||----------------||||-----#--
--XXX-------|---------||||--------||||----------||----------||----------||--||----------------------||------------------||----------------||||----XXXX
--XXX-------|---------||||--------||||----------||----------||----------||--||----------------------||------------------||----------------||||----XXXX
