-------------------------------------------------------------------------------------------------------------------------------------------------------------------------------------------------------------------------------------------------------------------------------------------------------------------------------------------------------------------------------------
-------------------------------------------------------------------------------------------------------------------------------------------------------------------------------------------------------------------------------------------------------------------------------------------------------------------------------------------------------------------------------------
---------------------------------------TT--------------------------------------------------------------------------------------------------------------------------------------------------------------------------------------------------------------------------------------------------------------------------------------------------------------------------------------------
-------------tt------------------------TT---------------------------------------------------oo----------------------------------------------------------------------------------------------------------------------------------------------------------oo---------------------------------------------------------------------------------------------------------------------------
---------TT--tt------------------------TT----------------------------------------------------------------------------------------------------------------------------------------------------------------------------------------------------------------------------------------------------------------------TT-------------------------------TT-----------------------------------
---------TT--tt------------------------TT----------------------------------------------------------------------------------------------------------------------------------------------------------------------------------------------------------------------------o-----------------------------------------TT-------------------------------TT-----------------------------------
---------TT--tt------------------------TT-------------------------------------------------------#------------------------------------------------TT------------------------------#-------------------------------TT----------------------#---------------------------------------------------------------------TT-------------------------------TT-----------------------------------
---------TT--tt------------------------TT-------------------------------------------------------#------------------------------------------------TT-----------------------K-----##-------o-------TT--------------TT---------------------##----------------------------------------------oo---------------------TT-------------------------------TT-----------------------------------
---------TT--tt------------------------TT-------------------------------------------------------#------------------------------------------------TT----------------------------###---------------TT--------------TT--------------------###------------#---------------#--------------------------SSSS----------TT-------------------------------TT-----------------------------------
---------TT--tt------------------------TT-------------------------------------------------------#------------------------------------------------TT---------------------------####---------------TT--------------TT-------------------####------------#---------------#----------------------------------------TT---o---------------------------TT-----------------------------------
---------TT--tt------------------------TT------------TT-----------------------------------------#------------------------------------------------TT--------------------------#####---------------TT---------TT---TT----------TT------#####------------#---------------#----------------------------------------TT-------------------------------TT-----------------------------------
---------TT--tt------------------------TT------------TT-----------------------------------------#------------------------------------------------TT-------------------------######---------------TT---------TT---TT----------TT-----######------------#---------------#-------oo-------------------------------TT-------oo----------------------TT-----------------------------------
---------TT--tt------------------------TT------------TT-----------------------------------------#--------------------------------------TT--------TT------------------------#######---------------TT---------TT---TT----------TT----#######------------#---------------#----------------------------------------TT-------------#-----------------TT------#------------------------F---
-M-------TT--tt------------------------TT------------TT-------------o---------------------------#--------------------------------------TT--------TT-----------------oo----########---------------TT---------TT---TT----------TT---########-----k------#----k----------#----------------------------------------TT-------------#-----------------TT------#---------------oo-------#---
XX------XXXX-XXX--------XX----XX------XXXX--XX------XXX-----------------------------------------XX----------------------XX--------XX--XXXXXX----XXXX----XX----------------XXXXXXXX--------------XXXXXX--XXXXXX--XXXX---------XXX--XXXXXXXX----XX------XX--XX----------XX------X---------XX--------------------XXXX------------XX--X---------XX--XX------XX--XX------XX--------XXXX---
XX------XXXX-XXX--------XX----XX------XXXX--XX------XXX-----------------------------------------XX----------------------XX--------XX--XXXXXX----XXXX----XX----------------XXXXXXXX--------------XXXXXX--XXXXXX--XXXX---------XXX--XXXXXXXX----XX------XX--XX----------XX------X---------XX--------------------XXXX------------XX--X---------XX--XX------XX--XX------XX--------XXXX---
