-------------------------------------------------------------------------------------------------------------------------------------------------------------------------------------------------------------------------------------------------------------------------------------------------------------------------------------------------------------------------------------
-------------------------------------------------------------------------------------------------------------------------------------------------------------------------------------------------------------------------------------------------------------------------------------------------------------------------------------------------------------------------------------
------------------------#------------------------------------------------------------------------------------------TT--------------------TT---------------------------------------------------------------------------------------------------#---------------------------------------------------#--------------------#-------------------------------------------------------------
------------------------#--------------------------------------------------------------------o---------------------TT-----------o--------TT------------------------------------------------------------------1--------------------------------#---------------------------------------------------#-------------------##-------------------------------------------------------------
------------------------#------------------------------------------------------------------------------------------TT--------------------TT-----------------------------------------------------------------------#---------------------------#---#------------------------------------------TT---#------------------###--------------------------------------------#----------------
------------------------#------------------------------------------------------------------------------------------TT--------------------TT-----------------------------------------------------------------------#---------------------------#---#------------------------------------------TT---#-----------------####--------------------------------------------#----------------
-----------2------------#--------------SSSS------------------------------------------------------------------------TT--------------------TT-----------------------------------------------------------------------#---------------------------#---#------------------------------------------TT---#----------------#####--------#----------------SSSS---------------#----------------
-------------K----------#---------------------------------------------------------oo-------------------------------TT--------------------TT-----------------------------------------------------------------------#---------------------------#---#-----------------------------------o------TT---#-----oo--------######--------#-----------------------------------#----o-----------
-------------------TT---#-----------#------------------------------------------------------------------------------TT--------------------TT-----------------------#-------------------------------------------#---#---------------------------#---#------------------------------------------TT---#--------------#######--------#-----------#-----------------------#----------------
-------------------TT---#-----------#--------------------------------------------------------o---------------------TT------------TT------TT-----------------------#-------------------------------------------#---#---------------------------#---#----------------------------o-------------TT---#-------------########--------#-----------#-----------------------#----------------
-------------------TT---#-----------#------------------------------------------------------------------------------TT------------TT------TT-----------------------#-------------------------------------------#---#---------------------------#---#-----#------------------------------------TT---#------------#########--------#-----------#-----------------------#----------------
-------------------TT---#-----------#-------------------------------------oo-----o---------------------------------TT------------TT------TT-----------------------#----------------------tt-------------------#---#---------------------------#---#-----#------------------------------------TT---#-----------##########--------#-----------#--------o--------------#----------------
-------------------TT---#-------#---#-----------------------#--------------------------------------------------TT--TT------------TT------TT-----------------------#------------------TT--tt-------------------#---#---------------------------#---#-----#------------------------------------TT---#----------###########--------#-----------#-----------------------#------------F---
-M-----------------TT---#-------#---#-----------------------#--------------------------------------------------TT--TT------------TT------TT-----------------------#------------------TT--tt-------------------#---#---------------------------#---#-----#------------------------------------TT---#---------############--------#-----------#---------------gg------#------------#---
XX--XX-------------XXX--XXXX--XXXX--XX--------------XX------XX----------------------------------------------XXXXXXXXXX--------XXXXX-----XXXX------XX------XX------XX--------XX------XXXX-XXX----X-XX----------XXXXXX------XX------------------XX--XX----XX----------------------------------XXXX--XX--------XXXXXXXXXXXX--------XX----------XX------XXXX----XX------XX----------XXXX-
XX--XX-------------XXX--XXXX--XXXX--XX--------------XX------XX----------------------------------------------XXXXXXXXXX--------XXXXX-----XXXX------XX------XX------XX--------XX------XXXX-XXX----X-XX----------XXXXXX------XX------------------XX--XX----XX----------------------------------XXXX--XX--------XXXXXXXXXXXX--------XX----------XX------XXXX----XX------XX----------XXXX-
