-----------------------------------------------------------------------------------------------------------------------------------------------------
-----------------------------------------------------------------------------------------------------------------------------------------------------
----------------------------------------------------------o------------------------------------------------------------------------------------------
-----o---o------------------oo----------------------------SSSS-------------------------------------------SSS--------------------------------------o--
----------------------------------------------o---------------------------------------------------------------------------------------------%%%------
----------------------------------------------SSSS-----o-----------------------------------------------------------------------------o-------|-------
------------------------------------SS------------SS----------------------------------------------------SS-----------------------------------|-------
--------------------------------------------------------SS---o---------------------------------%%%-------------------------------------------|-------
-----------------------------------------------------------------------------------------SSS----||-------------------------------------------|-------
--------------------------------------------------------------------------o---------------------||------------------------------o--------o---|-------
------------------------------------------------------------------------------------------------||-------------------------------------------|-------
---o--------------------------o--------------------------------------------------%%%------------||-----o-------------------------------------|-------
-----------------------------------------------------------------%%%%--------------|------------||-------------------------------------------|-----F-
-M------%%----------------------------%%------%%------------------||----%%---------|----%%------||--%%------%%---R------------------oo-------|-----#-
XXX-----||-----------------------------|-------|------------------||----||---------|----||------||--||-------|-------------------------------|---XXXX
XXX-----||-----------------------------|-------|------------------||----||---------|----||------||--||-------|-------------------------------|---XXXX
