---------------------------------------------------------------------------------------------------------------------------------------------------------------------
---------------------------------------------------------------------------------------------------------------------------------------------------------------------
----------------%%%-----------------------------------SS----------------------------------------------SSS---------%%%-----------SS-------%%%%------------------------
-----------------|-------------------------------------------------------------------------------------------------|----------------------||-------------------------
-----------------|-------------------------------------------------------------------------------------------------|----------------------||-------------------------
-----------------|-----------------------------------------------------------------------------------------%%%%----|--SS------------------||-------------------------
-----------------|----------SSS-----------------SSS---------------------------------------------------------||-----|----------------------||-------------------------
-----------------|-------------------------------------------------------------------------------------%%%%%||-----|----------------------||-------------------------
-----------------|----------------oo--------------------------------------------------------------------|||-||-----|----------------------||-------------------------
-----------------|----------------SS---------------------------------------------------------------%%%%%|||-||-----|----------------------||-------------------------
-----------------|----------------------------------------------------------------------------------|||-|||-||-----|----------------------||-------------------------
-----------------|-----------------------------------------------------------------------------%%%%%|||-|||-||-----|----------------------||-------------------------
-------------SS--|------------------------------------------------------------------------------|||-|||-|||-||-----|----------------------||-----------------------F-
-M--------------%%%%%%%%%%%%%%%%%%%%%%%%%%%%%%%%%%%%%%%%%%%%%%%%%%%%%%%%%%%%%%%%%%%%%%%%%%%%%%%%|||-|||-|||-||-----|----------------------||-----------------------X-
XXX--%%%%%-------||-|||-|||-|||-|||-|||-|||-|||-|||-|||-|||-|||-|||-|||-|||-|||-|||-|||-|||-|||-|||-|||-|||-||-----|----------------------||-XXXXXXXXXXXXXXXXXXXXXXXX
XXX---|||--------||-|||-|||-|||-|||-|||-|||-|||-|||-|||-|||-|||-|||-|||-|||-|||-|||-|||-|||-|||-|||-|||-|||-||-----|----------------------||-XXXXXXXXXXXXXXXXXXXXXXXX
