---------------------------------------------------------------------------------------------------------------------------------------------------------------------
---------------------------------------------------------------------------------------------------------------------------------------------------------------------
----------------SS------%%-------------------------------------------------------------------%%%--SSoo------%%--------SS------------------%%-----------------SS------
-----SSS----------------------------------------------------------ooo-----------------------------------------------------------------SS-----------------------------
--%%--------------------------------------------------%%--------------------------%%--------------------------------%%--SS--------%%--------------------%%-----------
----------------------------------------------------------ooo-------------------------------------------------------------------------------ooo----------------------
------------------------------------------%%----SS-------------------------------------------------------------------------------------------------------------------
---------------------------------------------------------------------------------------------------------------------------------------------------------------------
------%%-------------------%%%------SS------------------%%---------------------%%%------------SS----------------------%%----------------%%---------------------------
----------------------------------------------SS-------------------------------------------------------------oo------------------------------------------------------
--------%%----------------------------SS-----------------------------------------------%%%-----------%%%-----------------------------SSS-----------------------------
---------------------------------------------------------------------------------------------------------------------------------------------------------------------
---------------SS--------------------------SSS--------------------------%%------------------%%----------------------------------------------SS------%%------%%-----F-
-M--------------------------------------------------------------------------------------------------------------------------------SS-------------------------------X-
XXX--%%%----%%--------------%%%---------%%------------------------------------%%--------------------------------------%%-----------------------------------------XXXX
XXX--------------------------------------------------------------------------------------------------------------------------------------------------------------XXXX
