----------------------------------------------------------------------------------------------------------------------------------------------------------------------------------------------------------
----------------------------------------------------------------------------------------------------------------------------------------------------------------------------------------------------------
--------------------------------------------------------------------------------------------------------------!-------------------------------------------------------------------------------------------
----------------------------------------------------------------------------------------------------------------------------------------------------------------------------------------------------------
-------SSS----------------------SS----------------------------SS-------------------SSS---SS---------------------------------------------SS----------------------------------------------------------------
----------------------------------------------------------------------------------------------------------------------------------------------------------------------------------------------------------
----------------------S-------------------------SS------------------------------------------------------------------------------SS!S----------------------------------------------------------------------
----------------------------------------------------------------------------------------------------------------------------------------------------------------------------------------------------------
------S----@------------------------------!---------------------!-------------!-----------------------------------------SS!S----------------------------------------------------SS------------!-----------
----------------------------------------------------------------------------------------------------------------------------------------------------------------------------------------------------------
--------------------------------------------------------------------------------------------------------------------SS----------------------------S!!S----------#-------!---------------------------------
----------------------------------------------------------------------------------------------------------------------------------------------------------------##----------------------------------------
--------##------------------------------------------SS----------------------------------------------------------------tt----------------------------------------##------------------------------------F---
---M----##------------------------------------------------------------------------------------------------------------tt--------------------gg------------------##---------------------g--------------#---
XXXXXXXXXXXXXXXXXXXXXXXX-----------------------------------------XXX---XXXXXXXXXXXXXXXXXXXXXXXXXXXXXXXXXXXXXXXXXXXXXXXXXXX-------------XXXXXXXXXXXXXXXXXXXXXXXXXXXXXXXXXXXXXXXXXXXXXXXXXXXXXXXXXXXXXXXXX--
XXXXXXXXXXXXXXXXXXXXXXXX-----------------------------------------XXX---XXXXXXXXXXXXXXXXXXXXXXXXXXXXXXXXXXXXXXXXXXXXXXXXXXX-------------XXXXXXXXXXXXXXXXXXXXXXXXXXXXXXXXXXXXXXXXXXXXXXXXXXXXXXXXXXXXXXXXX--
