---------------------------------------------------------------------------------------------------------------------------------------------------------------------
---------------------------------------------------------------------------------------------------------------------------------------------------------------------
--------------%%%----------------------------------------------------------------%%%%---------------------------------------SSS--------------------------------------
---------------|------------------------------------------------------------------||------------------------------------------------ooo----------------oo-------SS---
---------------|--------------------------------------------------SS----SSoo------||----------------------------------------------SSS-----SS--------SS---------------
---------------|------------------------------------------------------------------||---------------------------------------------------------------------------------
---------------|--------------------------------------------SSoo----------SS------||--------------------------------------------------------------------SS-----------
---------------|---------------------------------%%%%-----------------------------||----------------------------------------------------SS---------------------------
--SS-----------|----------------------------------||------------SSS---------------||--------------------------------------------------------SS-----------------------
---------------|-----------------------------%%%%%||------------------------------||---------------------------------------------------------------------------------
---------------|------------------------------|||-||--------SS--------------------||---------------------------------------------------------------------------------
---------------|-------------------------%%%%%|||-||------------------------------||---------------------------------------------------------------------------------
----------SSS--|--------------------------|||-|||-||--SSS-----------------%%%-----||-------------------------------------------------------------------------------F-
-M------------%%%%%%%%%%%%%%%%%%%%%%%%%%%%|||-|||-||-----------------------|------||-------------------------------------------------------------------------------X-
XXX--%%%%%-----||-|||-|||-|||-|||-|||-|||-|||-|||-||-----------------------|------||-XXXXXXXXXXXXXXXXXXXXXXXXXXXXXXXXXXXXXXXXXXXXXXXXXXXXXXXXXXXXXXXXXXXXXXXXXXXXXXXX
XXX---|||------||-|||-|||-|||-|||-|||-|||-|||-|||-||-----------------------|------||-XXXXXXXXXXXXXXXXXXXXXXXXXXXXXXXXXXXXXXXXXXXXXXXXXXXXXXXXXXXXXXXXXXXXXXXXXXXXXXXX
