------------------------------------------------------------------------------------------------------------------------------------------------------------------------------------------------------------------------------
------------------------------------------------------------------------------------------------------------------------------------------------------------------------------------------------------------------------------
-----------------------------------------------------------------------------------Q------------------------------------------------------------------------------------------------------------------------------------------
--------------------------------------------------------------------------------------------y-----------------------------oo--------------------------------------------------------------------------------------------------
------------------------Q------------------------------------Q------------------------------##-------------------TT-----------------------------------------------------------------------------------------------------------
--------------------------------oo---------------------------------------------------------###-------------------TT-----------------------------------------------------------------------------------------------------------
------------------------------------------------------------------------------------------####--------------Q----TT-----------------------------------------------------------------------------------------------------------
-------------------------------------y-----------------------------oo-------------------y#####-------------------TT-----------------------------------------------------------------------------------------------------------
---------------------------------QQ?SSQQQ-------------------------o--o-----Q------------######-------------------TT----------------------------C------------------------------------------------------------------------------
--------------------------y-------------------------------y----------------------------#######-------------------TT------------------------------------------------------------------------------oo---------------------------
--------------------------##------------------------------##--------------------------########-------------------TT-----------------------------------------------------------------------------o--o-------------Q------------
------------------------y###----------------oo-----------###-------------------------#########-------------------TT-----------------------------------------------------------------------------------------------------------
------------------------####---------------C------------####------------------------##########-------------------TT-------------------------------------------------------------------------------------------------------F---
-M---------------------#####---------------------------#####-----------------------###########-------------------TT-------------------------------------------------------------------------oo----------------------------#---
XX--------------------XXXXXX--XX--------------------XXXXXXXX--------------------XXXXXXXXXXXXXX------------XX----XXXX------------------XX------------------------------------------XX------------------XX--XXXX--XX--------XX--
XX--------------------XXXXXX--XX--------------------XXXXXXXX--------------------XXXXXXXXXXXXXX------------XX----XXXX------------------XX------------------------------------------XX------------------XX--XXXX--XX--------XX--
