---------------------------------------------------------------------------------------------------------------------------------------------------------------------
---------------------------------------------------------------------------------------------------------------------------------------------------------------------
-------%%%%-------%%%----------------------------------------------------------------------------------------------------%%%%----------------------------------------
--------||---------|--------------------------------------------------------------------ooo-------------------------------||----------------------ooo----------------
--------||---------|------SS------SSS-----------------------------------SS--------------------SSoo------------------------||-----------------------------------------
--------||---------|----------------------------------------------------------------------------------------SS------------||-----------------------------------------
--------||---------|------------------------------------------------------------------------------------------------------||--------------------------------------SS-
--------||---------|---------------------------------------%%%%---ooo-----------------------------------------------SS----||-----------------------------------------
--------||---------|----------------------------------------||----------------------------------%%%-----------------------||------------------SS------------SS-------
--------||---------|----------------------SS-----------%%%%%||-----------------------------------|---------------oo-------||-----------------------------------------
--------||---------|------------------------------------|||-||----------SSoo--------------SS-----|------------------------||-----------------------------------------
--------||---------|-------------------------------%%%%%|||-||-----------------------------------|------------------------||----------------------------SS-----------
--------||----SSS--|--------------------------------|||-|||-||--------------------SS-------------|------------------------||---------------------------------------F-
-M------||--------%%%%%%%%%%%%%%%%%%%%%%%%%%%%%%%%%%|||-|||-||------------------------SS---------|------------------------||---------------------------------------X-
XXXXX--%%%%--------||||-|||-|||-|||-|||-|||-|||-|||-|||-|||-||-----------------------------------|----%%%-----------------||-XXXXXXXXXXXXXXXXXXXXXXXXXXXXXXXXXXXXXXXX
XXXXX---||---------||||-|||-|||-|||-|||-|||-|||-|||-|||-|||-||-----------------------------------|-----|------------------||-XXXXXXXXXXXXXXXXXXXXXXXXXXXXXXXXXXXXXXXX
