------------------------------------------------------------------------------------------------------------------------------------------------------------------------------------------------------------------------------
------------------------------------------------------------------------------------------------------------------------------------------------------------------------------------------------------------------------------
-----------------TT------------------------------------------------------------------------------------------------------------------------------------------------Q-------------------------------------------------TT-------
-----------------TT-------------------------------------------------------------------------------------------------------------------------------------------------------------------y------------------------------TT-------
-------TT--------TT--------------------------------------------------------------Q----------Q-----------------------------------------------------------------------------------------##-----------------TT----------TT-------
-------TT--------TT------------------------------------------------------------------------------------------------------------------------------------------------------------------###-----------------TT----------TT-------
-------TT--------TT------------------------TT---------------------------------------------------------------------------------------------------------------------------------------####-----------------TT----------TT-------
-------TT--------TT---------------y--------TT---------------------------y----------------------------------------------------------------------------------------------------------#####-----------------TT----------TT-------
-------TT--------TT----Q----------##-------TT---------------------------##--------------------------------------------------------------------------------------------------------######-----------------TT----------TT-------
-------TT--------TT--------------###-------TT-----------------oo--oo---###-----------------------------------------------------------------y-----------------y-------------------#######-----------------TT----------TT-------
-------TT--------TT-------------####-------TT----C--------------------####----------------------------------Q--------------------------QQ?SSQQQ----------QQ?SSQQQ---------------########-----------------TT----------TT-------
-------TT--------TT-----------y#####-------TT-------y----------------#####----------------------------------------------------------------------------------------------------y#########----------oo-----TT----------TT-------
-------TT--------TT-----------######-------TT-------##--------------######----------------------------------------------------------------------------------------------------##########-----------------TT----------TT---F---
-M-----TT--------TT----------#######-------TT------###-------------#######---------------------------------------------------------------------------------------------------###########-----------------TT----------TT---#---
XX----XXXX------XXXX--------XXXXXXXX------XXXX----XXXX------------XXXXXXXX----XX------XX----------------------------XX--------XX------------------------------------XX--XX--XXXXXXXXXXXX----XX-----XXX--XXXX--------XXXX--XX--
XX----XXXX------XXXX--------XXXXXXXX------XXXX----XXXX------------XXXXXXXX----XX------XX----------------------------XX--------XX------------------------------------XX--XX--XXXXXXXXXXXX----XX-----XXX--XXXX--------XXXX--XX--
