-------------------------------------------------------------------------------------------------------------------------------------------------------------------------------------------------------------------------------------------------------------------------------------------------------------------------------------------------------------------------------------
-------------------------------------------------------------------------------------------------------------------------------------------------------------------------------------------------------------------------------------------------------------------------------------------------------------------------------------------------------------------------------------
------------------------------------------------------------------------------------------------#-------------------------------------------------------------------------------------------------#--------------------TT---------------------------------------------------------------------------------------------#--------------------------------------------------------------
------------------------------------------------------------------------------------------------#--------------------------------------------------------------1----------------------------------#---------------o----TT---------------------------------------------------------------------------------------------#--------------------------------------------------------------
------------------------------------------------------------------------------------------------#-------------------------------------------------------------------------------------------------#--------------------TT------------------------------------------------------------------TT-------------------------#--------------------------------------------------------------
------------------------------------------------oo-------------1--------------------------------#-------------------------------------------------------------------------------------------------#--------------------TT------------------------------------------------------------------TT-----K-------------------#--------------------------------------------------------------
------------------------------------------------------------------------------------------------#------------------TT-----------------------------------------------------------------------------#--------------------TT---------------------------------------------------TT-------2-----TT-----------------#-------#--------------------------------------------------------------
----------------------------------------------------------------------------o-------------------#------------------TT-----------------------------------------------------------------------------#-------------o------TT---------------------------------------------------TT---------K---TT-----------------#-------#--------------------------------------------------------------
---------------------------------------------------------------------------------------TT-------#------------------TT-----#--------------------------------------------------------------TT-------#--------------------TT---------------------------------------------------TT--TT---------TT-----------------#-------#------------------------------------------------2-------------
---------------------------------------------------------------------------------------TT-------#----------TT------TT-----#--------------------------------------------------------------TT-------#--------------------TT---------------------------------------------------TT--TT---------TT-----------------#-------#--------------------------------------------------K-----------
-------------------------------TT------------------------------------------------------TT-------#----------TT------TT-----#------------------------TT------------------------------------TT-------#--------------------TT----TT---------------------------------------------TT--TT---------TT-----------------#-------#--------------------------#-----------------TT----------------
-------------------------------TT------------------------------------------------------TT-------#----------TT------TT-----#------------------------TT-----------o------------------------TT-------#-----oo-------------TT----TT---------------------------------------------TT--TT---------TT-----------------#-------#-------------------------##-----------------TT----------------
------------------#-------#----TT------------------------------------------------------TT---#---#----------TT------TT-----#------------------------TT------------------------------------TT-------#--------------TT----TT----TT---------------------------------------------TT--TT---------TT-----------------#-------#------------------------###-----------------TT------------F---
-M----------------#-------#----TT-------------------------------------------ggg--------TT---#---#----------TT------TT-----#------------------------TT----SSUSSS--------------------------TT-------#--------------TT----TT----TT----------------o----------------------------TT--TT---------TT-----------------#-------#-----------------------####------oo---------TT------------#---
XX----XX----------XX----XXXX--XXXXXX----------XX--XX------------------------XXXX------XXXX--XX-XXX----XXXXXXXX----XXXX----XX------XX---------------XXX----------------------------------XXX-------XXXX-----------XXX--XXXX--XXXX--------------------------------------------XX--XX------XXXXXX----------------XX------XX----------------------XXXXXX--XX----------XXXX----------XX---
XX----XX----------XX----XXXX--XXXXXX----------XX--XX------------------------XXXX------XXXX--XX-XXX----XXXXXXXX----XXXX----XX------XX---------------XXX----------------------------------XXX-------XXXX-----------XXX--XXXX--XXXX--------------------------------------------XX--XX------XXXXXX----------------XX------XX----------------------XXXXXX--XX----------XXXX----------XX---
