-------------------------------------------------------------------------------------------------------------------------------------------------------------------------------------------------------------------------------------------------------------------------------------------------------------------------------------------------------------------------------------
-------------------------------------------------------------------------------------------------------------------------------------------------------------------------------------------------------------------------------------------------------------------------------------------------------------------------------------------------------------------------------------
-------TT------------------------------------------------------------------------------------------------------------------------------------------------TT--------------------------------------------------------------------------------------------------------------------------------------------------------------------------------------------------------------------------
-------TT--------------------------------------------------------------------SSUSSS----------------------------------------------------------------------TT--------------------------------SSUSSS--------------SSUSSS------------------------------o---------------------------------------------------------------------------------------------------------------------------------
-------TT----------TT------------------------------------------------TT----------------------------------------------------------------------------------TT------------TT-----------------------------------------------------------------------------------------------------------------------------------------------------------------#------------------------------------------
-------TT----------TT------------------------------------------------TT------------------------------------------------TT--------------------------------TT------------TT--------------------------------------------------------------------------------------------------------------------------------------------------------------o--#--------------------------------1---------
-------TT----------TT--------------------------TT--------------------TT------------------------------------------------TT--------------------------------TT------------TT-------------------------------------------------------------------------------------------------------------#-----------------------#---------------------------#---------------------------------#--------
-------TT----------TT--------------------------TT--------------------TT------o-----------------------------------------TT--------------------------------TT------------TT---------------------oo------------o-----oo------------------------------------------------------------------#-----------------------#---------------------------#---------------------------------#--------
-------TT----------TT--------------TT----------TT--------------------TT------------------------------------------------TT--------------------------TT----TT------------TT---------------------------------------------------------#--------2--------TT---------------------------TT---#-----------------------#---------------------------#---------#------------SSSS-------#--------
-------TT----------TT--------------TT----------TT--------------------TT------------------------------------------------TT--------------------------TT----TT------------TT---------------------------------------------------------#----------K--o---TT---------------------------TT---#-----------------------#---------------------------#---------#-----------------------#--------
-------TT----------TT--------------TT----------TT--------------------TT------------------------------------------------TT--------------------------TT----TT------------TT-----------------------------------------------#---------#-----------------TT---------------------------TT---#-----------------------#---------------------------#---------#-----------------------#--------
-------TT----------TT--------------TT----------TT--------------------TT----------------------------------TT------------TT--------------------------TT----TT------------TT-----------------------------------------------#---------#-----------------TT---------------------------TT---#-----------------------#-------oo------------------#----o----#-----------------------#--------
-------TT----------TT--------------TT----------TT--------------------TT----------------------------------TT------------TT--------------TT----TT----TT----TT------------TT-------------------------------------TT--------#---------#-----------------TT---------------------------TT---#-----------------------#---------------#-----------#---------#-----------------------#----F---
-M-----TT----------TT--------------TT----------TT--------------------TT----------------------------------TT------------TT--------------TT----TT----TT----TT------------TT-------------------------------------TT--------#---------#-----------------TT---------------------------TT---#-----------------------#---------------#-----------#---------#-----gg----------------#----#---
XX--XXXXXX----X---XXXX------------XXXX---------XXXXX----------------XXXX----------------XXXX------------XXXX----XX----XXXX------------XXXX--XXX---XXXX--XXXX----------XXXX------------XX--XX----------------XXXX--------XX--XX----XX----------------XX--XXXX--------------------XXXX--XX----------------XX----XX--XX----XX----XX----------XX----XX--XX--XXXX------XXXX----X-XXXXXX---
XX--XXXXXX----X---XXXX------------XXXX---------XXXXX----------------XXXX----------------XXXX------------XXXX----XX----XXXX------------XXXX--XXX---XXXX--XXXX----------XXXX------------XX--XX----------------XXXX--------XX--XX----XX----------------XX--XXXX--------------------XXXX--XX----------------XX----XX--XX----XX----XX----------XX----XX--XX--XXXX------XXXX----X-XXXXXX---
