--------------------------------------------------------------------------------------------------------------------------------------------------------------
--------------------------------------------------------------------------------------------------------------------------------------------------------------
------------------------------------------------------------------------------------------SS------------------------------------SS----------------------------
----------------------------SS----SS----SS------SS----------------------SS------SS---SSS--SS----SS--------------------SS--SSSS--SS----SSSS--------------------
----------------------------------------------------------------SS----------SS--------------------------------------------------------------------SS----------
----SS----------------------------------------SS----------------SS----------SS----------------------------SSSS------SS----------------------------SS----------
--------------------------------SS--SS--------------SS--SS----------------------------------SS----------------------------------------------------------------
---C--------SS----------------------------------SS----------------SS----------SS--SS--------SS----------SS----SS--SS--SS------SSSS----SS--------SS------------
------SS--SS--------------------------------SS----SS----------SS----------------------------------------------------SS----SS--------------------SS----SS------
------SS--SS------------SS------------SS----SS----SS----------SS--------SSSS--------------------------------------------------------SS----------SS----SS------
--------SS------------SS----------------------------------------------------------------------------------------------------------------------------SS--------
S-------------------------SS-----C--------SS----SS----------------SS--------------------------------------------------------------------SS--------------------
S-----------SS--SS------SS------------------------------------------------------------------------------------------------------------------------------------
S--M------------SS----------------------------------------SSSS----------SSSSSS------------------SS--SS----------SS--SS------------------------SSSS------SS--F-
XXXX--XX------XXXX--------XXXX------------------------XX------XXXX----XX----------------XXXX--------------XX----------------XX--XX--XX----------------------XX
XXXX--XX------XXXX--------XXXX------------------------XX------XXXX----XX----------------XXXX--------------XX----------------XX--XX--XX----------------------XX
