---------------------------------------------------------------------------------------------------------------------------------------------------------------------
---------------------------------------------------------------------------------------------------------------------------------------------------------------------
----------------------------%%%-------------------------%%%--------------------------------------------%%%%----------------------------------------------------------
-----------------------------|---------------------------|----------------------------------------------||-----------------------------------------------------------
----------------------%%%----|---------------------------|--------------------SS------------------------||--------------SS-------------------------------------------
-----------------------|-----|---------------------------|----------------------------------------------||-----------------------------------------------------------
-----------------------|-----|---------------------------|------SSS-------------------------------------||--SS-------------------------------------------------------
-----------------------|-----|---------------------------|----------------------------------------------||-----------------------------------------------------------
-----------------------|-----|---------------------------|------------------%%%%%-----------------------||-----------------------------------------------------------
-----------------------|-----|---------------------------|-------------------|||------------------------||--------------------------------------------SSS------------
-----------------------|-----|--------------SS-----------|-------------------|||------------------------||-----------------------------------------------------------
-----------------------|-----|---------------------------|-------------------|||------------------------||-----------------------------------------------------------
----------------%%%----|-----|---------------------------|-------------------|||----------%%%-----------||---------------------------------------------------------F-
-M---------------|-----|-----|---------------------------|-----oo------------|||-----------|------------||---------------------------------------------------------X-
XXX--%%%%%-------|-----|-----|----%%%--------------------|-------------------|||-----------|------------||-XXXXXXXXXXXXXXXXXXXXXXXXXXXXXXXXXXXXXXXXXXXXXXXXXXXXXXXXXX
XXX---|||--------|-----|-----|-----|---------------------|-------------------|||-----------|------------||-XXXXXXXXXXXXXXXXXXXXXXXXXXXXXXXXXXXXXXXXXXXXXXXXXXXXXXXXXX
