------------------------------------------------------------------------------------------------------------------------------------------------------
------------------------------------------------------------------------------------------------------------------------------------------------------
------------------------------------------------------------------------------------------------------------------------------------------------------
------------------------------------------------------------------------------------------------------------------------------------------------SSS---
---------------------------------SS--------%%%%------%%%%%%%%----------------------------------%%%%--------------------------------%%%%---------------
------------------oo------ooo---------------||--------||||||------------%%%---------------------||--------------------------ooo-----||----------------
-------------------------%%%%---------------||--------||||||------------||---------------%%%%---||----------------------------------||----------------
--------------------------||----------------||--------||||||----%%------||----------------||----||----------------------------------||----%%----------
--------------------------||---------SS-----||--------||||||----||-----%%%%---------------||----||----------------------------------||----||----------
--------------------------||----------------||--------||||||----||------||----------------||----||----------------------------------||----||----------
-------%%%%---------------||----------------||--------||||||----||------||----------------||----||----------------------------------||----||----------
--------||----------------||----------------||--------||||||----||------||----------------||----||----------------------------------||----||----------
--------||-----------%%%--||----------------||---%%%%-||||||----||------||----------------||----||----------------------------------||----||-------F--
-M------||------------|---||----------------||----||--||||||----||------||----------------||----||---------------------------R------||----||-------#--
XXX-----||------------|---||------%%%-------||----||--||||||----||------||----------------||----||----%%%---------------------------||----||------XXXX
XXX-----||------------|---||-------|--------||----||--||||||----||------||----------------||----||-----|----------------------------||----||------XXXX
