-------------------------------------------------------------------------------------------------------------------------------------------------------------------------------------------------------------------------------------------------------------------------------------------------------------------------------------------------------------------------------------
-------------------------------------------------------------------------------------------------------------------------------------------------------------------------------------------------------------------------------------------------------------------------------------------------------------------------------------------------------------------------------------
-----------------------------------------------------------------------------------------------------------------------------------------------------------------------------------------------------------------------------------------------------------------------------------------------------------------------------------------------TT------------------------------------
--------------------------------------------------------------------------------------------------oo--------------------------------------------------------------------------------------------------------------------------------------------------------------------------------o----------------------------------------------------------TT-------------------------------oo---
----------------------------------------------------------------------------------------------------------------------------------------------------------------------------------------------------------------------------------------------------------------------------#------------------------------------------------------------------TT------------------------------------
-------------------------------------------------------------------------------------------------------------TT-------------------------------------------------------------------------------------------------------------------------------------------------------------#------------------------------------------------------------------TT------------------------------------
---------------------------------------#---------------------------------------------------------------------TT------------------------------------------TT-----------------------------------------------------------------------------------------------------------------#------------------------------------------------2-----------------TT------------------------------------
--------------------------------------##---------------TT------------------------1---------------------------TT------------------------------------------TT-----------------------------------------------------------------------------------------------------------------#--------------------------------------------------K---------------TT------------------------------------
-------------------------------------###---------------TT----------------------------------------------------TT------------------------------------------TT------------------------------------------------#----------------------------------------------------------------#------------------------------------------------------------------TT------------------------------------
------------------------------------####---------------TT----------------------------------------------------TT------------------------------------------TT-----------------------------------------------##----------------------------------------------------------------#------------------------------------------------------------------TT------------------------------------
-------------TT--------------------#####---------------TT----------------------------------------------------TT------------------------------------------TT----------------------------------------------###-------------------------------------#--------------------------#--------TT--------------------------------------------------------TT------------------------------------
-------------TT-------------------######---------------TT----------------------------------------------------TT------------------------------------------TT---------------------------------------------####---------------------------TT-------##--------------------------#--------TT----------------SSUSSS----------------------o-----------TT------------------------------------
-------------TT------------------#######---------------TT----------------------------------------------------TT------------------------------------------TT-----#------------TT------------------------#####-------------TT------------TT------###--------------------------#--------TT--------------------------------------------------------TT--------------------------------F---
-M-----------TT-----------------########---------------TT----------------------------------------------------TT---------------------gg-------------------TT-----#------------TT---ggg-----------------######-------------TT------------TT-----####--------------------------#--------TT---------------------------------------------oo---------TT---------------------kk---------#---
XX----------XXX-------------XX--XXXXXXXX--XX----------XXXX--XX--------------XX------------XX--------XX------XXXX--------------------XX----XX------------XXXX----XX--------XXXXXX--XXXX--XX------------XXXXXX------------XXXXXX--------XXXX--X-XXXXXX------------------XX----XX------XXXX------XX--------------------XX----XX------XX----------XXXX--XX----------------XX--------XX---
XX----------XXX-------------XX--XXXXXXXX--XX----------XXXX--XX--------------XX------------XX--------XX------XXXX--------------------XX----XX------------XXXX----XX--------XXXXXX--XXXX--XX------------XXXXXX------------XXXXXX--------XXXX--X-XXXXXX------------------XX----XX------XXXX------XX--------------------XX----XX------XX----------XXXX--XX----------------XX--------XX---
