-----------------------------------------------------------------------------------------------------------------------------------------------------
-----------------------------------------------------------------------------------------------------------------------------------------------------
-----------------SSS---------------------------------------------------------------------------------------------------------------------------------
------------------------------------------------------------------------SS--------------------------------------------------------------------oo-----
--------------------------------------o--------------------------------------------------------------------------------------------------------------
--------------------------------------SSSS---------%%%-------------------------------------SSS--------------------------o-------------oo-------------
-----------------------------------------------------|-----------------------------------------------------------------------------------------------
-----------------------------------------------------|-----------------------------------------------------------------------------------------------
-------------------SSS-------------------------------|-----------------------------------------------------------------------------------%%%%--------
-----------------------------------------------------|-------------------SSS----------------------------SS--------------------------------||---------
-----------------------------------------------------|------------------------------------------------------------------------------------||---------
-----------------------------------------------------|-----------------------SSS--------------------------o-------------------------------||---------
-----------------------------------------------------|-----------------%%%%------------------------%%%%-----------------------------------||-------F-
-M--------%%--------------%%-------------------------|-----------SSS----||--------%%----------------||--------%%--------------------------||-------#-
XXX-------||--------------||--------------%%%%-------|------------------||--%%%%---|----------------||---------|------------------%%%%----||-----XXXX
XXX-------||--------------||---------------||--------|------------------||---||----|----------------||---------|-------------------||-----||-----XXXX
