-------------------------------------------------------------------------------------------------------------------------------------------------------------------------------------------------------------------------------------------------------------------------------------------------------------------------------------------------------------------------------------
-------------------------------------------------------------------------------------------------------------------------------------------------------------------------------------------------------------------------------------------------------------------------------------------------------------------------------------------------------------------------------------
-----------------------------------SSSS-------------------------------------------------------------------------------------------------------------------#-----------------------------------------------------------------------------------------------------------------------#-------------------------------------------------------------------------------------#------------
----------------------------------------------------------------------------------------------------------------------------------------------------------#-----------------------------------------------------------------------------------------------------------------------#-------------------------------------------------------------------------------------#------------
----------------------------------------------------------------------------------------------------------------------------------------------------------#-----------------------------------------------------------------------------------------------------------------------#----TT------------------------------------------------#------------------------------#------------
------K--------------------------------------------------------------------------TT-----------------------------------------------------------------------#------------------------------------------------------------------------------------------------------------------TT---#----TT-----------------------------------------------##------------------------------#------------
---------------------------------------------------------------------------------TT------------------------------------------TT---------------------------#------------------------------------------------------------------------------------------------------------------TT---#----TT----------------------------------------------###----------------#-----#-------#------------
--------------------------------------------------------------------oo-----------TT------------------------------------------TT----------TT----SSUSSS-----#------------------------------------------------------------------------------------------------------------------TT---#----TT---------------------------------------------####----------------#-----#-------#------------
-----------------------------------------------------TT--------------------------TT--------TT--------------------------------TT----------TT---------------#----------------------------2-------------TT---------TT-----------------------------------------------------------TT---#----TT--------------------------------------------#####----------------#-----#-------#------------
-----------------------------------------------------TT--------------------------TT--------TT--------------------------------TT----------TT---------------#------------------------------K-----------TT---------TT-----------------------------------------------------------TT---#----TT------------------o------------------------######----------------#-----#-------#------------
-----------------------------------------------------TT--------------------------TT--------TT--------------------------------TT----------TT---------------#------------------------------------------TT---------TT-----------------------------------------------------------TT---#----TT------------------------------------------#######----------------#-----#-------#------------
-----------------------------------------------------TT--------------------------TT--------TT--------------------------------TT----------TT---------------#------------------------------------------TT---------TT-----------------------------------------------------------TT---#----TT--------1----------------------------K---########----------------#-----#-------#------------
-------#---------------------------------------------TT--------------------------TT--------TT--------------------------------TT----------TT---------------#------------------------------------------TT---------TT-----------------------------------------------------------TT---#----TT----------------------------------------#########----------------#-----#-------#--------F---
-M----##------------k--------------------------------TT-----------k---gg---------TT--------TT--------------------------------TT----------TT---------------#------------------------------------------TT---------TT-----------------------------------------------------------TT---#----TT-----------------gg--------------------##########----------------#-----#---kk--#--------#---
XX--XXXX------XX----XX------------XX----------------XXXX----------XXXXXX--------XXXX------XXXX--------------XX--------------XXXXXX------XXXX--------------XX--XX----------------------XX----------XXXXXX----XX--XXXXXX------------------------------------------------------XXXX--XX--XXXX----------XX----XX--------------------XXXXXXXXXX----------------XX----XX--XX--XX--XX--XX---
XX--XXXX------XX----XX------------XX----------------XXXX----------XXXXXX--------XXXX------XXXX--------------XX--------------XXXXXX------XXXX--------------XX--XX----------------------XX----------XXXXXX----XX--XXXXXX------------------------------------------------------XXXX--XX--XXXX----------XX----XX--------------------XXXXXXXXXX----------------XX----XX--XX--XX--XX--XX---
