----------------------------------------------------------------------------------------------------------------------------------------------------------------------------------------------------
----------------------------------------------------------------------------------------------------------------------------------------------------------------------------------------------------
--------------------------------------------S-------------------------------------------------------------------------------------------------------------------------------------------------------
----------------------------------------------------------------------------------------------------------------------------------------------------------------------------------------------------
------------------------SSQS------------------TT--------------------SSSSSS--------------------------------------------------------------S-----SS-----------------Q----S-------SS--------SS----------
----------------------------------------------TT----------------------------------------------------------------------------------------------------------------------------------------------------
-----------------------------Q--------TT------TT--SS------------------------------------------TT------------------------------------------------------------------------#---------------------------
--------------------------------------TT------TT----------------------------------------------TT------------------------------------------------------------------------#---------------------------
--------------------------------------TT------TT-----------SQS----------SS--------------------TT------------------------------------------------------------------------##--------------------------
--------------------------------------TT------TT----------------------------------------------TT------------------------------------------------------------------------##--------------------------
------------------SSQS----------------TT------TT----------------------------------------------TT------------------------------------------------------------------------##--------------------------
----k---------------------------------TT------TT----------------------------------------------TT------------------------------------------------------------------------##--------------------------
----SS--------------------------------TT------TT-------SQS------------------------------------TT-----------------------Q------------------------------------------------##-----------------------F--
-M------------------------------------TT------TT----------------------------------------------TT------------------------------------------------------------------------##-----------------------#--
XX--------------------------XX----XX--XX------XXXX--------------------------------XX----------XX------------------XX----XX------------------------XX--------------------XX----X-----XX----XXXX--XX--
XX--------------------------XX----XX--XX------XXXX--------------------------------XX----------XX------------------XX----XX------------------------XX--------------------XX----X-----XX----XXXX--XX--
