-------------------------------------------------------------------------------------------------------------------------------------------------------------------------------------------------------------------------------------------------------------------------------------------------------------------------------------------------------------------------------------
-------------------------------------------------------------------------------------------------------------------------------------------------------------------------------------------------------------------------------------------------------------------------------------------------------------------------------------------------------------------------------------
---------------------------------------------TT-------------------------------------------------------#---------------------TT----------------------------------------------------------------------------------#--------------------------TT----------------------------------------------------------------------------#-----------------------------------------------------------
---------------------------------------------TT-------------------------------------------------------#---------------------TT----------------------------------------------------------------------------------#--------------------------TT---------------------------------------------------------------------------##-----------------------------------------------------------
---------------------------------------------TT-------------------------------------------------------#---------------------TT----------------------------------------------------------------------------------#--------------------------TT----------------------------------------------------------TT--------------###----------------------------#-------------------#----------
---------------------------------------------TT---------------oo---------------o----------------------#-----------oo--------TT----------------------------------------------------------------------------------#--------------------------TT----------------------------------TT----------------------TT-------------####----------------------------#-------------------#-----o----
---------------------------------------------TT-------------------------------------------------------#------TT-------------TT-------------------------------------------TT-------------------------------------#--------------------------TT----------------------------------TT---------#------------TT------------#####-------------2--------------#-------------------#----------
---------------------------------------------TT-------------------------------------------------------#------TT-------------TT-------------------------------------------TT-------------------------------------#--------------------------TT----------------------------------TT---------#------------TT-----------######---------------K------------#-------------------#----------
---------------------------------------------TT------------------------------------------TT-----------#------TT-------------TT-------------------------------------------TT-------------------------------------#--------------------------TT----------------------------------TT---------#------------TT----------#######----------------------------#-------------------#----------
---------------------------------------------TT------------------------------o-----------TT-----------#------TT-------------TT--------------------------------oo---------TT-------------------------------------#--------------------------TT----------------------------------TT---------#------------TT---------########----------------------------#-------------------#----------
---------------------------------------------TT------------------------------------------TT-----------#------TT-------------TT-------------------------------------------TT-------------------------------------#--------------------------TT----------------------------------TT---------#------------TT--------#########----------------------------#-------------------#----------
---------------------------------------------TT------------------------------------------TT-----------#------TT-------------TT-------------------------------------------TT-------------------------------------#--------------------------TT----------------------------------TT---------#------------TT-------##########----------------------------#-------------------#----------
---------------------------------------------TT------------------------------------------TT-----------#------TT-------------TT-------------------------------------------TT-------------------------------------#--------------------------TT----------------------------------TT---------#------------TT------###########----------------------------#-------------------#------F---
-M--------oo---------------------------------TT------------------------------------------TT--------o--#------TT-------------TT-------------------------------------------TT---------------k---------------------#--------------------------TT----------------------------------TT---k-----#------------TT-----############----------------------------#-----ggg-----------#------#---
XX----------------XX------------X-----------XXXX--XX------------XX--------------------XXXXXX----------XX----XXXX------------XX------------------XX--XX--XX--------------XXXX--------------XX------XX------------XX------------------------XXXX------------------XX------------XXXX--XX----XX----------XXXXXX-XXXXXXXXXXXXX--------XXXX--------XXXX--XXXX----XXXX----XX----XX----XX---
XX----------------XX------------X-----------XXXX--XX------------XX--------------------XXXXXX----------XX----XXXX------------XX------------------XX--XX--XX--------------XXXX--------------XX------XX------------XX------------------------XXXX------------------XX------------XXXX--XX----XX----------XXXXXX-XXXXXXXXXXXXX--------XXXX--------XXXX--XXXX----XXXX----XX----XX----XX---
