-------------------------------------------------------------------------------------------------------------------------------------------------------------------------------------------
-------------------------------------------------------------------------------------------------------------------------------------------------------------------------------------------
------------------------------------QQ---------------------SSS----------SS------2-------------------------------2--------------------------------------------------SSS---------------------
--SS----------------SS------------------------SS--------------------SS----------------------SS----SS------SS----------------------SS------SS--SS--------------SS------------------SSSS-----
----------------------------------SS----------------------------QQ------------------------------------------------------------------------------SS-----------------------------------------
----------------------------------------SSSS--------SS------------------------------------------SS------------------------SSSS--------SS------------SS----------------SS-------------------
----------------------------SS----------------QQ--------------------------------------------------------------------------------------------------SS---------------------------------------
--------SS-------S--SS------SS--SS----------------------SS--------SS--SS----------------SS------------------SS--SS----SS------------SS--------------------SS--SS---------------------------
------S--------------------SSS------------------------------------------SS-------------------------------------------------SSS-------------------------------------------------------------
------------------SS----------------SSSS----SS------------SS--------------------------------------------SSSS--------------------SS------------------------------SS-------------------------
------------------------------------------------------------SS--------------SS------SS----------------S-------SS----SS--------------------------------------------------------------------F
S-------SS----------------------------------------------------------------------------------SSSS-----------------------------------------S------------SSSS--------------------SS----SS---SS
S---------TT----------------------------------S-------2-----------------SS----TT--------------------QQ--------------------------------SS--SS----------------SS---------------------------SS
S-M-------TT--------SS--SSSS------SS--------------------------------SS--SS----TT------SSSS----------------------SS------SS---------------------------------------------------------------SS
XXXX------XX-----------X--------XX--XX--XXXX------------------XX--XX----XX----XX--XX----------------------XX----------------------XX---------------X------------------XX--XX--------XX---XX
XXXX------XX-----------X--------XX--XX--XXXX------------------XX--XX----XX----XX--XX----------------------XX----------------------XX---------------X------------------XX--XX--------XX---XX
