-------------------------------------------------------------------------------------------------------------------------------------------------------------------------------------------------------------------------------------------------------------------------------------------------------------------------------------------------------------------------------------
-------------------------------------------------------------------------------------------------------------------------------------------------------------------------------------------------------------------------------------------------------------------------------------------------------------------------------------------------------------------------------------
--------------------------------------------------------------------------------------------------------------------------------------------------#---------------------------------------------------------------#------------------------------------------------------------------------------------------------------------------------------------------------------------------
----------------------------------------o--------------------------------------------------TT-----------------------------------------------------#---------------------------------------------------------------#-----------------------------------------------------------------------------------------------------------------------------oo-----------------------------------
--------------------------------------------------------------------------------TT---------TT-----------------------------------------------------#------------------------------------------------------------#--#----------------------------------------------------------TT---------------------------------------------------#--------------------------------------------------
--------------------------------------------------------------------------------TT---------TT-----------------------------------------------------#--------------o--------------------------------------------##--#----------------------------------------------------------TT---------------------------------------------------#--------------------------------------------------
---------------------------------------TT---------------------------------------TT---------TT-----------------------------------------------------#----------------------------------------------------------###--#----------------------------------------------------------TT---------------------------------------------------#--------------------------------------------------
---------------------------------------TT---------------------------------------TT---------TT----------------------------------SSUSSS-------------#---------------------------------------------------------####--#------------------------------------------o---------------TT-------------------------oo------------------------#--------------------------------------------------
---------------------------------------TT---------------------------------------TT---------TT-----------------------------------------------------#--------------------------------------------------------#####--#----------------------------------------------------------TT---------------------------------------------------#------------------------------2-------------------
---------------------------------------TT---------------------------------------TT---------TT-----------------------------------------------------#-------------------------------------------------------######--#----------------------------------------------------------TT----------------------TT---------------------------#--------------------------------K-----------------
---------------------------------------TT---------------------------------------TT---------TT--------------------------------------------#--------#--------------2---------------------------------------#######--#----------------------------------------------------------TT-------------TT--#----TT---------------------------#----------------------------------TT--------------
---------------------------------------TT---------------------------------------TT---------TT-------------------------------------------##--------#----------------K------------------------------------########--#----------------------------------------------------------TT-------oo----TT--#----TT---------------------------#----------------------------------TT--------------
---------------------------------------TT---------------------------------------TT---------TT------------------------------------------###--------#------2---------------------------------------------#########--#----------------------------------------------------------TT---------TT--TT--#----TT---------------------------#----------------------------------TT----------F---
-M-------------------------------------TT-----------gg------------k-------ggg---TT---------TT---------------------------k-------------####--------#--------K------------------------------------------##########--#----------------------------------------------------------TT---------TT--TT--#----TT---------------------o-----#----------o-----------SSUSSS------TT----------#---
XX------------XX------------------XX--XXXX-----XXX--XX--------XX--XX------XXXX--XX--------XXXX--XX----------------------XXX-X---------XXXX--------XX----------XX----------XX--------XXXX--XX----------XXXXXXXXXX--XX----------------------------------XX----XXXX----XX------XXXXXX----XXXX--XX--XX--XXXX--------------------------XX--------------------------------XXXX----XX--XX---
XX------------XX------------------XX--XXXX-----XXX--XX--------XX--XX------XXXX--XX--------XXXX--XX----------------------XXX-X---------XXXX--------XX----------XX----------XX--------XXXX--XX----------XXXXXXXXXX--XX----------------------------------XX----XXXX----XX------XXXXXX----XXXX--XX--XX--XXXX--------------------------XX--------------------------------XXXX----XX--XX---
