----------------------------------------------------------------------------------------------------------------------------------------------------------------------------------------------------------
----------------------------------------------------------------------------------------------------------------------------------------------------------------------------------------------------------
----------------------##-----------------S----------------------------------SS--------------------------------------------------------------------------------------------------SS------------------------
----------------------##-----------------------------------------------------------------------------------------------------------------------------------------------------o----------------------------
-----------------Q-------------------------------------------------------------------------------------------------------------------------------------------------S----------------SS--------------------
-----------------------------------------------------------------o--------------------------------SS----------------------------------------------SSSU----------------------------------------------------
------------##---------S--------------------------------------------------SS--------SS----------SS--------------------------SS--------%%%-------------SS--##--?-----------------?-------------------------
------------##------------------------------------------------------------SS--------------------SS-------------------------------------|--------------SS--##----------------------------------------------
----------------------------------------SS--------%%%-------USSS!---------SS--------------------SS-------------------------------------|------------------------------------------------------------------
---------------------------------------------------|----------------------------------------------------------SS-----------------------|---------o----------------------------------------------SS--------
---------------------------------------------------|----------------------------------------------------------------------------##-----|----------------------------------------%%%-----------------------
---------------------------------------------------|-------------------------------------------S--------------------------------##-----|--------------------------------SS-------|------------------------
--------SS----SS-----------------------------------|------------------------SS----------------------SS------oo-------------------------|------##---------------------------------|----------!--!------F---
---M------------------%%---------------------------|------------------------SS--------------------------%%------%%---------------------|------##------------------%%-------------|--------------------#---
--XX------------------||----X----------------------|------XX----XX--XX--XX----------XX------------------||------||---------------------|------XX-------------------|-------------|------------------XXXX--
--XX------------------||----X----------------------|------XX----XX--XX--XX----------XX------------------||------||---------------------|------XX-------------------|-------------|------------------XXXX--
