--------------------------------------------------------------------------------------------------------------------------------------------------------------------------------
--------------------------------------------------------------------------------------------------------------------------------------------------------------------------------
--------------------------SS--------------------------SS------------------------------------------------------------------------SS----------------------------------------------
------------------------------K-------------------------------------------------------------------------------------------------------------------------------------------------
------------------------------SS------------------------------------------SSSS--------------------------------------------------------------------------------------------------
----------------------------------------------------------------------------K-----------K---------------------------------------------------------------------------------------
----------------------------------------------------------------------------------------SS--------------------------------------------------------------------------------------
-----------------K------------------------------------U-------------------------------------------------------------------------------------------------------------------------
-------------------------------------B---------------------B--------------------------------------------------------------------------------------------------------------------
------------------------SS-----------b---------------------b-----------------K--------------------------------------------------------------------------------------------------
----------SS-----------------------SS#CS-----------------SS#CS------------------------------------SS----------------------------------------------------------------------------
--------------------TT---------K--------------------------------------------------------------------------------------------SS--------------------TT--------SS------------------
--------------------TT-----------------K-B------------SS-----K-B------------TT--------------------------------------------------------------------TT------------------------F---
-M------------------TT-------------------b---------------------b------------TT--------------------------------------------------------------------TT------------------------#---
XX------XXXXXX------XX------XX--------XXXXXX--XX------------XXXX----XX------XX--------XX------------------------------------------XXXX------------XX------XX------XX--------XX--
XX------XXXXXX------XX------XX--------XXXXXX--XX------------XXXX----XX------XX--------XX------------------------------------------XXXX------------XX------XX------XX--------XX--
