-------------------------------------------------------------------------------------------------------------------------------------------------------------------------------------------------------------------------------------------------------------------------------------------------------------------------------------------------------------------------------------
-------------------------------------------------------------------------------------------------------------------------------------------------------------------------------------------------------------------------------------------------------------------------------------------------------------------------------------------------------------------------------------
------------------------------------TT-----TT-----------------------------------------------------------------------------------------------------------TT--------------#-----------------------------------------#-------------------------------------#-------------------------#--------------------------------------------------------------------------------------------------
------------------------------------TT-----TT-------------------------------------------------K---------------------------------------------------------TT--------------#-----------------------------------------#--------------------------TT---------#-------------------------#--------------------------------------------------------------------------------------------------
------------------------------------TT-----TT----------------------------TT-----------------------------------------------------------------------------TT--------------#----------TT-----------------------------#--------------------------TT---------#----TT-------------------#--------TT------TT--------------------------------------------------------------------------------
------------------------------------TT-----TT----------------------------TT--------------------------------------------------------------------o--------TT--------------#----------TT-----------------------------#--------------------------TT---------#----TT-------------------#--------TT------TT--------------------------------------------------------------------------------
------------------------------------TT-----TT----------------------------TT------------------------------------------------------TT---------------------TT--------------#----------TT--------TT-------------------#--------------------------TT---------#----TT-------------------#--------TT------TT--------------------------------------------------------------------------------
------------------------------------TT-----TT----------------------------TT--------------------tt--------------------------------TT---------------------TT--------------#---K------TT--------TT-------------------#--------------------------TT---------#----TT-------------------#--------TT------TT--------------------------------------------------------------------------------
------------------------------------TT-----TT----------------------------TT----------------TT--tt--------------------------------TT---------------------TT--------------#----------TT--------TT-------------------#------------------TT------TT---------#----TT-------------------#--------TT------TT--------------------------------------------------------------------------------
-----------------------------TT-----TT-----TT----------------------------TT----------------TT--tt--------------------------------TT---------------------TT--------------#----------TT--------TT-------------------#------------------TT------TT---------#----TT-------------------#--------TT------TT--------------------------------------------------------------------------------
-----------------------------TT-----TT-----TT----------------------------TT----------------TT--tt--------------TT----------------TT---------------------TT--------------#----------TT--------TT-------------------#------------------TT------TT---------#----TT-------------------#--------TT------TT-----------------------------------------------------TT---------------TT--------
-----------------------------TT-----TT-----TT----------------------------TT----------------TT--tt--------------TT----------------TT---------------------TT--------------#----------TT--------TT-------------------#------------------TT------TT---------#----TT-------------K-----#--------TT------TT-----------------------------------------------------TT---------------TT--------
----#------------------------TT-----TT-----TT--------------------SSSS----TT------TT--------TT--tt--------------TT----------------TT---------------------TT--------------#----------TT--------TT-------------------#------------------TT------TT---------#----TT-------------------#--------TT------TT-----------------------------------------------------TT---------------TT----F---
-M--#-----------oo-----------TT-----TT-----TT----------------------------TT------TT--------TT--tt--------------TT----------------TT---------------------TT--------------#----------TT--------TT-------------------#------------------TT------TT-----k---#----TT-----------k-------#--------TT------TT------------------------------1--gg------------------TT----o----------TT----#---
XX--XX-XXX------------XX----XXXX----XX----XXXXXX----XXXX----------------XXXX----XXXX------XXXX-XXXXX----XX-----XXX----XX--------XXXX--XX----------------XX--------------XX--------XXXXXX----XXXX----------XX----XXXX----------------XXX-----XXXX----XX--XX--XXXX----------XX------XXXX----XXXX--XX-XXX--------------XX------XX--------XX------------------XX----------XX--XXXXXXXX--X
XX--XX-XXX------------XX----XXXX----XX----XXXXXX----XXXX----------------XXXX----XXXX------XXXX-XXXXX----XX-----XXX----XX--------XXXX--XX----------------XX--------------XX--------XXXXXX----XXXX----------XX----XXXX----------------XXX-----XXXX----XX--XX--XXXX----------XX------XXXX----XXXX--XX-XXX--------------XX------XX--------XX------------------XX----------XX--XXXXXXXX--X
