----------------------------------------------------------------------------------------------------------------------------------------------------------------------------------------------------
----------------------------------------------------------------------------------------------------------------------------------------------------------------------------------------------------
------------SS--------------------S---------------------------------------------------S---------------------------------------SS-----------------------------------------------SQS--#---------------
------------------------------------------------------------------------------------------------------------------------------------------------------------------------------------#---------------
--------------------------------------------------#-------------------------TT----------------SS--------------------------------------------S-----------SSC---------------#---------##--------------
--------------TT----------------------------------#-------------------------TT--------------------------------------------------------Q--?--------------------------------#--------###--------------
--------------TT------#---------------SSSSC-------#---------------SSQS------TT------------------------------------------------------SS------------------------------------#-------####------#-------
--------------TT------#---------------------------#-------------------------TT--------------------------------------------------------------------------SSS---------------#-------####------#-------
--------------TT------#-----------SSQS------------##------------------------TT------------------------------SS----SS------------S-----------------------------------------#-------####------#-------
--------------TT------#-----------------SSS-------##------------------------TT----------------------------------------------k---------------k-----------------------------#-------####------#-------
--------------TT------#---------------------------##------------------------TT------SSC-----------------------------SS------SS--------------SS----------------------------#-------####------#-------
--------------TT------#---------------------------##------------------------TT-------------------------------------------------------------------------------------------##-------####------#-------
--------------TT------#---------------------------##------------------------TT-------------------------------------------------------------------------------------------##-------####------#----F--
-M------------TT------#---------------------------##------------------------TT------SSS-----------------------------K----------------------------------------------------##-------####------#----#--
XXXX----------XX------XX----XX----XX--------------XX--X---------------------XX--------------------XX----XX----------XX------XX------------XXXX--XX--------XX------------XXXX------XXXX------XX--XX--
XXXX----------XX------XX----XX----XX--------------XX--X---------------------XX--------------------XX----XX----------XX------XX------------XXXX--XX--------XX------------XXXX------XXXX------XX--XX--
