------------------------------------------------------------------------------------------------------------------------------------------------------------------------------------------------------------------------------
------------------------------------------------------------------------------------------------------------------------------------------------------------------------------------------------------------------------------
----------------------?----------------------------------------------------------------------Q-------------------------------------------------------------------------------------------------------------------TT-----------
-------------------------------------------------------------------------------------------------------oo--------------------------------------------------------------------------------------------------------TT-----------
------------------------------------------------------------------------------------------------------o--o--------------Q-------------------------?--------------------------------------TT----------------------TT-----------
------------oo---------------------------------------------------------------------------------------------------------------------------------------------------------------------------TT-------------y--------TT-----------
---------------------------------------------------------Q-------Q-----------------------------------------------------------------------------------------------------------------------TT-------------##-------TT-----------
--------------------------------------------------------------------------------------------y--------------------------------------------------------------------------------------------TT-----------y###-------TT-----------
-------------------------------------------------------------------TT------Q----------------##-----------------------------------------1---------Q-------------TT------------------------TT-----------####-------TT-----------
------------------------oo-----------------------------------------TT----------------------###-----------------------------------------------------------------TT------------------------TT-----oo--y#####-------TT-----------
-----------------------------TT------------------------------------TT---Q-----------------####-----------------------------TT----------------------------------TT----------Q-------------TT---------######-------TT-----------
-----------------------------TT------------------------------------TT--------------------#####-----------------------------TT-----------------------------oo---TT------------------------TT--------#######-------TT-----------
---------Q-------------------TT------------------------------------TT-------------------######-----------------------------TT----------------------------------TT------------------------TT-------########-------TT-------F---
-M---------------------------TT------------------------------------TT------------------#######----------------------oo-----TT----------------------------------TT------------------------TT------#########-------TT-------#---
XX----------------------XX--XXXX----------------------------------XXXX--------XXXX----XXXXXXXX----------------------------XXXXXX--------------------XX----XX--XXXXXXXX------XXXX----XX--XXXX----XXXXXXXXXX------XXXX------XXXX
XX----------------------XX--XXXX----------------------------------XXXX--------XXXX----XXXXXXXX----------------------------XXXXXX--------------------XX----XX--XXXXXXXX------XXXX----XX--XXXX----XXXXXXXXXX------XXXX------XXXX
