---------------------------------------------------------------------------------------------------------------------------------------------------------------------
---------------------------------------------------------------------------------------------------------------------------------------------------------------------
-----SSS------------------------------------------------------------------------SS--------------SS------%%%--------------------%%%%----------------------------------
---------------------------------------------------------------------------------------------------------|----------------------||-----------------------------------
--SS------------------------------------------------------oo------------SSS------------------------------|----------------------||------------------------SSS--------
----------------------------------------------------------SS------SS------------------ooo----------------|-----------------oo---||-----------------------------------
--------------------------------------------------------------SS-----------------------------------------|----------------------||-----------------------------------
---------------------------------------------------------------------------------------------------------|----------------------||-----------------------------------
----------------------------------SS--------------------------------------%%%----------------------------|----------------------||--------------------------------SS-
----------------------------SSS--------------------------------------------|------------------SSS--------|--SS------------------||----------------SS--SS----ooo------
---------------------------------------------------------------------------|----SSS----------------------|----------%%%---------||------------SSoo-------------------
-----------------------------------------------oo---SS---------------------|-----------------------------|-----------|----------||-----------------------------------
----------------------------------------------------------%%%%-------------|--------------SS-------------|-----------|----------||---------------------------------F-
-M------------ooo------------------------------------------||--------------|-----------------------------|-----------|----------||---------------------------------X-
XXXXX--%%%%------------------------------------------------||--------------|-----------------------------|-----------|----------||-XXXXXXXXXXXXXXXXXXXXXXXXXXXXXXXXXX
XXXXX---||-------------------------------------------------||--------------|-----------------------------|-----------|----------||-XXXXXXXXXXXXXXXXXXXXXXXXXXXXXXXXXX
