--------------------------------------------------------------------------------------------------------------------------------------------------------------------------------
--------------------------------------------------------------------------------------------------------------------------------------------------------------------------------
--------------------------------------------------------------------------------------------------------------------------------------------------------------------------------
-------------------------------------------------------------------------------K-----------------------------------------K------------------------------------------------------
--------------------------------------------------SS----------------------------------------------------------------------------------------------------------------------------
---------------------------K----------------------------------------------------------k-----------------------------------------------------------------------------------------
--------------------------------------------------------------------------------------##---------------------------#------------------------------------------------------------
-------------------------------------------------------------------------------------###--------------------------##------------------------------------------------------------
-----------------------------------------------------------------------------------#####-----B-------------------###---------------------------------------------------#----SS--
-----------------------------------------------K----------------------------------######-----b------------------####----------------------k---------------------------##--------
----------------------------------------------------------------------------------######---SS#CS----------------####--------SS----SS------##--------------------------##--------
--------------------------------------------K----------------TT------------------#######-----------------------#####---------------------###-------------------------###--------
--------------------------------------------SS---------------TT------#----------########-------K-B------------######--------------------####------------------------####----F---
-M-----------------------------------------------------------TT-----##---------#########---------b-----------#######-------------------#####-----------------------#####----#---
XX--------------------------------------XX----------XX------XXXX----XX--------XXXXXXXXXX------XXXX----------XXXXXXXX------------XX--XXXXXXXX----------------------XXXXXX----XX--
XX--------------------------------------XX----------XX------XXXX----XX--------XXXXXXXXXX------XXXX----------XXXXXXXX------------XX--XXXXXXXX----------------------XXXXXX----XX--
