--------------------------------------------------------------------------------------------------------------------------------------------------------------------------------
--------------------------------------------------------------------------------------------------------------------------------------------------------------------------------
------------------------------SSSS-----------------------------------------------------------#----------------------------SS----------------------------------------------------
--------------------------U-----K-----------K-----SS----------------------------------------##----------------------------------------k-------------------------------k---------
--------------------------------------------SS--------------------------SS-----------------###----------------------------------------##------------------------------##--------
------------------------------------------------------------------------------------------####---------------------------------------###-----------------------------###--------
----------------------------------------------SS------------------------------------------####--------------------------------------####----------------------------####--------
---------------------------------------------------------------------K-------------------#####-------------------------------------#####---------------------------#####--------
------QQ----------------------------------------------------------SS--------------------######---------------------B-------------#######--------------------------######--------
---------K-----------------------------------------------------------------------------#######---------------------b------------########-------------------------#######--------
--SS----------------------------------------------------------------------------SS----########---------------#---SS#CS----------########--------SS--------------########--------
-------------------------------------------------------B---------------K-------------#########--------------##-----------------#########-----------------------#########--------
-------B----------------SS------------SS---------------b----TT----------------------##########-------------###-------K-B------##########-------B--------------##########----F---
-M-----b-----------------------------------------------B----TT-k-------------------###########------------####---------b-----###########-------b-------------###########----#---
XX----XX--XX------XX------------XXXX----XX------XX----XX----XXXXXX----------------XXXXXXXXXXXX--------XX--XXXX------XXXX----XXXXXXXXXXXX------XX------------XXXXXXXXXXXX--XXXX--
XX----XX--XX------XX------------XXXX----XX------XX----XX----XXXXXX----------------XXXXXXXXXXXX--------XX--XXXX------XXXX----XXXXXXXXXXXX------XX------------XXXXXXXXXXXX--XXXX--
