----------------------------------------------------------------------------------------------------------------------------------------------------------------------------------------------------------
----------------------------------------------------------------------------------------------------------------------------------------------------------------------------------------------------------
----------------------------------------------------------------SS----------------------------------------------------------------------------------------------------------------------------------------
--------SS------------------------------SS----------------------SS-----------------------------------------------------------------------------------------------------------------------S----------------
-------------------------------------------o--------------------------------------------------------------------------------------%%%-------Q-------------------------------SS----------------------------
--------------------SS----------------------------SS------------------------------------------SS--oo------K------------------------|------------------------------------oo--------------------------------
------------------------------------TT-------------------S--------------------SS---------------------------------------------------|------------------##--------------S-----------------------------------
-----------K------------------------TT----------------------------------------SS---------------------------------------------------|------------------##----------SS--------------------------------------
------------------------------------XX------------------------------------------------------------------##-------------------------|----------------------------------------------------------------------
----------------------o---------------------------------------------------SS----------------------------##--------K----------------|----------------------------------------------------------------------
-----------------------------###--------------------------------------------------------------%%%----1-----------------------------|----------------------------------------------------------------------
------------oo---------------###---------------------------------------------------------------|-----------------------------------|--------------------------------K-------------------------------------
----------------------------##---------------------B----SS-------------------------------------|--------------------SC-------------|--------------##------------------------------------------XX--SS--F---
---M----------------%%------##---------------------b------------SS------------------------U----|------------------------------%%---|--------------##------------------%%----------------------XX------#---
--XX------------XX--||----------X-----XX--XX----XXXX--XX------------XX-------X-----------------|------------XX----------------||---|--------XX--XX--------------------||%%%-------------------XX------XXXX
--XX------------XX--||----------X-----XX--XX----XXXX--XX------------XX-------X-----------------|------------XX----------------||---|--------XX--XX--------------------||-|--------------------XX------XXXX
