----------------------------------------------------------------------------------------------------------------------------------------------------------------------------------------------------
----------------------------------------------------------------------------------------------------------------------------------------------------------------------------------------------------
--------------------------------------------------------------------#-------------------SS----------------------------------------------------------------------SS----------------TT--SSQS----------
--------------------------------------------------------------------#-------------------------------------------------------------------------------------------------------------TT----------------
--------------------------------------------SS-------------SQS------##------SSQS----SS------------------------------------------------------------TT------------------------------TT--------#-------
--------------------------------------------------------------------##----------------------------k-----k-----------------------------------------TT------------------------k-----TT--------#-------
----------------------------------------#---------------------------##----------------------------SS----SS----------------#-----------------------TT------------------------SS----TT--------#-------
----------------------------------------#---------------------------##----------------------------------------------------#-----------------------TT------------------------------TT--------#-------
----------------------------------------##---SQS--------------------##----------------------------------------------------##----------------------TT------------------------------TT--------#-------
----------------------------------------##--------------------------##----------------------------------------------------##----------------------TT------------------------------TT--------#-------
------------------------------SSC------###--------------------------##--------------SS------------------------------------##-----SQS--------------TT-----------SSS----------------TT--------##------
--------------------------------------####--------------------------##----------------------------------------------------##----------------------TT-------------K----------------TT--------##------
--------------------------------------####--------------------------##----------------------------------------------------##----------------------TT------------------------------TT--------##---F--
-M----------------------------SSS-----####--------------------------##----------------------------------------------------##----------------------TT------------------------------TT--------##---#--
XX------------XX----------------------XXXX----------XX--XX----------XX--------XX------------------------------------XX----XX--XXXX--------XX------XX----XX--------------------XX--XXXX------XX--XX--
XX------------XX----------------------XXXX----------XX--XX----------XX--------XX------------------------------------XX----XX--XXXX--------XX------XX----XX--------------------XX--XXXX------XX--XX--
