-----------------------------------------------------------------------------------------------------------------------------------------------------
-----------------------------------------------------------------------------------------------------------------------------------------------------
---------------------%%%%----------------------------------------------------------------------------------------------------------------------------
----------------------||-----------------SSS--------------------------o-----------------------------------------------------------SS-------------o---
----------------------||--------------------------------------------------------------?--------------------------------------------------------------
----------------------||-------------------------------------------------------------------------------------------------------o---------------------
----------------------||---------------------------------------------------------------------------------------------------------------SSS--%%%------
----------------------||-----------------o------------------------------------------------------------------SS-------------------------------|-------
----------------------||---------------------------------------------------------------------------------------------------------------------|-------
----------------------||-----------------------------------------------------------o---------------------R-----------------------------------|-------
----------------------||----------------------------------------?----------------------------------------------------------------------------|-------
--------------------%%||------------------------------SS-------------------------------SSS-------------------------------------------R--o----|-------
--------------------||||-%%%%----------------------------------------------------------------------------------------------------------------|-----F-
-M------------------||||--||--------------------SS--------------------%%------------oo------------------------------------o------------------|-----#-
XXX-----------------||||--||------------------------------------------||%%%%-----%%%---------------------------------------------------------|---XXXX
XXX-----------------||||--||------------------------------------------||-||-------|----------------------------------------------------------|---XXXX
