--------------------------------------------------------------------------------------------------------------------------------------------------------------------------------
--------------------------------------------------------------------------------------------------------------------------------------------------------------------------------
--------------------------------------------------------------------------------------------------------------------------------------------------------------------------------
--------------------------------------------------------------------------------------------------------------------------------------------------------------------------------
----SS-------------------------------------------------------------#------------------------------------------------------------------------------------------------------------
------------------------------------------------------------------##-----------------------------------------------------------------------------K------------------------------
--------------------------------------------1-----1---------SS---###----------------------SS-------------------------------------------------#----------------------------------
---------------K------------------------------------------------####------------------------------------------------------------------------##----------------------------------
----------------------------------------------------------------####-----------------------------------------------------------------------###----1---------------SS------------
---------------------------------------------------------------#####--------------------k-------------------------------------------------####----------------------------------
-------------------------------------------------------------#######--------------------##------------------------------------------------####----------------------------------
-----------TT-----------------------------------------------########-------------------###----------------------------U------------------#####----------------------------------
-----------TT----------------------------------------------#########------------------####-------------------TT------------------------#######------------------------------F---
-M---------TT--------------K------------------------------##########-------K---------#####-------------------TT-----------------------########------------------------------#---
XX--------XXXX--------------------------------------------XXXXXXXXXXXX------XX--XX--XXXXXXXXXX--------------XXXX----------------------XXXXXXXX----XXXX--XXXX----------------XX--
XX--------XXXX--------------------------------------------XXXXXXXXXXXX------XX--XX--XXXXXXXXXX--------------XXXX----------------------XXXXXXXX----XXXX--XXXX----------------XX--
