------------------------------------------------------------------------------------------------------------------------------------------------------
------------------------------------------------------------------------------------------------------------------------------------------------------
---------------------------------------------------------------------------SSS------------------------------------------------------------------------
--------------------------------------------------SS------------------------------------------------------------------------oo------------------------
---------------------------------------------------------------------------------------------%%%------------------------------------------------------
------------------------------------------------------ooo--------R----SS----------------------|-------------------------------------------------------
----------------------------------------------------------------------------------------------|----------%%%%----R---------%%%%------------------SSS--
----------------------------------------------------------------------------------------------|-----------||----------------||------------------------
---------------------------------------------------------------%%%%---------------------------|-----------||----------------||------------------------
-------------R----------------------------------------ooo-------||----------------------------|-----------||----------------||------------------------
-----------------------------------------%%%%--%%%%-------------||----------------------------|-----------||----------------||------------------------
------------------------------------------||----||--------------||----------------------------|-----------||----------------||------------------------
-----------------------------%%%%---------||----||-----g--------||----------------------------|-----------||----------------||---oo----------------F--
--M-------------SS------------||----------||----||--%%%%--------||------oo-----------oo-------|-----------||----------------||---------------------#--
--XXX-------%%%---------------||----------||----||--||||--------||----------------------------|-----------||----------------||------------%%%-----XXXX
--XXX--------|----------------||----------||----||--||||--------||----------------------------|-----------||----------------||-------------|------XXXX
