-------------------------------------------------------------------------------------------------------------------------------------------------------------------------------------------------------------------------------------------------------------------------------------------------------------------------------------------------------------------------------------
-------------------------------------------------------------------------------------------------------------------------------------------------------------------------------------------------------------------------------------------------------------------------------------------------------------------------------------------------------------------------------------
---------------TT----------------------------------------------------------------------------------------------------------------------------------------------------------------------#--------------------------------------------------------------------------------#------------------TT------------------TT--------------------------TT----------------------------------------
---------------TT--------------------o------------------------------------------------------------------------------------------------------------------------------------------------##--------------------------------------------------------------------------------#------------------TT------------------TT--------------------------TT----------------------------------------
---------------TT------------------------------------------#--------------#----------------------------------------------------------------------------------------------------------###--------------------------------------------------------------------------------#------------------TT------------------TT--------------------------TT----------------------------------------
---------------TT-----------------------------------------##--------------#---------------------------------------------------------------------------------------------------------####-----------------o--------------------------------------------------------------#------------------TT------------------TT--------------------------TT-------------------------------K--------
---------------TT------------------TT--------------------###--------------#------------------------------------TT------------------------------------------------------------------#####-----------------------------------------------------TT-------------------------#------------------TT------------------TT--------------------------TT----------------------------------------
---------------TT------------------TT-------------------####----------oo--#------------------------------------TT-----------------------------------------------------------------######------------------------------------------------o----TT-------------------------#------------------TT------------------TT--------------------------TT----------------------------------------
---------------TT------------------TT------------------#####-------TT-----#-------#----------------------------TT----------------------------------------------------------------#######-------------------TT---#----------------------------TT-----#-------------------#------------------TT------------------TT--------------------------TT----------------------------------------
---------------TT------------------TT--------1--------######-------TT-----#-------#----------------------------TT---------------------------------------------------------------########-------------------TT---#---oo-----------------------TT-----#-------------------#------------------TT----------tt------TT--------------------------TT----------------------------------------
---------------TT------------------TT----------------#######-------TT-----#-------#----------------------------TT--------------------------------------------------------------#########-------------------TT---#--------------TT------------TT-----#-------------------#------------------TT------TT--tt------TT--------------------------TT----------------------------------------
---------------TT------------------TT---------------########-------TT-----#-------#----------------------------TT-------------------------------------------------------------##########-------------------TT---#--------------TT------------TT-----#-------------------#------------------TT------TT--tt------TT----TT-----------oo-------TT----------------------------------------
---------------TT------------------TT--------------#########-------TT-----#-------#------------#---------------TT------------------------------------------------------------###########-------------------TT---#--------------TT------------TT-----#-------------------#------------------TT------TT--tt------TT----TT--------------------TT------------------------------------F---
-M-------------TT------------------TT-------------##########-------TT-----#-------#-----------##---------------TT-------------------------------------oo--------------------############-------------------TT---#--------------TT------------TT-----#--------k-------o--#------------------TT------TT--tt------TT----TT--------------------TT------------------------------------#---
XXXX----------XXXXXX--------------XXXX------------XXXXXXXXXX------XXXX----XX------XX----------XX------------XXXXXX------------------XX----XX----------------------XX--------XXXXXXXXXXXX------XX----------XXXXXXXX--------XX---XXX----------XXXX----XX---XXXXX--XX------XX----XX----------XXXX----XXXX-XXX----XXXX--XXXX--XX--------------XXXX----XX--------XX------XX----------XX---
XXXX----------XXXXXX--------------XXXX------------XXXXXXXXXX------XXXX----XX------XX----------XX------------XXXXXX------------------XX----XX----------------------XX--------XXXXXXXXXXXX------XX----------XXXXXXXX--------XX---XXX----------XXXX----XX---XXXXX--XX------XX----XX----------XXXX----XXXX-XXX----XXXX--XXXX--XX--------------XXXX----XX--------XX------XX----------XX---
