-------------------------------------------------------------------------------------------------------------------------------------------------------------------------------------------------------------------------------------------------------------------------------------------------------------------------------------------------------------------------------------
-------------------------------------------------------------------------------------------------------------------------------------------------------------------------------------------------------------------------------------------------------------------------------------------------------------------------------------------------------------------------------------
-----------------------------------------------------2--------------------------------------#----------------------------------------------------------------------------------------------------TT--------------------------------------------------------------------TT------TT--------------------------------------------TT----------TT------------------------------------------
-------------------------------------------------------K------------------------------------#------------------------------------------------------------------------SSUSSS----------------------TT---------------------------------------------------------------o----TT------TT--------------------------------------------TT----------TT------------------------------------------
--------------------------------------------------------------------------------------------#----------------------------------------------------------------------------------------------------TT-------------------------------------#------------------------------TT------TT--------------------------------------------TT----------TT--------------------TT--------------------
----------------------------------------------------------------------------oo--------------#----------------------------------------------------------------------------------------------------TT-------------------------------------#------------------------------TT------TT--------------------------------------------TT----------TT--------------------TT--------------------
--------------------------------------------------------------------------------------------#-----------------------------------------------------#----------------------------------------------TT-------------TT----------------#-----#------------------------------TT------TT--------------------------------------------TT----------TT--------------------TT--------------------
--------------------------------------------------------------------------------------------#-----------------------------------------------------#--------------------------------------tt------TT-------------TT----------------#-----#------------------------------TT------TT------------------------o-------------------TT----------TT--------------------TT--------------------
--------------------------------------------------------------------------------------------#-----------------------------------------------------#----------------------------------TT--tt------TT-------------TT----------------#-----#------------------------------TT------TT--------------------------------------------TT----------TT--------------------TT--------------------
--------------------------------------------------------------------------------------------#-----------------------------------------------------#----------------------------------TT--tt------TT-------------TT------o---------#-----#------------------------------TT------TT--------------------------------------------TT----------TT--------------------TT--------------------
--------------------------------------------------------------------------------------------#----TT-----------------------------------------------#----------------------------------TT--tt------TT-------------TT----------------#-----#------------------------------TT------TT--------------------------------------------TT----------TT--------------------TT--------------------
--------------------------------------------------------------------------------------------#----TT------------------------TT---------------------#----------------------------------TT--tt------TT-------------TT----------------#-----#-----------oo-----------------TT------TT--------------------------------------------TT----------TT--------------------TT--------------------
--------------------------------------#-----------------------------------------------------#----TT------------------------TT---------------------#----------------------------------TT--tt------TT-------------TT----------------#-----#------------------------------TT------TT--------------------------------------------TT------TT--TT--------------2-----TT----------------F---
-M----------------kk------------------#---------------------------kk------------------------#----TT------------------------TT---------------------#----------------------------------TT--tt------TT-------------TT----------------#-----#------------------------------TT------TT---------o----------------------------------TT------TT--TT----------------K---TT----------------#---
XX----------------XX-------XXX--------XX----------------------XXXXXX------------------------XX--XXXX--------------------XX-XXXXX--XX--------------XX------XX----XX------------------XXXX-XXX----XXX---------XX--XX----XX-------XX-XX----XX----XX--XX------------------XXXX----XXXX----------XX--------------XX------------XXXXXX----XXXXXXXX----------------XX-XXX----XX--------XX---
XX----------------XX-------XXX--------XX----------------------XXXXXX------------------------XX--XXXX--------------------XX-XXXXX--XX--------------XX------XX----XX------------------XXXX-XXX----XXX---------XX--XX----XX-------XX-XX----XX----XX--XX------------------XXXX----XXXX----------XX--------------XX------------XXXXXX----XXXXXXXX----------------XX-XXX----XX--------XX---
