------------------------------------------------------------------------------------------------------------------------------------------------------
------------------------------------------------------------------------------------------------------------------------------------------------------
-----------------------------------------------------------------------------------------------------g------------------------------------------------
--------------------------------------------SS--------------------------------------------oo------%%%%------------------------oo----------------------
---------%%%---------------------------------------------------R-------------------%%%%-----------||||------------------------------------------------
----------|------r--------------------SS--------------------------------------------||------------||||------------oo----------------------------------
-----oo---|----%%%%-----------------------------------------------------------------||------------||||------------------------------------------------
----------|-----||----------------------------------oo------------------------------||------------||||------------------------------------------------
----------|-----||-----------%%%%---------------------------------------------------||------------||||------------------------------------------------
----------|-----||------------||----------------------------------------------------||------------||||--------------------------------SS--------------
----------|-----||-------SSS--||----------------------------------------------------||------------||||-----g-------------------%%%%-------------------
----------|-----||------------||----------------------------------------------------||------------||||--%%%%--------------------||--------------------
----------|-----||------------||----------------------------------------------------||------------||||--|||--------------%%%%---||-----------------F--
--M-------|-----||------------||-------oo--------------------------------------oo---||--oo--------||||--|||---------------||----||-----------------#--
--XXX-----|---%%%%%-----------||----------%%%---------------------------------------||------------||||--|||---------------||----||--%%%-----------XXXX
--XXX-----|----|||------------||-----------|----------------------------------------||------------||||--|||---------------||----||---|------------XXXX
