--------------------------------------------------------------------------------------------------------------------------------------------------------------
--------------------------------------------------------------------------------------------------------------------------------------------------------------
----------------------SS------------------------------------------------------------------SS----------SS----------------------------------SS--@QQQQ-----------
--------SS--SS----SS--SS----------------------------------SS--SS------------------------------SS------SS--------SS------------------------SS------------------
--------------------------------------------------SS--------SS------------------------------------------------------------------SSSS--------------------------
--------------SS--------SSSSSS----SS--------------SS--------SS------------------------------------SS----------------------------SSSS--------------------------
--------------------------------SS------------------------------------------------------------SS--------------------------------------------------------------
--SS----SS--SS--------SS--------------------------------------SS--SS--------------------------SS------------------SS--SS----SS--------------------------------
--------------------------------------------------------SS----------------------------------------------------------------------------------------------------
----------------------------------------------------SS--SS--SS--SS----------SS--------SS----------------------------------------SS----------------------------
--------------SS------------------------------SS----------------------------------------------------------SS--------------------------------------------------
S-------------SS------SS------------SSSSSSSS------SS----------------SS--------------SS--------------SS--------SS------SS--------------SS------------SS--------
S-----------------------------------------SS----SS------------------SS--------------SS------SS--------------------------------------------------SS------------
S--M----------------------------SS--------SS----SS------------------SS--------SS----SS------SS----------------------------SS--------------------------------F-
XXXX--------------------------XX----XXXX----------------------XX------XX----XX------XX------XXXX----XX------------------XX------------XX--XXXX----------XX--XX
XXXX--------------------------XX----XXXX----------------------XX------XX----XX------XX------XXXX----XX------------------XX------------XX--XXXX----------XX--XX
