----------------------------------------------------------------------------------------------------------------------------------------------------------------------------------------------------
----------------------------------------------------------------------------------------------------------------------------------------------------------------------------------------------------
--------------SS------#----------------------------------------------------------------------------------SQS------------------------SS--------------------------------------------------------------
----k-----------------#-----------------------------------------------------------------------------------------------------------------------------------------------------------------------------
----SS----------------#-----------S-------------SS------------------------------------------------------------------------------------------------------------------------SS------------------------
----------------------#-----k-----------------------------------------------------------------------------------------------------------------------------------------------------------------------
------------------#---#-----SS----------------------#---------------------S---------#---------------SSQS----------------------------------------------#---------------------------------------------
------------------#---#-----------------------------#-------------------------------#-----------------------------------------------------------------#---------------------------------------------
------------------##--#-----------------------------#-------------------------------###---------------------------------------------------------------#-----------SS--------------------------------
------------------##--#---k-------------------------#-------------------------------###---------------------------------------------------------------#-----------------k---------------------------
------SS----------##--##--SSSS--------SS------------#------------------------Q------###---------------------------------------------------------------#-----SSQS--------SS--------------------------
------------------##--##------------------------k---#-------------------------------###---------------------------------------------------------------#---------------------------------------------
------------------##--##------------------------#---#---------------------------S---###---------------------------------------------------------------#-------------------------------SS---------F--
-M----------------##--##------------------------#---#-------------------------------###---------------------------------------------------------------#------------------------------------------#--
XX------XX--------XX--XX----XX--------------XX--XX--XX------------XX------XX--------XXXX------------------------XX----------------------------------XXXX------------XX--XX------XX--------------XX--
XX------XX--------XX--XX----XX--------------XX--XX--XX------------XX------XX--------XXXX------------------------XX----------------------------------XXXX------------XX--XX------XX--------------XX--
