--------------------------------------------------------------------------------------------------------------------------------------------------------------------------------
--------------------------------------------------------------------------------------------------------------------------------------------------------------------------------
--SS-------------------------------------------------------------------------------------------------------#--------------------------------------------------------------------
--------------------------------------------K-------------------------------------------------------------##--------------------------------------------------------------------
--------------------------------------------SS-----------------------------------------------------------###--------------------------SS----------------------------------------
--------------------------------------------------------------------------------------------------------####------------------------------------------------------k-------------
--------------------------------------------------------------------------------------------------------####------------------------------------------------------##------------
-------------------------------------------------------------------------------------------------------#####---------------------------------------K-------------###------------
------SS---B------------------------------------------------------------------------------------------######-------------------------------------------#-------#####----1-------
-----------b-----------------------------------------------------------------------------------------#######------------------------------------------##------######------------
---------SS#CS--------------------------------------------------------------------------------------########-----------------------------------------###-----#######------------
------------------------------SS-------------------------------------------------------------------#########----------------------------------------####----########--K---------
-------------K-B--------------------------SS------------------------------SS----------------------##########---------------------------------------#####---#########--SS----F---
-M-------------b----------------------------------------U----------------------------------------###########--------------------------------------######--##########--------#---
XX----XXXX--XXXX----XXXX--XX------XX----------XX--XX------------------------------------XX------XXXXXXXXXXXX--------------XX------------------XX--XXXXXX--XXXXXXXXXXXX------XXXX
XX----XXXX--XXXX----XXXX--XX------XX----------XX--XX------------------------------------XX------XXXXXXXXXXXX--------------XX------------------XX--XXXXXX--XXXXXXXXXXXX------XXXX
