------------------------------------------------------------------------------------------------------------------------------------------------------------------------------------------------------------------------------
------------------------------------------------------------------------------------------------------------------------------------------------------------------------------------------------------------------------------
-----------------------------------------------------------------------------------------------------------------------------------------------------------------------------------------------------------Q------------------
--------------------------------------------------------------------------------------------------y----------------------------------------------y------oo------------------------------------------y-------------------------
--------------------------------------------------------------------------------------------------##-----------------------------------------QQ?SSQQQ-----------------------------------------------##------------------------
------------------oo-----------------------------------------------------------------------------###------------------------------------------------------------------------oo--------------------y###------------------------
---------------------------------------------------------------------------Q--------------------####----------Q-----------------------------------------------------------------------------------####------------------------
--------------------y--------------------------------------------------------------------------#####---------------------------------------------------------------------------------------------#####------------------------
-------TT-----------##-------------------------------------TT---------------------------------######--------------------------------------------------------------------------------------------######---------------C--------
-------TT----------###-------------------------------------TT--------------------------------#######-------------------------------------------------------------------------------------------#######------------------------
-------TT---------####-------------------------------------TT-------------------------------########------------------------------------------------------------------------------------------########------------------------
-------TT--------#####-------------------------------------TT------------------------------#########------------------------------------------------------------------------------------oo---#########------------------------
-------TT-------######-------------------------------------TT-----------------------------##########----------------------------------------------------------------------------------------##########--------------------F---
-M-----TT------#######-------------------------------------TT----------------------------###########-------------------y--------oo----oo-----------------y---------------------------------###########--------------------#---
XX--XXXXXX----XXXXXXXX------------------------XXXX--------XXXX------------XX--XX----XX--XXXXXXXXXXXX--XX------XX--XX--XX--------------------------------XX--XXXX----XXXX------------XX----XXXXXXXXXXXX----XXXX------------XX--
XX--XXXXXX----XXXXXXXX------------------------XXXX--------XXXX------------XX--XX----XX--XXXXXXXXXXXX--XX------XX--XX--XX--------------------------------XX--XXXX----XXXX------------XX----XXXXXXXXXXXX----XXXX------------XX--
