--------------------------------------------------------------------------------------------------------------------------------------------------------------------------------
--------------------------------------------------------------------------------------------------------------------------------------------------------------------------------
------------------------------------------------SS-------------------------------------------------------------------------------------------------------------#----------------
-----------------------------------------------------------------------------------------------K--------------------------------------------------------------##----------------
----SS--------------------------------------------------------------------------SS----------------------------------------------------------------------------##----------------
----------------------------------------------------------------------------------------------------------------------------SS-------------------------------###----------------
--------USS------------------------------------------------------------------------------------------------------------------------------------------------#####----USS---------
--------------------------K-----------------------U-----------------------------------------------------------------------------------------U-------------######----------------
--------------------------SS--------------------------------------------------------------------------------------------------------SSSS------------------######----------------
----------------------------------------------------------------------------------------------------------------------------SS--------K------------------#######----------------
------------------------------------------------------------------------------------------------USS-----1----------------------------------------------#########----------------
----------------------------------------------------k------------B------------------------------------------------------------------------------------##########----------------
---------------------------------------TT-----------##-----------b------------------------------------------------------------------------------------##########------------F---
-M-------------------------------------TT----------###-----------B-------------K---------------------------------------------------------------------###########------------#---
XX------------------------------XX----XXXX--XX--XXXXXX----------XX------XX--------------------------XX----------XX----XXXX--------XX--------XX------XXXXXXXXXXXX----XX------XX--
XX------------------------------XX----XXXX--XX--XXXXXX----------XX------XX--------------------------XX----------XX----XXXX--------XX--------XX------XXXXXXXXXXXX----XX------XX--
