-------------------------------------------------------------------------------------------------------------------------------------------------------------------------------------------------------------------------------------------------------------------------------------------------------------------------------------------------------------------------------------
-------------------------------------------------------------------------------------------------------------------------------------------------------------------------------------------------------------------------------------------------------------------------------------------------------------------------------------------------------------------------------------
-------------------------------------------------------------TT--------TT-----------------------------------------------------------------------#----------------------------------------------------------------------------------------------------------------------2-------------------------------------------------------------------------------------------------------------
----------------------------------------o--------------------TT--------TT----------------------------o------------------------------------------#--------TT----------------------------------------------------------------------------o---------------------------------K-----------------------------------------------------------------------------------------------------------
-------------------------------------------------------------TT--------TT-----------------------#-----------------------------------------------#--------TT---------------------------------------------------#--------------------------------------------------------------------------------------TT--------TT---------------------------------------#----------------------------
-------------------------------------------------------------TT--------TT-----------------------#-----------------------------------------------#--------TT---------------------------------------------------#--------------------------------------------------------------------------------------TT--------TT--------------TT-----------------------#----------------------------
---------------------------------------------------#---------TT--------TT-----------------------#-----------------------------------------------#--------TT---------------------------------------------------#--------------------------------------------------------------TT----------------------TT--------TT--------------TT-----------------------#----------------------------
--------------------------------------------------##---------TT--------TT-----------------------#-----------------------------------------------#--------TT---------------------------------------------------#------------------o------------------------------------K------TT----------------------TT--------TT--------------TT-----------------------#----------------------------
-------------------------------------------------###---------TT--------TT----------------------##-----------------------------------------------#--------TT---------------------------------------------------#--------------------------------------------------------------TT----------------------TT--------TT--------------TT-----------------------#----------------------------
------------------------------------------------####---------TT--------TT----TT----------------##-----------------------------------------------#--------TT-------------------------------------------oo------#--------------------------------------------------------------TT----------------------TT--------TT--------------TT-----------------------#----------------------------
--------------------TT-------------------------#####---------TT--------TT----TT--------TT------##-----------------------------------------------#--------TT---------------------------------------------------#--------------------------------------------------------------TT----------------------TT--------TT--------------TT--------TT-------------#------TT--------------------
--------------------TT-------------tt---------######---------TT--------TT----TT--------TT------##-----------------------------------------------#--------TT--------------1-----------o------------------------#--------------------------------------------------------------TT----------------------TT--------TT--------------TT--------TT-------------#------TT--------------------
--------------------TT---------TT--tt--------#######---------TT--------TT----TT--------TT------##-------------#---------------------------------#--------TT------TT--TT---------------------------------------#--------------------------------------------------------------TT----------------------TT--------TT--------------TT--------TT-------------#------TT----------------F---
-M------------------TT---------TT--tt-------########---------TT--------TT----TT--------TT------##-------------#---------------------------------#--------TT------TT--TT---------------------------------------#--------------------------------------------------------------TT-------gg-------------TT--------TT--------------TT---ggg--TT-------------#------TT----------------#---
XX------------------XX------X-XXXX-XXX------XXXXXXXX--------XXXXXX----XXXX--XXXX------XXXX-----XXX----------X-XX------------XX------------------XX------XXXXXX--XXXXXXXX--------XX----------XX------XX--------XX----------XX------------XX--------XX------------------XX-XXXXXXX------XX------------XXXX------XXXX------XX----XXXXXXXXXX-XXXXX----------XX----XXXX----------XX--XX---
XX------------------XX------X-XXXX-XXX------XXXXXXXX--------XXXXXX----XXXX--XXXX------XXXX-----XXX----------X-XX------------XX------------------XX------XXXXXX--XXXXXXXX--------XX----------XX------XX--------XX----------XX------------XX--------XX------------------XX-XXXXXXX------XX------------XXXX------XXXX------XX----XXXXXXXXXX-XXXXX----------XX----XXXX----------XX--XX---
