--------------------------------------------------------------------------------------------------------------------------------------------------------------------------------
--------------------------------------------------------------------------------------------------------------------------------------------------------------------------------
--------------------------------------------------------------SS--SS-------------------#----------------------------------------------------------------------------------------
--------------------------------------------------------SS----------------------------##----------------------------------------------------------------------------------------
-------------------------------------------------------------------------------------###------------------------------------------SS--------------------------------------------
-----------------------------K------------------------------------------------------####------------------------------------------------------------------------------k---------
------------------------------------------------------------------------------------####-----------------------------------------------------------------------------###--------
-----------------------------------------------------------------------------------#####----------------------------------------------------------------------------####--------
-----------------------------------------#--------------------SS----SS------------######--------------------------SS-------------B---------------------------------#####--------
---------------------------K------------##---------------------------------------#######-----------------------------------------b---------------K----------------######--------
--QQ-----------------------------------###--------------------------------------########---------------------------------------SS#CS----------------USS-----1-----######--------
-----K--------------------------------####-------------------------------------#########-------------------------------------------------------------------------#######--------
---------------------B----------------####------------------SS-----TT--------###########-------------------------------------------K-B--------SS--------SS------########----F---
-M----U--------------b---------------#####-------------------------TT-------############---------------------------------------------b-------------------------#########----#---
XX------------------XX--XX----------XXXXXX----XX----------------XXXXXX--XX--XXXXXXXXXXXX--------------------------------XX------XXXXXX--XX------XX------------XXXXXXXXXX----XX--
XX------------------XX--XX----------XXXXXX----XX----------------XXXXXX--XX--XXXXXXXXXXXX--------------------------------XX------XXXXXX--XX------XX------------XXXXXXXXXX----XX--
