-------------------------------------------------------------------------------------------------------------------------------------------------------------------------------------------
-------------------------------------------------------------------------------------------------------------------------------------------------------------------------------------------
--SS----------------SS------------SS------------------------------S-------------------------------SS------------------------------------------SS-----SSS-----------------------------------
----------SS----------------------------------------------------------------------------------------------SS--SS--------SS----------------SS----------------------SS--------------SS-------
--------------------------------------------------------SS----SS----SS------------------------------------------------SS----------------------------------------SS-------------------------
------SS----SS----------------------------SSSS----------------SS----SS------SS--SS----------------------SS--SS------------------------------------------------------------------SS---------
----------------------S-----------------------SS--------------SS----SSSS------------------------SS----------------------------------SS-----------------------------------------------------
-----------S--------------------SS------------------SSSS--------------------------SS----------------------------------------------------------------SS--------------SS-----S--SS-----------
------------------------------------------QQ------------------------------------------S-------------------QQ----------------------------------------------S--------------------------------
------SS--------SS--------------------------------------------------------SS--------------------------SS--------------------------------------------------------------SSSS------------SS---
------------------------------------SS------------SS--SS----------SS----------------------------------------------------------------------------------------------------------SSSS--------F
S-------SS------------------------------SS------------------SS--------------------SS-----S----SS----------------SS----SS----SSSS----SS--SSSS----------------------------------------SS---SS
S---------SS--------QQ--------------------SS----------------------------SS----------------------------------SS--------------------------------------------------------SS--SS-------------SS
S-M-----------------------------SS------------SS----------------------------SS--------------------------------------------------------SS--------SS------------------------SS------SS-----SS
XXXX--------------------XX--------------XX----------------------------------------------------XX----XX------------------XX------------------XX----------------------------XXXX-------X---XX
XXXX--------------------XX--------------XX----------------------------------------------------XX----XX------------------XX------------------XX----------------------------XXXX-------X---XX
