----------------------------------------------------------------------------------------------------------------------------------------------------------------------------------------------------------
----------------------------------------------------------------------------------------------------------------------------------------------------------------------------------------------------------
-----------------------Q------------------------------------SS----------------SS------?-----------------------------------------------------------SS------------------------------------------SS----------
--------------------------SS--------------------------------SS------------------------------------------------------------------------------------SS----------------SS------------------------------------
------------------S-----------SS----------------------------------------##--------------------------------------------------------------------------------------------------------SSQS----------------SS--
------------------------------------------------------------------------##--------------------------------------------------------------------------------------------------------------------------------
------------------------------------------------------------------------------------------------------------------------SS--------------------------------------------------------------------------------
----------------------------------------------SS--------------------------------------------------------------------------------------------------------------------SSSS------------------------------oo--
----------------------SS----------------SS-------------------------o------------------------------------------------------SS--SS------------------------------------------------------##------------------
--------------------------------------------------------------------------------------SSSSSSSU--oo------------------------------------------------------------------------------------##------------------
------------------------------------------------------------------------------------------------------------------------------------------SS--------------------------------------------------------------
------------------------------------------------------------------------------------------------------------------------------------------------------SS------SS------------------------------------------
------SS--------------------SC------------------------------------S-------------------------------------------SS------------------------------------------------##----------------##----XX------------F---
---M------------------------------------%%------------------------------------------------------------SS--SS--SS------------------------------------------------##----%%----------##----XX--------%%--#---
--XX------------------XX--------XX-------|------------XX--------------XX------------XX----XX--------XX--------XX----------------------------------X---------XX----XX--|-----------------XX--------||--XX--
--XX------------------XX--------XX-------|------------XX--------------XX------------XX----XX--------XX--------XX----------------------------------X---------XX----XX--|-----------------XX--------||--XX--
