----------------------------------------------------------------------------------------------------------------------------------------------------------------------------------------
----------------------------------------------------------------------------------------------------------------------------------------------------------------------------------------
XX----------o--------------------------------------------------------------------------------------------------ooo----------------------------------------------------------------------
XX--------------------------------------------------------------------------------------------------------------------------------------------------------------------------------------
XX---------------------------------------------------------------------------------------------###--SS----------------------SS------------------SS-------------------------------#####--
XX--------------------------------------------------------------------------------------------####------------------------------------------------------------------------------####----
XX--------------------------------------------------------------------------------------------XX------------o--------------------------------------------ooo--------------------XX------
XX--------------------------------------------------------------------------------------------XX--------------------------------------------------------------------------------XX------
XX--------------------------------------------------------------------------------------------XX-----------------------------------###---------#####----------------------------XX------
XX--------------------------------------------------------------------------------------------XX----------------------------------####--------######----------------------------XX------
XX--------------------------------------------------------------------------------------------XX---------------------------------#########----XX-------------------#######------XX------
XX--------------------------------------------------------------------------------------------XX--------------------------------##########----XX------------------########------XX------
XX--------------------XX-------ooo----------------------------------------------2-----------XXXX--------------------------------XX------------XX------------------XX------------XX--F---
XX--M-----------------XX--------------------------------------------------------------------XXXX--------------------------------XX------------XX------------------XX------------XX--#---
XX--XXXX----XX--------XX----XX----XX------------------------XX------------XX----------------XXXX----------XX----------XX------XXXX------------XX------------------XX------------XX--XX--
XX--XXXX----XX--------XX----XX----XX------------------------XX------------XX----------------XXXX----------XX----------XX------XXXX------------XX------------------XX------------XX--XX--
