-------------------------------------------------------------------------------------------------------------------------------------------------------------------------------------------------------------------------------------------------------------------------------------------------------------------------------------------------------------------------------------
-------------------------------------------------------------------------------------------------------------------------------------------------------------------------------------------------------------------------------------------------------------------------------------------------------------------------------------------------------------------------------------
----------------------------------------------------------------------TT----------------------------------------------------------------------------------------------------------------------------------------------------------------------------------------------#----------------------------------------------------------------------------------------TT--------------------
----------------------------------------------------------------------TT------------------------------------------------------------------------------o-----------------------------------------------------------------oo------------------------o-------------------#---------------------------------------------------------------------oo-----------------TT--------------------
----------------------------------------------------------------------TT------#---#-------------------------------#-------------------------------------------------------------#-------------------------------------------------------------------------------------#--------------------------------------TT----------TT------------------------------------TT--------------------
----------------------------------------------------------------------TT------#---#-------------------------------#-------------------------------------------------------------#-------------------------------------------------------------o----------o------------#--------------------------------------TT----------TT------------------------------------TT--------------------
----------------------------------------------------------------------TT------#---#-----------#-------------------#-------------------------------------------------------------#-------------------------------------------------------------------------------------#--------------------------------------TT----------TT-------------#----------------------TT--------SSSS--------
----------------------------------------------------------------------TT------#---#-----------#-------------------#---------------o---------------------------------------------#---------------------------------------K---------------------------------------------#--------------------------------------TT------1---TT-------------#----------------------TT--------------------
--------------------------#----------------TT-------------------------TT------#---#-----------#-------------------#------------TT-----------------------------------------------#-------------------------------------------------------------------------------------#----------------------------TT--------TT----------TT-------------#----TT----------------TT--------------------
--------------------------#----------------TT-------------------------TT------#---#-----------#-------------------#------------TT-------------------------------------oo--------#------------------------------------o------------------------------------------------#----------------------------TT--------TT----------TT-------------#----TT----------------TT--------------------
--------------------------#----------------TT----------------TT---TT--TT------#---#-----------#-------------------#------------TT-------------#---------------------------------#-----------------------------------------------------TT--------------------#---------#----------------------------TT--------TT----------TT----TT-------#----TT----------------TT--------------------
----oo---o----------------#----------------TT-------o--------TT---TT--TT------#---#-----------#-------------------#------------TT-------------#---------------------------------#-----------------------------------------------------TT--------------------#---------#----------------------------TT--------TT----------TT----TT-------#----TT----------------TT--------------------
-----------SSSS-----------#---TT-----------TT----------------TT---TT--TT------#---#-----------#-------------------#------------TT-------------#---------------------------------#-----------------------------------------------------TT--------------------#---------#-------#--------------------TT--------TT----------TT----TT-------#----TT----------------TT----------------F---
-M------------------------#---TT-----------TT----------------TT---TT--TT------#---#-----------#-------------------#------------TT-------ggg---#---ggg----------k------k---------#-------------------------------------gg--------------TT--------------------#---------#-------#--------------------TT--------TT----------TT----TT-------#----TT----------------TT----------------#---
XX------------------------XX--XX----------XXXX----XX---------XXX--XX--XX------XX--XX----------XX----------------XXXX----------XXXXXX----XXXXXXXX--XXXX--------XX------XX--------XX------------------------------------XX--XX----------XX--------------XX----XX----XX--XX--XX--XX------X---XX------XXXX--XX---XXX--XXXX--XXXX--XXXXXX--XXXX--XXXX--------------XXX-XXXX----------XX---
XX------------------------XX--XX----------XXXX----XX---------XXX--XX--XX------XX--XX----------XX----------------XXXX----------XXXXXX----XXXXXXXX--XXXX--------XX------XX--------XX------------------------------------XX--XX----------XX--------------XX----XX----XX--XX--XX--XX------X---XX------XXXX--XX---XXX--XXXX--XXXX--XXXXXX--XXXX--XXXX--------------XXX-XXXX----------XX---
