----------------------------------------------------------------------------------------------------------------------------------------------------------------------------------------------------------
----------------------------------------------------------------------------------------------------------------------------------------------------------------------------------------------------------
--------------------------S-----------------------------------------------------------------SS----------S!S-------------S---------------------------------------------------------------------------------
----------------------------------------------------------------------------------------------------------------------------------------------------------------------------------------------------------
------------------------------------------------S-----------S!S-------------------SS------------------------S!S-------------------------------------------------SS----------------------------------------
----------------------------1-----------------------------------------------------------------------------------------------------------------------------------------------------------------1-----------
----SS--------------------------------------------SS------------SS---@--------------------------SS----SS--------------------------------------------SS----------------------------------------------------
----------------------------------------------------------------------------------------------------------------------------------------------------------------------------------------------------------
-----------------------------------SSS------------------------------------SS--------------------------------------------------------------------------SS--------------------------SS----------------------
----------------------------------------------------------------------------------------------------------------------------------------------------------------------------------------------------------
--------------------------------SS----------------------------------------------------------------------------------------------!-----------------------------------------------------------SS------------
----------------------------------------------------------------------------------------------------------------------------------------------------------------------------------------------------------
------------------------------------------------------------------------------------------------------##----------------------------------------------------------------------------------------------F---
---M--------------------------------------------------------------------------------------------------##-----------------------------------------------------------------------------g----------------#---
XXXXXXXXXXXXXXXXXXXXXXXXXXXXXXXXXXXXXXXXXXXXXXXXXXXXXXXXXXXXXXXXXXXXXXXXXXXX-----------------------XXXXXXXXXXXXXXXXXXXXX-----------------------XXXXXXXXXXXXXXXXXXXXXXXXXXXXXXXXXXXXXXXXXXXXXXXXXXXXXXXXX--
XXXXXXXXXXXXXXXXXXXXXXXXXXXXXXXXXXXXXXXXXXXXXXXXXXXXXXXXXXXXXXXXXXXXXXXXXXXX-----------------------XXXXXXXXXXXXXXXXXXXXX-----------------------XXXXXXXXXXXXXXXXXXXXXXXXXXXXXXXXXXXXXXXXXXXXXXXXXXXXXXXXX--
