------------------------------------------------------------------------------------------------------------------------------------------------------------------------------------------------------------------------------
------------------------------------------------------------------------------------------------------------------------------------------------------------------------------------------------------------------------------
-------------------Q----------------------------------------------------------------------------------------------------------------------------------------------------------------------------------------------------------
--------------------------------------y---------------y-----------------------------------------------------------------------y-----------------------------------------------------------------------------------------------
--------------------------------------##--------------##----------------------------------------------------------------------##----------------------------------------------------------------------------------------------
--------------------y---------------y###-------------###--------oo-----------------------------------------------------------###---------------------------------------------------------y------------------------------------
--------------------##--------------####------------####-----------------------------------------------------------Q--------####---------------------------Q-----1-------------------QQ?SSQQQ---------------------------------
-------------------###------------y#####----------y#####-------------------------------------------------------------------#####----------------------------------------------------------------------------------------------
------------------####------------######----------######-------------------------------------------------------C----------######-----------------------------------Q----Q-----------------------------------------------------
-----------------#####-----------#######---------#######-----------------------------------------------------------------#######----------------------------------------------------------------------------------------------
-----------1----######----------########--------########----------------------------------------------------------------########------------------Q---------------------------------------------------------------------------
---------------#######--------y#########-------#########--------------------------------------------------------------y#########----------------------------------------------------y-----------------------------------------
-------Q------########--------##########------##########-----------C--------------------------------------------------##########----------------------------------------------------##------------------------------------F---
-M-----------#########-------###########-----###########------------------------------------------------oo-----------###########---------------------------------------------------###------------------------------------#---
XXXX--------XXXXXXXXXX------XXXXXXXXXXXX--XXXXXXXXXXXXXXXX----------XX----XX----------XX------XX------XX--XX--------XXXXXXXXXXXX--------------------------------------XX----XX----XXXXX-------------------XX--------------XX--
XXXX--------XXXXXXXXXX------XXXXXXXXXXXX--XXXXXXXXXXXXXXXX----------XX----XX----------XX------XX------XX--XX--------XXXXXXXXXXXX--------------------------------------XX----XX----XXXXX-------------------XX--------------XX--
