--------------------------------------------------------------------------------------------------------------------------------------------------------------------------------
--------------------------------------------------------------------------------------------------------------------------------------------------------------------------------
------------------------------SS----------------------------------------------------------------SS-------------------------------------------------------------#----------------
-----------------------K--------------------------------------------------------------------------------------------------------------------------------------##----------------
----------------------------------------------------------------------------------------------------------------SS--------------------------------------------##----------------
----------------------------------------------------------------------------------------------------------------------------------------------U--------------###----------------
----1--------------------------------#----------------------------------------------------------------------------------SS----------------------------------####----------------
------------------SS----------------##----------------SS----K-------------------------------------U-------------------------------------------------SS-----#####----------------
------------------------------SS---###----------------------SS--------------------------------------------------------------------------------------------######----------------
----------------------------------####------------------------------------------------------------------------------------------k------------------------#######-----------K----
----------------------------------####------------------------------------------------------------------------------------------##---------------------#########----------------
---------------------------------#####----------------------------k-------------------------------------------------k----------###--------------------##########----------------
--------------------------------######---------------------------###------------------------------------------------##--------####--------------------##########------------F---
-M-----------------------------#######--------------------------####-----------------------------------------------###-------#####-------------------###########------------#---
XX--XX----XXXX----------------XXXXXXXX--XX------------XX------XXXXXXXX------------XX----XX--XX----------------XX--XXXX------XXXXXX----XX--XX--------XXXXXXXXXXXXXX----------XXXX
XX--XX----XXXX----------------XXXXXXXX--XX------------XX------XXXXXXXX------------XX----XX--XX----------------XX--XXXX------XXXXXX----XX--XX--------XXXXXXXXXXXXXX----------XXXX
