--------------------------------------------------------------------------------------------------------------------------------------------------------------
--------------------------------------------------------------------------------------------------------------------------------------------------------------
-----------------------------------------------------S------------------------------------------------------------------------------SS------------------------
------------SS--SS----SS--------SS--SS--SSSS---------S----------SS----SS------------------SS--SS--SS------------SS--------SS--------SS--------SS--------------
-----------------------------------------------------SSS--SS--------SS------------------------------------------------------------------SS--------------------
--------------------SS----------------SS------------------SS----------------------------------------------------------SS----------------SS--------------------
--------------------------------------------------SS--------------------------SS--------------SS----------------------------oo--SSSS------SSSS--------SS------
--------SSSS----------SSSS--SS------SS--SS----------------------SS------------------------------------------------SSSS----------SSSS--------SS----SS----------
----SS-------------------------------------------------------S--------------------SS----------------------------------------SS--------SS----------------------
----SS------SS------------SS------SS--------------------SS---S------------SS------------SSSS--------SS----------------SS--------------------------------------
--------------------------------------SS--SSSS---------------SSS----------------SS------------------------SS--------------------------------------------------
S---------SS----SS------SS------------SS----SS----SS--SS------------SSSSSS--SS--------------------SS------------SSSS----------SS--------------------SS--SS----
S-------------SS--------SS--------SS------------SS--SS--------------SS----------------------------------------------------------------------------------------
S--M--SS----------------SS--------------------------SS----------SS--SS------------SS------------------SSSS------------SS--SS--------------------------------F-
XXXX--------------------XX--XX--------XX------------XX------XX----------XX-----------XXX----------------------XX--------------------------XXXX--------------XX
XXXX--------------------XX--XX--------XX------------XX------XX----------XX-----------XXX----------------------XX--------------------------XXXX--------------XX
