-------------------------------------------------------------------------------------------------------------------------------------------------------------------------------------------
-------------------------------------------------------------------------------------------------------------------------------------------------------------------------------------------
-------SSS--------------------------------------SS------------SS--SS--------------SSSS----------------------------------------SS--------SS------------------------SS-----------------------
--------------------------SS----------SSSS----------------------------SSSS--SS----------SS------------SS--------SS--------SS--------------------------------------------SS------SS--SS-----
---------------------------------SSS--------------------------------------------------------------------------------SS----------------SS------------------------------SS-------------------
----------SS------------------------------------------SSSS----------------------------------SS----SS----------------------------SS--------SS--SS--SSSS--------SSSS----------------------SS-
--------------------------------------------------------------------------------SS------------------------------------------SS----------SS------------------S---------------------SS-------
----------------SS--------SS-----------------------------------S----------------------------------------SS----SS------------------SS------------------------------------------SS-----------
----------------------------SS------QQ---------------SSS--SS--------------------------------------------------------------------------QQ--SS-----------------USS--------SS-----------------
--SSSS------SS-------------------S------------------------------SS--SSS-------SS------------------------------------------------SS------------------SS-------------------------------------
----------------SS----------------------------SS----------------------------SS----SS------------------------------------------SS--------------SS----------------------------------S-------F
S-----------------------------------------------------------------SS--------------------SS-----S------------------------------------------------------------------SS---------------------SS
S-----------------------------------------------------------QQ------------SS--------SS----------SS--S---------SS----QQ----------------------------------------SS----------SS-------------SS
S-M-----SS----SS--------------SS--------SS--------SS------------------SS------------------------SS------------------------SS------------SS--SS------------SS------------------------SS---SS
XXXXXX-------------X----------------------------------XX--------------------------XX------------XX----------------------------------XX-------------------------------X----------XXXX-----XX
XXXXXX-------------X----------------------------------XX--------------------------XX------------XX----------------------------------XX-------------------------------X----------XXXX-----XX
