----------------------------------------------------------------------------------------------------------------------------------------------------------------------------------------------------------
----------------------------------------------------------------------------------------------------------------------------------------------------------------------------------------------------------
--------------------------------------------------------------?-------o-------------------------------------------------%%%-----------SS--------------------------SS--------##----------------------------
------------------------------SS-----------------------------------------------------------------------------------------|--------------------------------------------------##----------------------------
-----------------------------------2------------------------##---------------------##------------------------------------|---------------------------Q----------------------------------------------------
------------------------------------------------------------##------oo---------------------------------------------K-----|----------------------------------Q---------------------------------------------
----Q---------------------------------------------------------------------------------##---------------------------------|----------------------------------------####------------S-----------------------
------------------------------------------oo------------------------------------------##---------------------------------|-----------------------o----------------##--------------------------------------
------------------------------------------------SS--------------SS-------------------------------------------------------|------------------------SS------------------------------------------------------
------------------------------------------------SS--------------------------------------------------------------SS-------|--------------------------------------------------------------------------------
------------------------------------------------SS--------------------------------------------------------SS-------------|------------------SS------SS----------------------------------------------------
----------------------kk------------------SS-----------------------------------------------------------------------------|------------------SS------------------------------------------------------------
--------------SS------XX--------------XX------------------------------------------------------------------------XX-------|--SS--XX--------------------XX----------------------------------------------F---
---M------------------XX--------SS----XX----------------SS----oo------------------------------------------------XX-------|--SS--XX--------------------XX------------------------SS--------------------#---
XXXX--------XX--------XX------------XXXX--XX--%%%---------------------------XX----------XX----------XX----------XX-------|------XX--------------XX----XXXX--------XX-------X------XXXX----------------XX--
XXXX--------XX--------XX------------XXXX--XX---|----------------------------XX----------XX----------XX----------XX-------|------XX--------------XX----XXXX--------XX-------X------XXXX----------------XX--
