-------------------------------------------------------------------------------------------------------------------------------------------------------------------------------------------------------------------------------------------------------------------------------------------------------------------------------------------------------------------------------------
-------------------------------------------------------------------------------------------------------------------------------------------------------------------------------------------------------------------------------------------------------------------------------------------------------------------------------------------------------------------------------------
----------------------------------------------------------------------------------------------------------------------------------------------------------------------------------------------------TT---------------------------------TT--------------------------------------------------------------------------------------------------------------------------------------------
----------------------------------------------------------------------------------------------------------------------------o-----------------------------------------------------------------------TT----------------------------o----TT--------------------------------------------------------------------------SSUSSS--------------------------------------------tt--------------
---------------------------------------------------------------------------------------2----------------------------------------------------#----------------------------TT-----------------#-------TT---------------------------------TT---#----------------------------------------------------------TT--------------------#-----------------------------------TT--tt--------------
---------------------------------------------------------------------------o-------------K-----------------------------------------tt-------#----------------------------TT-----------------#-------TT---------------------------------TT---#----------------------------------------------------------TT-------------------##-----------------------------------TT--tt--------------
-------------------------------------------------------------TT---------------#------------------------------------------------TT--tt-------#----------------------------TT-----------------#-------TT-----------------------------TT--TT---#----------------------------------------------------#-----TT------------------###---------------------TT------------TT--tt--------------
-------------------------------------------------------------TT---------------#-----------------------K------------------------TT--tt-------#----------------------------TT--------o--------#-------TT-----------------------------TT--TT---#---------------------------------------------------##-----TT-----------------####---------------------TT------------TT--tt--------------
-------------------------------------------------------------TT---------------#------------------------------------------------TT--tt-------#----------------------------TT-----------------#-------TT---------------------SSSS----TT--TT---#-------------------#------------------------------###-----TT----------------#####---------------------TT------------TT--tt--------------
-------------------------------------------------------------TT---------------#--------------TT------------------------TT------TT--tt-------#-------oo-------tt----------TT-----------------#-------TT-----------------------------TT--TT---#-------------------#-----------------------------####-----TT---------------######---------------1-----TT------------TT--tt--------------
-------------------------------------------------------------TT---------------#--------------TT------------------------TT------TT--tt-------#------------TT--tt----------TT-----------------#-------TT-----------------------------TT--TT---#-------------------#----------------------------#####-----TT--------------#######---------------------TT------------TT--tt--------------
-------------------------------------------------------------TT---------------#--------------TT-----o------------------TT------TT--tt-------#------------TT--tt----------TT------o-----o----#-------TT-----------------------------TT--TT---#-------------------#---------------------------######-----TT-------------########---------------------TT------------TT--tt--------------
-------------------------------------------------------------TT--TT-----------#--------------TT------------------------TT------TT--tt-------#------------TT--tt----------TT-----------------#-------TT-----------------------------TT--TT---#-------------------#--------------------------#######-----TT------------#########---------------------TT------------TT--tt----------F---
-M-----------------------------------------------------------TT--TT-----k-----#---k----------TT------------------------TT------TT--tt-------#------------TT--tt----------TT-----------------#-------TT-----------k-----------------TT--TT---#-------------------#-------gg----------------########-----TT-----------##########---------------------TT------------TT--tt----------#---
XXXXXX--XX------XX------XX----------------XX--XX----XX-XXX--XXXXXXXX----XX----XX--XX--XX-----XXX------------XX----XX--XXXXXX---XXX-XXX------XX--------X-XXXX-XXXXX------XXXX--------XX------XX------XX----------XX----------------XXXXXXX---XXXX----------------XXXX----XX------------X---XXXXXXXX----XXXX--XX------XXXXXXXXXX---XX---------------XXX-----------XXXX-XXX--------XXXX-
XXXXXX--XX------XX------XX----------------XX--XX----XX-XXX--XXXXXXXX----XX----XX--XX--XX-----XXX------------XX----XX--XXXXXX---XXX-XXX------XX--------X-XXXX-XXXXX------XXXX--------XX------XX------XX----------XX----------------XXXXXXX---XXXX----------------XXXX----XX------------X---XXXXXXXX----XXXX--XX------XXXXXXXXXX---XX---------------XXX-----------XXXX-XXX--------XXXX-
