------------------------------------------------------------------------------------------------------------------------------------------------------
------------------------------------------------------------------------------------------------------------------------------------------------------
------------------------------------------------------------------------------------------------------------------------------------------------------
------------------oo----------------%%---------R------SSS-----%%%---------------------------------------------------%%%-------------------------------
------------------------------------||------------------------||----------------------------------------------------||--------------------------------
---R--------------------------------||------------------------||---------ooo----------------------------------------||----------------SSS-------------
-----------oo-----------------------||------------------------||---------%%%%---------------------------------------||--------------------------------
------------------------------------||------------------------||----------||----%%--%%--------------oo--------------||--------------------------------
------------------------------------||-----------%%%%---------||----------||----||--||------------------------------||--------------------------------
------------------------------------||------------||------ooo-||----------||----||--||------------------------------||--------------------------------
-----%%%----------------------------||------------||----------||---%%%%---||----||--||------------------------------||--------------------------------
------|-----------------------------||------------||----------||----||----||----||--||------------------------------||--------------------------------
------|-----------------------------||------------||----------||----||----||----||--||-----%%%%---------------------||-----%%%%------------%%%%----F--
-M----|-----------------------------||------------||----------||----||----||----||--||------||----------------------||------||--------------||-----#--
XXX---|---%%%---------------%%%-----||------------||----------||----||----||----||--||------||----------------------||------||--------------||----XXXX
XXX---|----|-----------------|------||------------||----------||----||----||----||--||------||----------------------||------||--------------||----XXXX
