------------------------------------------------------------------------------------------------------------------------------------------------------------------------------------------------------------------------------
------------------------------------------------------------------------------------------------------------------------------------------------------------------------------------------------------------------------------
---------------TT-------------------------------------------------Q---------------------------------------------------?-------------------------------------------------------------------------------------------------------
---oo----------TT------------------------------------------------------------------y------------------------------------------------------------------------------------------------------------------------------------------
--o--o---------TT--------------------------------------------------------------QQ?SSQQQ---------------------------------------------------------------------------------------------------------------------------------------
---------------TT------------------------------------------------------------------------------oo-----------------------------------------------------------------------------------------------------------------------------
---------------TT-----------------------------------------------------------------------------o--o----------------------------------------------------------------------------------------------------------------------------
---------------TT---------y-------------------------------------------------------------------------------------------------------------y-------------------------------------------------------------------------------------
---------------TT---------##---------------------------------------------------------------------------------TT-------Q-----------Q-----##---------------------------------------------TT-------------------------------------
---------------TT-------y###-----------------------------y---------------------------------------------------TT------------------------###------------------oo-------------------------TT-------------------------------------
---------------TT-------####-----------------Q-------QQ?SSQQQ------------------------------------------------TT-----------------------####---------------------------------------------TT--------------Q------------Q---------
---------------TT-----y#####--------------------------------------------------------#-------------------oo---TT---------------------y#####---------------------------------------------TT-------------------------------------
---------C-----TT-----######-------------------Q------------------------------------#------------------------TT---------------------######---------------------------------------------TT---------------------------------F---
-M----------y--TT----#######--------------------------------------------------------#------------------------TT--------------------#######---------------------------------------------TT---------------------------------#---
XX----------XXXXXX--XXXXXXXXXX--------XX--------------------XX----------------------XX----------------XX----XXXX----XX----------XXXXXXXXXX------------------------------------------XXXXXX----------XX--------XX----------XX--
XX----------XXXXXX--XXXXXXXXXX--------XX--------------------XX----------------------XX----------------XX----XXXX----XX----------XXXXXXXXXX------------------------------------------XXXXXX----------XX--------XX----------XX--
