----------------------------------------------------------------------------------------------------------------------------------------------------------------------------------------------------
----------------------------------------------------------------------------------------------------------------------------------------------------------------------------------------------------
------------SSC---------------------------------------------------#-----------------------#-----------------------#--------------------------------------------------SQS----------------------------
------------------------------------------------------------------#-----------------------#-----------------------#---------------------------------------------------------------------------------
---------------------------------------------------------------####-------------------SS--#---S-------------------#-----------------------------------------SS----------------------#---------------
------------SSS-----------------------------------------------##--#-----------------------#-----------------------#---------------------------------------------------K-------------#---------------
--------SSQS--------------------------------------------------##--#-----------------------#-----------------------#---------#-----------------------------------------SS------------#---------------
--------------------------------------------------------------##--#-----------------------#-----------------------#---------#-------------------------------------------------------#---------------
------------------S-------------------------------------------##--#-----------------------#-----------------------#---------##------------------------------------------------------#---------------
--------------------------------------------------------------##--#-----------------------#-----------------------#---------##------------------------------------------------------#---------------
---------------------------------------------Q----------------##--##------SS--------------#-----------------------#---------##------------------------------------------------------##--------------
--------------------------Q--?--------------------------------##--##----------------------#-----------------------#---------##------------------------------------------------------##--------------
--------------------------------------------------------------##--##--SS------------------#-----------------SS----#---------##------------------------S-----------------------------##-----------F--
-M------------------------------------------------------------##--##----------------------#-----------------------#---------##------------------------------------------------------##-----------#--
XX----------XX--XX----------------------XX--------------------XX--XX----------XX----------XXXXXX--------XX----XXXXXX--------XX----XX--------------------XX--------------------------XX----XX----XX--
XX----------XX--XX----------------------XX--------------------XX--XX----------XX----------XXXXXX--------XX----XXXXXX--------XX----XX--------------------XX--------------------------XX----XX----XX--
