------------------------------------------------------------------------------------------------------------------------------------------------------
------------------------------------------------------------------------------------------------------------------------------------------------------
------oo-------------%%%%-----------------------------------------------------------------------------------------------------------------------------
----------------------||----------------%%%---------------------------------------------%%%---------------------------------------%%%-----ooo---------
-------------%%%------||----------------||----------------------------------------------||----------------------------------------||------------------
-------SSS----|-------||----------------||------------SS--------------------------------||----------------------------------------||------------------
--------------|-------||----------------||----------------------------------------------||-----%%%%----------------SSS------------||------------------
--------------|-------||----------oo----||----------------------------------------------||------||----------------------SS--------||------------------
--------------|-------||----------------||----------------------------------------------||------||--------------------------------||------------------
------SS------|-------||----------------||----------------------------------------oo----||------||--------------------------------||------------------
--------------|-------||----------------||-----------------------------%%%-------------%%%%-----||--------------------------------||-------%%%%-------
--------------|-------||----------------||------------------------------|---------------||------||----ooo-------------------------||--------||--------
--------------|-------||----------------||-------------%%%%-------------|------%%%%-----||------||--------------------------------||--------||-----F--
--M-----------|-------||------%%%-------||--------------||--------------|-------||------||------||--------------------------------||--------||-----#--
--XXX---------|-------||------||--------||--------------||--------------|-------||------||------||------XXX---%%%-----------------||--------||----XXXX
--XXX---------|-------||------||--------||--------------||--------------|-------||------||------||------XXX----|------------------||--------||----XXXX
