----------------------------------------------------------------------------------------------------------------------------------------------------------------------------------------------------------
----------------------------------------------------------------------------------------------------------------------------------------------------------------------------------------------------------
------SS--------------SS-------------------------------------------------------------------------------------------------------------------------------------------------------------------------------g--
----------------------------------------------------------------------------------------------------------------------------------------------------------------------------------------------------------
-----------------SSS------------------SS-------------------SS-----------------------------------SU------------------------------------!---------------------------------------S----------------------S@S--
----------------------------------------------------------------------------------------------------------------------------------------------------------------------------------------------------------
-----------------------------------------------------------------------------------------------------------------------------@----------------------------------------------------------------------------
----------------------------------------------------------------------------------------------------------------------------------------------------------------------------------------------------------
----------------------------------------------------------------------------------SS------------------------------------------------------------------------------------S-----------------SS--------------
----------------------------------------------------------------------------------------------------------------------------------------------------------------------------------------------------------
--------------------------------------------------------------------SS--------------SU----------!------@----------------------------S!!S---------------------------------------@--------------------------
----------------------------------------------------------------------------------------------------------------------------------------------------------------------------------------------------------
----------------tt-------------------------------------------#----------------------------------------------------------##----------------------------------------------------------#-----------------F---
---M------------tt------------------------------------------##----------------------------------------------------------##-----------------------------------------------g----------##----------------#---
XXXXXXXXXXXXXXXXXXXXXXXXXXXXXXXXXXXXXXXXXXXXXXXXXXXXXXXXXXXXXXXXXXXXXXXXXXXXXXXXXXXXXXXXXXXXXXXXXXXXXXXXXXXXXXXXXXXXXXXXXXXXXXXXXXXXXXXXXXXXXXXXXXXXXXXXXXXXXX---XXXXXXXXXXXXXXXXXXXXXXXXXXXXXXXXXXXXXXX--
XXXXXXXXXXXXXXXXXXXXXXXXXXXXXXXXXXXXXXXXXXXXXXXXXXXXXXXXXXXXXXXXXXXXXXXXXXXXXXXXXXXXXXXXXXXXXXXXXXXXXXXXXXXXXXXXXXXXXXXXXXXXXXXXXXXXXXXXXXXXXXXXXXXXXXXXXXXXXX---XXXXXXXXXXXXXXXXXXXXXXXXXXXXXXXXXXXXXXX--
