----------------------------------------------------------------------------------------------------------------------------------------------------------------------------------------
----------------------------------------------------------------------------------------------------------------------------------------------------------------------------------------
XX------------------------------------------------2----------------------------------------------------------------------US-----------------------SS--------------------------SSC-------
XX--------------------------------------------------------------------------------------------------------------------------------------------------------------------------------------
XX---------------------------------------------------------------QQ---------------------------------------------------------------------------------------------------------------------
XX-------------SSS----------------------------------------------------------------------------------------------------------------------------------------------------------------------
XX--2--------------------------------------------------------------------------------------------------------------------------------------------------ooo------------------------------
XX--------------------------------------------------------------------------------------------------------------------------------------------------------------------------------------
XX----------------------------------------------------------------------------------------------------------------------------------SS--------------------------------------------------
XX--------------------------------------------------------------ooo---------------------------------------------------------------------------------------------------------------------
XX--------------------------------------------------------------------------------------------------------------------------------------------------------------------------------------
XX--------------------------------------------------------------------------------------------------------------------------------------------------------------------------------------
XX--------------------------------------------------------------------------------------------------------XX----SS------------------------------------------------------XX----------F---
XX--M---------------------ooo--------------------------------------------SSS------------------------------XX------------------------------------------------------------XX----------#---
XX--XX--XX----------XX------------------------XX--XXX-XX--XX--------------------------XX----------XX------XX--------XX------------------XX----------------XX--XXXX------XX--XXXX--XXXX--
XX--XX--XX----------XX------------------------XX--XXX-XX--XX--------------------------XX----------XX------XX--------XX------------------XX----------------XX--XXXX------XX--XXXX--XXXX--
