---------------------------------------------------------------------------------------------------------------------------------------------------------------------
---------------------------------------------------------------------------------------------------------------------------------------------------------------------
--------------------------------------------------------------------%%--%%---%%%--------%%------%%----------------------------%%%%--------------------------%%-------
--------------------------------------------ooo----------------------------------------------------------------------------------------------------------------------
------%%--------------------%%----------------------%%%%---%%%---------------------%%%---------------------SS------%%%-----------------------------------------------
--------------------------------SS-----------------------------------------------------------------------------------------------------------------------------------
--------------SS--------------------------------%%------------------%%----------------------%%------%%------------------------------%%----------------SS-------------
------------------------------------------------------------------------------------------------------------------------------------------------ooo------------------
------%%----%%---------SSS--------------------------%%----SS--------------------------------------SS----------SS------------------------%%%%%---%%-------------------
---------------------------------------------------------------------------------------------------------------------------------------------------------------------
-----------------------------%%%----%%-------SSS--------------------------------------%%--------------%%--------------%%--%%--------%%---------------%%%-------------
---------------------------------------------------------------------------------------------------------------------------------------------------------------------
------------------%%-----------------------------------------------------SSS---------------------------------------------------------------------------------------F-
-M-------SSS----------------------------------------------SS-------------------------------------------------------------------------------------------------------X-
XXX--%%%--------------------%%------%%----------------%%----%%%---------------------------%%----------------------%%----------%%----------------------%%--%%%%---XXXX
XXX--------------------------------------------------------------------------------------------------------------------------------------------------------------XXXX
