----------------------------------------------------------------------------------------------------------------------------------------------------------------------------------------------------------
----------------------------------------------------------------------------------------------------------------------------------------------------------------------------------------------------------
--------------------------------------------S---------------------S!!S------------------------------------!------------@--------SU------------S!!S--------------------------------------------------------
----------------------------------------------------------------------------------------------------------------------------------------------------------------------------------------------------------
------------------------------------------------S!S----------------------------------------------------------------------------------------------------------------@--------------------------------------
----------------------------------------------------------------------------------------------------------------------------------------------------------------------------------------------------------
------------------------------------------------------!-----------------!-----------------!---------------S-----------------------------------------------------------------------------------------------
----------------------------------------------------------------------------------------------------------------------------------------------------------------------------------------------------------
--------------------------------------------------------------------------S-----------------------------------------------------------------------------------S-------------------------------SS----------
----------------------------------------------------------------------------------------------------------------------------------------------------------------------------------------------------------
----------------------------------------------------------------------------------------------!-----------S!S---------------------S-----------------------------------------------------------------------
----------------------------------------------------------------------------------------------------------------------------------------------------------------------------------------------------------
------------------------------------------------------------------------------------------------------------------------------------------------------------------------------------------------------F---
---M--------------------------------------------------------------------------------------------------------------------------------------------------------------------------------------------------#---
XXXX-----------XXXXXXXXXXXXXXXXXXXXXXXXXXXXXXXXXXXXXXXXXXX---------XXXXXXXXXXXXXXXXXXXXXXXXXXXXXXXXXXXXXXXXXXXXXXXXXXXXXXXXXXX-------------------XXXXXXX-----------------XXXXX-----------------XXXXXXXXX--
XXXX-----------XXXXXXXXXXXXXXXXXXXXXXXXXXXXXXXXXXXXXXXXXXX---------XXXXXXXXXXXXXXXXXXXXXXXXXXXXXXXXXXXXXXXXXXXXXXXXXXXXXXXXXXX-------------------XXXXXXX-----------------XXXXX-----------------XXXXXXXXX--
