------------------------------------------------------------------------------------------------------------------------------------------------------
------------------------------------------------------------------------------------------------------------------------------------------------------
------------------------------------------------------------------------------------------------------------------------------------------------------
----------------------------------oo----------------SS----------------------------------oo------------------------------------oo----------------------
---------------------g--------------------------------------------------------------------------------------------------------------------------------
------------------%%%%--------------------------------SS-----oo-------------------------------------------------------------------%%%-----------------
------------------||||-----------%%%%---------------------------------------------------------------------------------------------||------------------
--------------oo--||||------------||------------------------------------------------------------------SS--------------------------||------------------
------------------||||------------||---------------%%%%%-----------------------------------oo----------------------------%%%%-----||------------------
------oo----------||||------ooo---||----------------|||------------------------------R----------------------oo------------||------||------------------
------------------||||------------||----------------|||----------------------%%%%--------------oo------------------%%%%---||------||------------------
----------SS------||||------------||----------------|||----R------------------||------oo----------------------------||----||------||------------------
------------------||||------------||----------------|||-----------------------||-----g------------------------------||----||------||---------------F--
--M---------------||||------------||----------------|||-----------------------||--%%%%--------------------SS--------||----||------||------SS-------#--
--XXX-------------||||------------||----------------|||-----------------------||--|||-------------------------------||----||------||--------------XXXX
--XXX-------------||||------------||----------------|||-----------------------||--|||-------------------------------||----||------||--------------XXXX
