-----------------------------------------------------------------------------------------------------------------------------------------------------
-----------------------------------------------------------------------------------------------------------------------------------------------------
--SS-------------------------------------------------------------------------------------------------------------------------------------------------
--------o-----------------------------------------------------------SS-------------------------------------------------------------------------------
------------------------------------------------SS--------------SSS----------------------------------------------------------------------------------
--------------------------------------------------------------------------------------------------------SSS-------------SSS--------------------------
---------------------------------------------------o----------------------------------------------------------------%%%-------------------------SS---
--------------------------------------------------%%%-------------------------oo-------------------------------------|----------o--------------------
------------------------------------%%%------------|-----------------------------------------------------------------|-------------------------------
-------------------------------------|-------------|-----------------------------------------------------------------|-------------------------------
-------------------------------------|--------?----|-----------------------------------------------------------------|-------------------------------
-------------------------------------|-------------|-----o-----o------------%%----------------------------%%---------|-----------R--oo---------------
-------------------------------------|------------%%%%----------------------||%%%%------------------------||---------|----------------------%%%----F-
-M------%%%%--%%---------------------|-------------||-----%%----------------||-||---------%%-------o------||---------|-----------------------|-----#-
XXX------|||--||---------------------|----%%%%%%%%-||-----||----------------||-||---------||--------------||---------|-----------------------|---XXXX
XXX------|||--||---------------------|-----||||||--||-----||----------------||-||---------||--------------||---------|-----------------------|---XXXX
