----------------------------------------------------------------------------------------------------------------------------------------------------------------------------------------------------------
----------------------------------------------------------------------------------------------------------------------------------------------------------------------------------------------------------
-------------------------------SQS------SSSS------------%%%-------------S-------------------------Q---##----------------------------------------------------------SS--------------------------------------
--------------------------SS--------------K--------------|------oo------------------------------------##------------------------------SS--------------------------SS--------------------------------------
---------------------------------------------------------|----------------------------------------------------------------------------------S---------------------------------SS--------------------------
---------------------------------------------------------|------------------------------------------------------------------------------------------------------------------------------------------------
----------oo----------US------------------SS-------------|----------------------------------------------------------##----------------------------------------------------------%%%-----------------------
------------------------------------------SS-------------|--------------------------------SS------------------------##--------o--------------------------------------------------|------------------------
---------------------------------------------------------|--------------------------------------------------------------------------SS----------------------##-------------------|----------------SS------
----------------------------------------------SS---------|------------------------------------------------SS----SS--------------------------------------oo--##-------------------|---TT-------------------
---------------------------------------------------------|--------------------------------------------------------------------------------##------SS-----------------------------|---TT-------------------
------SS---------------------------K---------------------|------------SS------------------SS-----------------K-------------o--------------##----------------------SS-------------|---XX-------------------
-----------------------------------------S-------S-------|-----------S------SS----------------------------------SS----------------------SS------------SS--%%%---------XX---------|--------------------F---
---M----------SS-----------------------------------------|--------------%%--SS----------------------------------SS--%%-------------------------------------|----------XX---------|-----------SSS------#---
XXXX----------------------XX--XX------XX------------XX---|--------------||------------------------------------XX----||-------------------------------------|----XX----XX----XX---|------X-------------XX--
XXXX----------------------XX--XX------XX------------XX---|--------------||------------------------------------XX----||-------------------------------------|----XX----XX----XX---|------X-------------XX--
