----------------------------------------------------------------------------------------------------------------------------------------------------------------------------------------------------
----------------------------------------------------------------------------------------------------------------------------------------------------------------------------------------------------
-------------SSS----------------------------#---SS------------------------SS------------------------------------------------------S---------------------------------------SSQS--#-------SS--TT------
---------------K----------------------------#---------------------------------k-------------k-----------------------------------------------------------------------------------#-----------TT------
----S-----------#-------------------SSQS----#---------------------------------#---------#---SS--------------#-----------------------------------------------#------------------###----------TT------
----------------#---------------------------#---------------------k-----------#---------#-------------------#-----------------------------------------------#-----------------####----------TT------
----------------#-------------#-------------#---------------------SS----------##--SSQS--#-------------------##-------------------------------------Q--------#-----------------####----------TT------
----------------#-------------#-------------#---------------------------------##--------#---K---------------##----------------------------------------------#-----------------####----------TT------
----------SSQS--#-------------#-------------#---------------------------------##--------#---SS--------------##----------------------------------------------#-----------------####----------TT------
----------------#-------------#-------------#---------------------------------##--------#-------------------##----------------------------------------------#-----------------####----------TT------
----#-----------#-------------##-----SQS----#---------------------------------##--#-----##------------------##----------------------S-----------------------#-----------------####----------TT------
----#-----------#-------------##------------#---------------------------------##--#-----##------------------##----------Q--?--------------------------------#-----------------####----------TT------
----##----------#-------------##------------##--------------------------------##--#-----##------------------##----------------------------------------------#-----------------####----------TT---F--
-M--##----------#-------------##------------##--------------------------------##--#-----##------------------##----------------------------------------------#-----------------####----------TT---#--
XX--XX--XX------XX------------XX--XXXX------XX--------------XX------------XX--XX--XX----XX----XXXX----------XXXX--------------------XX--XX--XXXX--------XX--XX----------------XXXX----------XX--XX--
XX--XX--XX------XX------------XX--XXXX------XX--------------XX------------XX--XX--XX----XX----XXXX----------XXXX--------------------XX--XX--XXXX--------XX--XX----------------XXXX----------XX--XX--
