-----------------------------------------------------------------------------------------------------------------------------------------------------------------------------------------------------
-----------------------------------------------------------------------------------------------------------------------------------------------------------------------------------------------------
-----------------------------------------------------------------------------------------------------------------------------------------------------------------------------------------------------
-------------------------------------------------------------------------------------------------SSSSS-----------------------------------------------------------------------------------------------
---------------------------------------------------------------------------------------------------------------------------------------XX------------------------------------------------------------
---------------------------------------------------------------------------------------------------------------------------------------XX------------------------------------------------------------
------------?------------------SSSS-------LSSS-----------------------------------?-----------------------------------------------------XX-----SSSSS--------------------------------------------------
------------------XX-------------------------------------------------------------------------------------------------------------------XX------------------------------------------------------------
------------------XX-------------------------------------------------------------------------------------------------------------------XX------------------------------------------------------------
------------------XX-------------------------------------------------------------------------------------------------------------------XX------------------------------------------------------------
------------------XX----------------------2------------------------C-------------------------------------------------------------------XX--------------C---------------------------------------------
------------------XX-----------------------------------------------------------------------------------TT------------------------------XX------------------------------------------------------------
------------------XX-----------------------------------------------------------------------------------TT------------------------------XX--------------------------------------------------------F---
--M----k----------XX-----k-----------------kk----k----------------gg-----k-----------------------------TT----k--------k----------------XX-----k-------gg-----k-----------------------------------X---
XXXXXXXXX------XXXXXXXXXXXX------------XXXXXXXXXXXX------------XXXXXXXXXXXX------------------------XXXXXXXXXXXX---XXXXXX------------XXXXXXXXXXXX---XXXXXXXXXXXX------------------------------XXXXXXXX
XXXXXXXXX------XXXXXXXXXXXX------------XXXXXXXXXXXX------------XXXXXXXXXXXX------------------------XXXXXXXXXXXX---XXXXXX------------XXXXXXXXXXXX---XXXXXXXXXXXX------------------------------XXXXXXXX
