--------------------------------------------------------------------------------------------------------------------------------------------------------------------------------
--------------------------------------------------------------------------------------------------------------------------------------------------------------------------------
--------------------------------------------------------------------------------------------------------------------------------------------------------------------------------
--------------------------------------------------------------------------------------------------------------------------------------------------------------------------------
--------------------------------------------------------------------------------------------------------------------------------------------------------------------------------
--------------------------K--------------------------------------------------------------------------------------------------------------------------K--------------------------
----------------------SSSSS----------------------------------------------------------------------------------------------------------------------SSSSS--------------------------
--------------------------------------------------------------------------------------------------------------------------------------------------------------------------------
------------------------------------------------------------------------------------------------k-------------------------------------------------------------------------------
-----------------------K----------------------SS------------------------------------------------##------------------------------------------------K-----------------------------
----------------------SSSSS--------------------------------------------------------------------###-----------------------------------------------SSSSS--------------------------
-------------------------K---#----------------------------------------------------------------####------K-------------------------------------------K---#-----------------------
-----------------------------#---------TT--------TT---TT--------------B--------B-------------#####--------------B-----------------B---------------------#---B---------------F---
-M---------------------------#---------TT--------TT---TT--------------b--------b------------######--------------b-----------------b---------------------#---b---------------#---
XXXXXXXXXXXXXXXXXXXXXXXXXXXXXXXXXXXX--XXXXXXXXXXXXXXXXXXXXXXXXXXXXXXXXXXXXXXXXXXXXXXXXXXXXX-XXXXXXXXXXXXXXXXXXXXXXXXXXXXXXXXXXXXXXXXXXXXXXXXXXXXXXXXXXXXXXXXXXXXXXXXXXXXXXXXXXXX
XXXXXXXXXXXXXXXXXXXXXXXXXXXXXXXXXXXX--XXXXXXXXXXXXXXXXXXXXXXXXXXXXXXXXXXXXXXXXXXXXXXXXXXXXX-XXXXXXXXXXXXXXXXXXXXXXXXXXXXXXXXXXXXXXXXXXXXXXXXXXXXXXXXXXXXXXXXXXXXXXXXXXXXXXXXXXXX
