-------------------------------------------------------------------------------------------------------------------------------------------------------------------------------------------------------------------------------------------------------------------------------------------------------------------------------------------------------------------------------------
-------------------------------------------------------------------------------------------------------------------------------------------------------------------------------------------------------------------------------------------------------------------------------------------------------------------------------------------------------------------------------------
-------------------------------------------------------------------------------------------------------------------------------------------------------------------------------------------------------------------------------------------------------------------------------------------------------------------------------------------------------------------------------------
------------------------------------------------------------------------------------------------------------------------------------------------------------------------------------------------------------------------------------------------------------------------------------------------------------------------------oo-----------------------------------------------------
-------------------------------------------------------------------------------------------------------------------------------------------------------------------------------------------------------------------------------------------------------------------------------------------------------------------------------------------------------------------------------------
-------------------------------------------------------------------------------------------------------------------------------------------------------------------------------------------------------------------------------------------------------------------------------------------------------------------------------------------------------------------------------------
---------------------------------------------------------------------------SSSSCSSS-------------------------------------------------------------------------------------------------------------------------------------------------------------------------------SSSSCSSS-------------------------------------------------------oo--------------------------------------------------
-------------------------------------------------------------------------------------------------------------------------------------------------------------------------------------------------------------------------------------------------------------------------------------------------------------------------------------------------------------------------------------
-------------------------------------------------------------------------------------------------------------------------------------------------------------------------------------------------------------------------------------------------------------------------------------------------------------------------------------------------------------------------------------
---------------------------------------------------------------oo----------------------------oo------------------------------------------------------------------------------------------------------------------------------------------------------------o-----------------------------------------------------------------##------------------------------------------------------
-------------------------------------------------------------------------------2----#---------------------------------------------------------------------------------------------------------------------------------------------------------------------------------2----#------------------------------------------------###------------------------------------------------------
-------------------------------------------------------------------------TT------K--#-----------------------------------------------------------------------------------------------------------------------------------------------------------------------------------K--#-----------------------------------------------####------------------------------------------------------
-------------------------------------------------------------------------TT---------#---------------------------------------------------------------------------------------------------------------------------------------------------------------------------o----------#----------------------------------------------#####--------------------------------------#-----------F---
-M-----------------------------------------------------------------------TT---------#--------------------------------------------------------------------------------------------------------------------------------------------------------------------------------------#--k-------ggg------------------------------gg######--k------------------------k--------k-#-----------#---
XXXXXXX--------------------------------------------------------------XXXXXXXXXXXXXXXXXXXXXX--------------------------------------------------------------------oo----------------------------------------------------------------------------------------X-----------XXXXXXXXXXXXXXXXXXXXXXXXXXXXXXXXXXXXX--------XXXXXXXXXXXXXXXXXXXXXX-XXXXXXXXXXX-XXXXXXXXXXXXXXXXXXXXXXX-XXXXXXXX
XXXXXXX--------------------------------------------------------------XXXXXXXXXXXXXXXXXXXXXX--------------------------------------------------------------------------------------------------------------------------------------------------------------X-----------XXXXXXXXXXXXXXXXXXXXXXXXXXXXXXXXXXXXX--------XXXXXXXXXXXXXXXXXXXXXX-XXXXXXXXXXX-XXXXXXXXXXXXXXXXXXXXXXX-XXXXXXXX
