----------------------------------------------------------------------------------------------------------------------------------------------------------------------------------------
----------------------------------------------------------------------------------------------------------------------------------------------------------------------------------------
----------------------------------------------------------------------------------------------------------------------------------------------------------------------------------------
----------------------------------------------------------------------------------------------------------------------------------------------------------------------------------------
----------------------------------------------------------------------------------------------------------------------------------------------------------------------------------------
----------------------------------------------------------------------------------------------------------------------------------------------------------------------------------------
----------------------------------------------------------------------------------------------------------------------------------###---------------------------------------------------
----------------------------------------------------------------------------------------------------------------------------------###---------------------------------------------------
-------------------------------------------------------------------------------------------------------------------------------y--###---------------------------------------------------
-------------------------------------------------------------------------------------------------------------------------------#--###----------------------------##---------------------
------------------------------------------------------------------------------------------------------------------------------##--###---------------------------###-----------QQ--------
----------------------------------------------------------------------------------------------------------------------------y###--###--------------------------####---------------------
----------------------------------------------------------------------------------------------------------------------------####--###-------------------------#####-----------------F---
----M-----------------------------------------------y---------------------------------------y--------------------y---------#####--###-------------------y-y--######-----------------#---
XXXXXXXXXXXXXXXX---XXXXXXXXXXXXXXXXXXXXX--XXXX---XXXXXXX--XXXXXXXXXXXXXXX---XXXXXXXXXXXXXXXXXXXXXXXXXXXXXXXXXXXXXXXXXX---XXXXXXX--XXXXXXXXXXXXXXXXXXXXXXXXXXXXXXXXX---XXXXXXXXXXXXXXXXXX
XXXXXXXXXXXXXXXX---XXXXXXXXXXXXXXXXXXXXX--XXXX---XXXXXXX--XXXXXXXXXXXXXXX---XXXXXXXXXXXXXXXXXXXXXXXXXXXXXXXXXXXXXXXXXX---XXXXXXX--XXXXXXXXXXXXXXXXXXXXXXXXXXXXXXXXX---XXXXXXXXXXXXXXXXXX
