-----------------------------------------------------------------------------------------------------------------------------------------------------------------------------------------------------
-----------------------------------------------------------------------------------------------------------------------------------------------------------------------------------------------------
-----------------------------------------------------------------------------------------------------------------------------------------------------------------------------------------------------
---------------------------------------------------------------------------------------------------------------?-------------------------------------------------------------------------------------
-----------------------------------------------------------------------------------------------------------------------------------------------------------------------------------------------------
-----------------------------------------------------------------------------------------------------------------------------------------------------------------------------------------------------
----SSSSS----------------------------------------------------------------------------------SSSSS---LSSS------------------------------------------------SSSS--------------------------------SSSSS-----
---------------------------------------------------------------XX------------------------------------------------------------------------------------------------------------------------------------
---------------------------------------------------------------XX------------------------------------------------------------------------------------------------------------------------------------
---------------------------------------------------------------XX------------------------------------------------------------------------------------------------------------------------------------
---------------------------------------------------------------XX------------SUS-------------------2-------------------------------------------------------------------------------------------------
---------------------------------#-----------------------------XX------------------------------------------------------------------------------------------------------------------------------------
-----------------------------K---#-----------------------------XX--------------------------------------------------------------------------------------------------------------------------------F---
--M----k-------------------------#------k----------------------XX-----k-----------k-----------------kk----k--------------------------------------------------------------------------------------X---
XXXXXXXXX---------------XXXXXXX--XXXXXXXXX------------------XXXXXXXXXXXX---XXXXXXXXX------------XXXXXXXXXXXX---------------------------------------------------------------------------------XXXXXXXX
XXXXXXXXX---------------XXXXXXX--XXXXXXXXX------------------XXXXXXXXXXXX---XXXXXXXXX------------XXXXXXXXXXXX---------------------------------------------------------------------------------XXXXXXXX
