------------------------------------------------------------------------------------------------------------------------------------------------------
------------------------------------------------------------------------------------------------------------------------------------------------------
------------------------------------------------------------------------------------------------------------------------------------------------------
-------------------------------------------------------R----------------------------------------------------------------------------------------------
------------------------------%%%%--------------------------------------------------------------------------------------------------------------------
-------------------------------||---------------%%%%%-------------------------------------------------------------------------------------------------
-------------------------------||---------------||||--------------------------------------------------------------------------------------------------
-------------------------------||---------------||||--------------------------------------------------------------------------------------------------
-------------------oo--oo------||---------------||||--------------------------------------------------------------------------------------------------
-------------------------------||---------------||||--------------------------------------%%%%%-------------------------------------------------------
-------------------------------||---------------||||---------------------------------------|||--------------------------------------------------------
-------------------------------||---------------||||---------------------------------------|||--------------------------------------------------------
-------------------------------||---------------||||---------------------------------------|||-----------------------------------------------------F--
-M--------------------%%%%-----||---------------||||---------------------------------------|||-----------------------------------------------------#--
XXXXXXXXXXXXXXXXXXXX---||------||---------------||||---------------------------------------|||------------------------------------------------XXXXXXXX
XXXXXXXXXXXXXXXXXXXX---||------||---------------||||---------------------------------------|||------------------------------------------------XXXXXXXX
