----------------------------------------------------------------------------------------------------------------------------------------------------------------------------------------------------
----------------------------------------------------------------------------------------------------------------------------------------------------------------------------------------------------
----------------------------------------------------------------------------------------------------------------------------------------------------------------------------------------------------
----------------------------------------------------------------------------------------------------------------------------------------------------------------------------------------------------
----------------------------------------------------------------------------------------------------------------------------------------------------------------------------------------------------
-------------------------------------------------------------------------------------k--------------------------------k-----------------------------------------------------------------------------
------------------------------------------------1-------USS-------------------------##-------------------------------##-----------------------------------------------------------------------------
-----------------------------------------------------------------------------------###------------------------------###-----------------------------------------------------------------------------
---------------------------------------------------------------------#-----------k####----------------#-----------k####-----------------------------------------------------------------------------
------------------Q--?--------------------------ggg------------------#-----------#####----------------#-----------#####-----------------------------------------------------------------------------
---------------Q---------SSS--------------##########---#-------------#----------######----------------#----------######-----------------------------------------------------------------------------
---------------------------K---TT--------##--------#---#------------##---------#######---------------##---------#######-----------------------------------------------------------------------------
------TT-----------------------TT-------###--------#---##----------###--------########--------------###--------########-------TT-------------------------------------------TT--------------------F--
-M----TT----------------K------TT------####--------#---##--gg-----####-------#########-------------####-------#########-------TT------------gg-----------------------------TT--------------------#--
XXXXXXXXXXXXXXXXXXXXXXXXXXXXXXXXXXXXXXXXXXX--------X---XXXXXXXXXXXXXXX---XXXXXXXXXXXXXXXXXXXXXXXXXXXXXX---XXXXXXXXXXXXXXXXXXXXXXXXXXXXXXXXXXXXXXXXXXXXXXXXXXXXXXXXXXXXXXXXXXXXXXXXXXXXXXXXXXXXXXXXXX
XXXXXXXXXXXXXXXXXXXXXXXXXXXXXXXXXXXXXXXXXXX--------X---XXXXXXXXXXXXXXX---XXXXXXXXXXXXXXXXXXXXXXXXXXXXXX---XXXXXXXXXXXXXXXXXXXXXXXXXXXXXXXXXXXXXXXXXXXXXXXXXXXXXXXXXXXXXXXXXXXXXXXXXXXXXXXXXXXXXXXXXX
