--------------------------------------------------------------------------------------------------------------------------------------------------------------------------------
--------------------------------------------------------------------------------------------------------------------------------------------------------------------------------
--------------------------------------------------------------------------------------------------------------------------------------------------------------------------------
--------------------------------------------------------------------------------------------------------------------------------------------------------------------------------
--------------------------------------------------------------------------------------------------------------------------------------------------------------------------------
---------------------------------------------k----------------------------------------------------------------------------------------------------------------------------------
---------------------------------------------##--------------------------------------------------------------------------------------------------------SSSSS--------------------
--------------------------------------------###---------------------------------------------------------------------------------------------------------------------------------
-------------------------------------------####-------------------------------k--------------------------------------------------------------B----------------------------------
------------------------------------------#####-----------------SS------------##-------------------------------------------------------------b----------K-----------------------
-----------------------------------------######------------------------------###-----------------------------------------------------------SS#CS-------SSSSS--------------------
----------------------------------------#######------K----------------------####--------------------------------------------------------------------------K---#-----------------
---------TT--------B-------------------########-----------TT---------------#####----TT--------TT-----------------------------B-----------------K-B------------#----B--------F---
-M-------TT--------b------------------#########-----------TT--------------######----TT--------TT-----------------------------b-------------------b------------#----b--------#---
XXXXXXXXXXXXXXXXXXXXXXXXXXXXXXXXXXXXX-XXXXXXXXXXXXXXXXXXXXXXXXXXXXXXXXXXX-XXXXXXXXXXXXXXXXXXXXXXXXXXXXXXXXXXXXXXXXXXXXXXXXXXXXXXXXXXXXXXXXXXXXXXXXXXXXXXXXXXXXXXXXXXXXXXXXXXXXXX
XXXXXXXXXXXXXXXXXXXXXXXXXXXXXXXXXXXXX-XXXXXXXXXXXXXXXXXXXXXXXXXXXXXXXXXXX-XXXXXXXXXXXXXXXXXXXXXXXXXXXXXXXXXXXXXXXXXXXXXXXXXXXXXXXXXXXXXXXXXXXXXXXXXXXXXXXXXXXXXXXXXXXXXXXXXXXXXX
