-------------------------------------------------------------------------------------------------------------------------------------------------------------------------------------------------------------------------------------------------------------------------------------------------------------------------------------------------------------------------------------
-------------------------------------------------------------------------------------------------------------------------------------------------------------------------------------------------------------------------------------------------------------------------------------------------------------------------------------------------------------------------------------
-------------------------------------------------------------------------------------------------------------------------------------------------------------------------------------------------------------------------------------------------------------------------------------------------------------------------------------------------------------------------------------
------------------------------------------------------------------------------------------------------------------------------------------------------------------------------------------------------------------oo-----------------------------------------------------------------------------------------------------------------------------------------------------------------
-------------------------------------------------------------------------------------------------------------------------------------------------------------------------------------------------------------------------------------------------------------------------------------------------------------------------------------------------------------------------------------
-------------------------------------------------------------------------------------------------------------------------------------------------------------------------------------------------------------------------------------------------------------------------------------------------------------------------------------------------------------------------------------
------------------------------------------------------------------------------------------------------------------------------SSSSCSSS-----------------------------------------------------------------------------------------------------------------------------------------------------------------------------------------------------------------------------------------------
-------------------------------------------------------------------------------------------------------------------------------------------------------------------------------------------------------------------------------------------------------------------------------------------------------------------------------------------------------------------------------------
------------------------------------------------------------------------------------------------oo----------------------------------------------------------------------------------------------------------------------------------------------------------------------------------------#------------------------------------------------------------------------------------------
-------------------------------------------------------------------------------------------------------------o------------------------------------------------------------------------------------------------------------------##----------o------o-------------------------------------##------------------------------------------------------------------------------------------
-------------------------------------------------------------TT-------------------------------TT----------------------------------2----#----------------#----------------------------------------------------------------------###------------------------------------------------------###------------------------------------------------------------------------------------------
-------------------------------------------------------------TT-------------------------------TT------------------------------------K--#----------------#---------------------------------------------------------------------####------------------------------------TT---------------####------------------------------------------------------------------------------------------
-------------------------------------------------------------TT-------------------------------TT-----#---------------------------------#----------------#--------------------------------------------------------------------#####------------------------------------TT--------------#####--------------------------------------------------------------------------------------F---
-M-----------------------------------------------------k-----TT--------------------kkk--------TT-----#---k--------k-----------k--------#----------------#-------------k---------------kkk--------------ggg----------------gg######--------------------------ggg---k---TT-----------gg######--------------------------------------------------------------------------------------#---
XXXXXXXXXX-----------XXXXXXX--------XXXXXXXXXXXXXXXXXXXXXXXXXXXXXXXXXX-XXXX-X-XXXXXXXXXXXXXXXXXXXXXXXXXXXXXXXXXXXXXXXXXXXXXXXXXXXXXXXXXXXXXXXXXXX-XXXXXXXXXXXXXXXXXXXXXXXXX-X-XXXXXXXXXXXXXXXX-XXXXXXXXXXXXXXXXXXXXXXXXXXXXXXXXXXXXXXXXXXXX--------XXXXXXXXXXXXXXXXXXXXXXXXXXXXXXXXXXXXXXXXXXXXXXXXXXXX-----------------------------------XXXXXXX-----------------------------XXXXXXX
XXXXXXXXXX-----------XXXXXXX--------XXXXXXXXXXXXXXXXXXXXXXXXXXXXXXXXXX-XXXX-X-XXXXXXXXXXXXXXXXXXXXXXXXXXXXXXXXXXXXXXXXXXXXXXXXXXXXXXXXXXXXXXXXXXX-XXXXXXXXXXXXXXXXXXXXXXXXX-X-XXXXXXXXXXXXXXXX-XXXXXXXXXXXXXXXXXXXXXXXXXXXXXXXXXXXXXXXXXXXX--------XXXXXXXXXXXXXXXXXXXXXXXXXXXXXXXXXXXXXXXXXXXXXXXXXXXX-----------------------------------XXXXXXX-----------------------------XXXXXXX
