----------------------------------------------------------------------------------------------------------------------------------------------------------------------------------------
----------------------------------------------------------------------------------------------------------------------------------------------------------------------------------------
----------------------------------------------------------------------------------------------------------------------------------------------------------------------------------------
----------------------------------------------------------------------------------------------------------------------------------------------------------------------------------------
----------------------------------------------------------------------------------------------------------------------------------------------------------------------------------------
----------------------------------------------------------------------------------------------------------------------------------------------------------------------------------------
------------------------------------------------------------------------------------------------------y---------------------------------------------------------------------------------
-----------------------------------------------------------------------y----------------------------#SSS--------------------------------------------------------------------------------
---------------------------------------------------------------------#SS--o------------------------##-----------------------------------------------------------------------------------
--------------------------------------------------------------------##----------------------------###1-----------------------------XSS-?Q-----------------------------------------------
-------------------------------------------------------------------###--SC------------------------###-----------------------------XX----------------------------------------------------
------------------------------------------------------------------####--------------------------#-###--SSS-----------------------XXX----------------------------------------------------
------------------------------------------------------------------####---SSS-------------------##-###---------------------------XXXX-------y----------------------------------------F---
----M------------------------------------y--y--------------------#####----------------------------###---------y----------------XXXXX---SSSSS-----y------------y--------y------------#---
XXXXXXXXXXXXXXXX---XXXXXX--XXXXXXXXXXXXXXXXXXXXXXXXXXXXXXXXXXXXXXXXXXX------XXXXXXXXXXXX--XXXXXXXXXXXXXX---XXXXXXXXXXX--XXXXXXXXXXXX-------XX-XXXXXXX--XXXXXXXXXXXXXXXXXXXXX--XXXXXXXXXX
XXXXXXXXXXXXXXXX---XXXXXX--XXXXXXXXXXXXXXXXXXXXXXXXXXXXXXXXXXXXXXXXXXX------XXXXXXXXXXXX--XXXXXXXXXXXXXX---XXXXXXXXXXX--XXXXXXXXXXXX-------XX-XXXXXXX--XXXXXXXXXXXXXXXXXXXXX--XXXXXXXXXX
