------------------------------------------------------------------------------------------------------------------------------------------------------
------------------------------------------------------------------------------------------------------------------------------------------------------
------------------------------------------------------------------------------------------------------------------------------------------------------
------------SS----------------------------------------------------------------------------------------------------------------------------------------
------------------------------------------------------------------------------------------------%%%%--------------------------------------------------
-------------------------------------------------------------------------------------------------||---------------------------------------------------
-------------------------------------------------------------------------------------------------||------------------------SS-------------------------
-----------------------------------------------------------------------------------SS------------||---------------------------------------------------
-------------------------------------------------------------------------------------------------||---------------------------------------------------
-------------------------------------------------------------------------------------------------||------%%%%%----------------------------------------
-------------------------------------------------------------------------------------------------||-------|||-----------------------------------------
-------------------------------------------------------------------------------------------------||-------|||-----------------------------------------
---------------------------------------------------------SS--------------------------------------||-------|||--------------------------------------F--
-M--------------------------%%%%-----------------------------------------------------------------||-------|||--------------oo----------------------#--
XXXXXXXXXXXXXXXXXXXXXXXXXX---||------------------------------------------------------------------||-------|||---------------------------------XXXXXXXX
XXXXXXXXXXXXXXXXXXXXXXXXXX---||------------------------------------------------------------------||-------|||---------------------------------XXXXXXXX
