--------------------------------------------------------------------------------------------------------------------------------------------------------------------------------
--------------------------------------------------------------------------------------------------------------------------------------------------------------------------------
--------------------------------------------------------------------------------------------------------------------------------------------------------------------------------
--------------------USS---------------------------------------------------------------------------------------------------USS---------------------------------------------------
--------------------------------------------------------------------------------------------------------------------------------------------------------------------------------
--------------------------------------------------------------------------------------------------------------------------------------------K-----------------------------------
-------------------------------------------------------SSSSS----------------------------------------------------------------------------SSSSS-----------------------------------
--------------------------------------------------------------------------------------------------------------------------------------------------------------------------------
---------------------B-----------------------------------------------------------------------------------------------------B--------------------------------B-------------------
---------------------b----------------------------------K------------------------------------------------------------------b-------------K------------------b-------------------
-------------------SS#CS-------------------------------SSSSS-------------------------------------------------------------SS#CS----------SSSSS-------------SS#CS-----------------
-----------------------------------K----------------------K---#----------------------------------------------------------------------------K---#--------------------------------
-----------------------K-B----------TT----TT------------------#----------B----------------TT----TT---------------------------K-B---------------#---TT---------K-B-----------F---
-M-----------------------b----------TT----TT------------------#----------b----------------TT-k--TT-----------------------------b---------------#---TT-----------b-----------#---
XXXXXXXXXXXXXXXXXXXXXXXXXXXXXXXXXXXXXXXXXXXXXXXXXXXXXXXXXXXXXXXXXXXXXXXXXXXXXXXXXXXXXXXXXXXXXXXXXXXXXXXXXXXXXXXXXXXXXXXXXXXXXXXXXXXXXXXXXXXXXXXXXXXXXXXXXXXXXXXXXXXXXXXXXXXXXXXX
XXXXXXXXXXXXXXXXXXXXXXXXXXXXXXXXXXXXXXXXXXXXXXXXXXXXXXXXXXXXXXXXXXXXXXXXXXXXXXXXXXXXXXXXXXXXXXXXXXXXXXXXXXXXXXXXXXXXXXXXXXXXXXXXXXXXXXXXXXXXXXXXXXXXXXXXXXXXXXXXXXXXXXXXXXXXXXXX
