------------------------------------------------------------------------------------------------------------------------------------------------------
------------------------------------------------------------------------------------------------------------------------------------------------------
------------------------------------------------------------------------------------------------------------------------------------------------------
------------------------------------------------------------------------------------------------------------------------------------------------------
---------------------------------oo-------------------------------------------------------------------------------------------------------------------
---------------------------------------------------------------------------------------------------SSS------------------------------------------------
------------------------------------------SS----------------------------------------------------------------------------------------------------------
---------------------------------------------------------------------------------------------------------------------%%%%--------%%%%-----------------
----------------------------------------------------------------------------------------------------------------------||----------||------------------
---------------------------------------------------------------------------------------------------------%%%%%--------||----------||------------------
----------------------------------------------------------------------------------------------------------|||---------||----------||------------------
----------------------------------------------------------------------------------------------------------|||---------||----------||------------------
----------------------------------------------------------------------------------------------------------|||---------||----------||---------------F--
-M--------------------------------------%%%%--------------------------------------------------------------|||---------||----------||---------------#--
XXXXXXXXXXXXXXXXXXXXXXXXXXXXXXXXXXXXXX---||---------------------------------------------------------------|||---------||----------||----------XXXXXXXX
XXXXXXXXXXXXXXXXXXXXXXXXXXXXXXXXXXXXXX---||---------------------------------------------------------------|||---------||----------||----------XXXXXXXX
