-----------------------------------------------------------------------------------------------------------------------------------------------------------------------------------------------------
-----------------------------------------------------------------------------------------------------------------------------------------------------------------------------------------------------
-----------------------------------------------------------------------------------------------------------------------------------------------------------------------------------------------------
---------------------------------------------------------------------------?-------------------------------------------------------------------------------------------------------------------------
-----------------------------------------------------------------------------------------------------------------------------------------------------------------------------------------------------
-----------------------------------------------------------------------------------------------------------------------------------------------------------------------------------------------------
-------------------------------SSSSS----QQQQQ------------------------------------------------------------------------------------LSSS----------------C-----------------------------------------------
-----------------------------------------------------------------------------------------------------------------------------------------------------------------------------------------------------
-----------------------------------------------------------------------------------------------------------------------------------------------------------------------------------------------------
------------------------------------------k----------------------------------------------------------------------------------------------------------------------------------------------------------
----------------------------------------?QQQQ------------------------------------------TT----------------------------------------2------------------SS-----------------------------------------------
---------------------------------------------------------------------------------------TT------------------------------------------------------------------------------------------------------------
---------------------------------------------------------------------------------------TT--------------------------------------------------------------------------------------------------------F---
--M----k--------------------------------------k----------------------------------------TT--------k--------------------------------kk----k------------k----k--------------------------------------X---
XXXXXXXXX------------------------------XXXXXXXXX------------------------------------XXXXXX---XXXXXX---------------------------XXXXXXXXXXXX------XXXXXXXXXXXX---------------------------------XXXXXXXX
XXXXXXXXX------------------------------XXXXXXXXX------------------------------------XXXXXX---XXXXXX---------------------------XXXXXXXXXXXX------XXXXXXXXXXXX---------------------------------XXXXXXXX
