----------------------------------------------------------------------------------------------------------------------------------------------------------------------------------------------------------
----------------------------------------------------------------------------------------------------------------------------------------------------------------------------------------------------------
----------------------------------------------------------------------------------------------------------------------------------------------------------------------------------------------------------
------------------------------SSS---------------------------SSoo-----%%%%--------------------------------------------------------------------------------------------------------------SS----SS-----------
----------------------------------------------------------------------||----------------------------------------------------------------------------------------------------------------------------------
----------------------------------------------------------------------||-------------------------#--------------------------------------------------------------------------------------------------------
---------------------------------------------------------------SSS----||------SSS---------------##----------SSS---------------------------------------------------SS----SS--------------------------------
----------------------------------------------------------------------||-----------------------###--------------------------------------------------------------------------------------------------------
----------------------------------------------------------------------||----------------------####--------------------------------------------------------------------------------------------------------
---------------------------------SSS------------------------SSS-------||---------------------#####----------------SSS------------------------------------SSS----------------------------------------------
----------------------------------------------------------------------||--------------------######--------------------------------------------------------------------------------------------------------
----------------------------------------------------------------------||-------------------#######--------------------------------------------------------------------------------------------------------
----------------------------------------------------------------------||-----------------#########----------------------------------------------------------------------------------------------------F---
---M------------------------------------------------------------------||--------------gg##########------------------------------------------------------------------------------o---------------------#---
XXXXXXXXX---------XXXXXX------------------------------------XXX-------||---------XXXXXXXXXXXXXXXXXXXXX---------XXXXXX------------------XXXXXX---XXX---XXX---------XXX---XXX---------------XXXXXXXXXXXXXXXX
XXXXXXXXX---------XXXXXX------------------------------------XXX-------||---------XXXXXXXXXXXXXXXXXXXXX---------XXXXXX------------------XXXXXX---XXX---XXX---------XXX---XXX---------------XXXXXXXXXXXXXXXX
