------------------------------------------------------------------------------------------------------------------------------------------------------
------------------------------------------------------------------------------------------------------------------------------------------------------
------------------------------------------------------------------------------------------------------------------------------------------------------
------------------------------------------------------------------------------------------------------------------------------------------------------
------------------------------------------------------------------------------------------------------------------------------------------------------
----------------------------------------------------------oo--oo---------oo--oo---------------------------------------------oo--oo--------------------
--------------------------------------------------------------------------------------------------------oo--------------------------------------------
------------------------------------------------------------------------------------------------------------------------------------------------------
----------------------------oo--oo--------------------------------------------------------------------------------------------------------------------
---------------------------------------------------------------------------------------------------------SSS---------%%%%%----------------------------
----------------------------------------------------------------------------------------------------------------------|||--------g-g------------------
----------------------------------------------------------------------------------------------------------------------|||-----%%%%%%------------------
----------------------------------------------------------------------------------------------------------------------|||-----|||||----------------F--
--M----------------------------------------------------------------------------------%%%%-----------------------------|||-----|||||----------------#--
XXXXXXXXXXXXXXXXXXXXXXXXXXXXXXXXXXXXXXXXXXXXXXXXXXXXXXXXXXXXXXXXXXXXXXXXXXXXXXXXXXX---||------------------------------|||-----|||||-----------XXXXXXXX
XXXXXXXXXXXXXXXXXXXXXXXXXXXXXXXXXXXXXXXXXXXXXXXXXXXXXXXXXXXXXXXXXXXXXXXXXXXXXXXXXXX---||------------------------------|||-----|||||-----------XXXXXXXX
