-------------------------------------------------------------------------------------------------------------------------------------------------------------------------------------------------------------------------------------------------------------------------------------------------------------------------------------------------------------------------------------
-------------------------------------------------------------------------------------------------------------------------------------------------------------------------------------------------------------------------------------------------------------------------------------------------------------------------------------------------------------------------------------
-------------------------------------------------------------------------------------------------------------------------------------------------------------------------------------------------------------------------------------------------------------------------------------------------------------------------------------------------------------------------------------
-------------------------------------------------------------------------------------------------------------------------------------------------------------------------------------------------------------------------------------------------------------------------------------------------------------------------------------------------------------------------------------
-------------------------------------------------------------------------------------------------------------------------------------------------------------------------------------------------------------------------------------------------------------------------------------------------------------------------------------------------------------------------------------
-------------------------------------------------------------------------------------------------------------------------------------------------------------------------------------------------------------------------------------------------------------------------------------------------------------------------------------------------------------------------------------
------------SSSSCSSS----------------------------------------------------------------------------------------------------------------oo----------------------------------------------------------oo-----------------------o----------------------------------------SSSSCSSS----------------------------------------------------------------------------------oo-----------------------
-------------------------------------------------------------------------------------------------------------------------------------------------------------------------------------------------------------------------------------------------------------------------------------------------------------------------------------------------------------------------------------
---------------------------------------------------------------------------------------------------------------------------------------------------------------------------------------------------------------------------------------------------------------------------------------------------------------------------oo--------------------------------------------------------
----------------------------------------------------------------------------------------o-----------------------------o----------------------------------------------------------------------------------------------------------------------------------------oo------------------------------------------------------------------------------------------------##------------------
----------------2----#------------------------------------------------------------------------------------------------------------------------------------------------------------------------------------------------------------------------------------------------2----#------------------------------------------------------------------------------------###------------------
-------TT---------K--#--------------------------------------------------------------------------------------------------------------------------------------------------------------------------------------------------------------------------------------------------K--#-----------------------------------------------------------------------------------####------------------
-------TT------------#-----------------------------------------------------------------------------------------------------------------------------------------------------------------------------------------------------------------------------------------------------#-------------------------------#---------------------#-----TT----#----------------#####--------------F---
-M-----TT---k--------#-----------------------------------------------------------------------------------------------------------------------------------------------------------------------------------------------------------------------------------------------------#-----------k-------------------#---------------------#-----TT----#-------------gg######-----k--------#---
XXXXXXXXXXXXXXXXXXXXXXXXXXXX---------XX---------------------------------------------------------------------------------------------------------------------------X-----------------------------------------X--------------------oo-------oo-------------------------XXXXXXXXXXXX-X-XXXXXX-X-XXXXXXXXXXXXXXXXXXXXXX-----------XXXXXXXXXXXXXXXXXXXXXXXXXXXXXXXXXXXXXXXXXXXXXXXXXXXXXXX
XXXXXXXXXXXXXXXXXXXXXXXXXXXX---------XX---------------------------------------------------------------------------------------------------------------------------X-----------------------------------------X--------------------------------------------------------XXXXXXXXXXXX-X-XXXXXX-X-XXXXXXXXXXXXXXXXXXXXXX-----------XXXXXXXXXXXXXXXXXXXXXXXXXXXXXXXXXXXXXXXXXXXXXXXXXXXXXXX
