--------------------------------------------------------------------------------------------------------------------------------------------------------------------------------
--------------------------------------------------------------------------------------------------------------------------------------------------------------------------------
--------------------------------------------------------------------------------------------------------------------------------------------------------------------------------
--------------------------------------------------------------------------------------------------------------------------------------------------------------------------------
--------------------------------------------------------------------------------------------------------------------------------------------------------------------------------
--------------------------------------------------------------------------------------------------------------------------------K-----------------------------------------------
----------------------------------------------------------------SSSSS-------------------------------------------------------SSSSS-----------------------------------------------
--------------------------------------------------------------------------------------------------------------------------------------------------------------------------------
---------------------------------------------------------------------------------------------------------------------------------------------------------k----------------------
-----------------------------------------------------------------K-----------------------------------------------------------K---------------------------##---------------------
----------------------------------------------------------------SSSSS-------------------------------------------------------SSSSS-----------------------###---------------------
-------------------------------------------------------------------K---#------------------------------------B------------------K---#-------------------####---------------------
-------------------------------------B-----------------B---------------#-------------------B----------------b-----------TT---------#------------------#####-----------B-----F---
-M-----------------------------------b-----------------b---------------#-------------------b----------------b-----------TT---------#-----------------######-----------b-----#---
XXXXXXXXXXXXXXXXXXXXXXXXXXXXXXXXXXXXXXXXXXXXXXXXXXXXXXXXXXXXXXXXXXXXXXXXXXXXXXXXXXXXXXXXXXXXXXXXXXXXXXXXXXXXXXXXXXXXX--XXXXXXXXXXXXXXXXXXXXXXXXXXXXX-XXXXXXXXXXXXXXXXXXXXXXXXXXX
XXXXXXXXXXXXXXXXXXXXXXXXXXXXXXXXXXXXXXXXXXXXXXXXXXXXXXXXXXXXXXXXXXXXXXXXXXXXXXXXXXXXXXXXXXXXXXXXXXXXXXXXXXXXXXXXXXXXX--XXXXXXXXXXXXXXXXXXXXXXXXXXXXX-XXXXXXXXXXXXXXXXXXXXXXXXXXX
