-------------------------------------------------------------------------------------------------------------------------------------------------------------------------------------------
-------------------------------------------------------------------------------------------------------------------------------------------------------------------------------------------
-------------------------------------------------------------------------------------------------------------------------------------------------------------------------------------------
---------SSS------SSSSSS---------------SSS---SSS------SSS--------------SSSS---SSS---------SSS---SSS------------SSSSSS------------SSS---SSS---------SSSS--------------------SSSSS----SSS----
-------------------------------------------------------------------------------------------------------------------------------------------------------------------------------------------
-------------------------------------------------------------------------------------------------------------------------------------------------------------------------------------------
---SSS--------SSSS------SSS---------SSS---------SSS------------------------------------SSS---------------------------------SSS---------------------------------SSS-------------------------
------------------------------------------------------------------------------------------------------------------------------------------------------------------------------------TT-----
------------------------------------------------------------------------------------------------------------------------------------------------------------------------------------TT-----
S-----SSS---------------------------------------------------------------SSSSSS------------SSS--------------------------SSSS---SSS---------SSSSSS---SSS---SSS------------SSS---------TT-----
S-----------------------------------------------------------------------------------------------------------------------------------------------------------------------------------TT----F
S-----------------------------------------------------------------------------------------------------------------------------------------------------------------------------------TT---SS
S--------------------SSS---SSSSSSSSS------------------------SSS-----SSSS---------SSSSSSSSS---------SSSSSSSSS---------------SSS---------SSS------------------------------------------TT---SS
S-M---------------------------------------------------------------------------------------------------------------------------------------------------------------------------------TT---SS
XXXXXX---------XXX---------------------------XXX---------------------------------------------XXX-------------------SSS--------------------------XXX---------XXX------------XXX---XXXXXX--XX
XXXXXX---------XXX---------------------------XXX---------------------------------------------XXX------------------------------------------------XXX---------XXX------------XXX---XXXXXX--XX
