--------------------------------------------------------------------------------------------------------------------------------------------------------------
--------------------------------------------------------------------------------------------------------------------------------------------------------------
--------------------------------------------------------------------------------------------------------------------------------------------------------------
------------------------------------------------------------------------------SSS---------SSS---SSS---------------SSSSSSSSLSSSSSS---SSSSSS--------------------
--------------------------------------------------------------------------------------------------------------------------------------------------------------
--------------------------------------------------------------------------------------------------------------------------------------------------------------
---SSS------SSS------------------------------------------SSS---SSSSSSSSS---------SSS------ooo------------------SSS------ooo------SSS---------SSS------SSS-----
--------------------------------------------------------------------------------------------------------------------------------------------------------------
------------------------------------------------------------------------------------------SSS---------------------------SSS-----------------------------------
S-----SSS------SSS---SSSSSS---------SSS---------------SSS---SSS---------------SSS------SSSSSSSSS------------------------SSSSSS---------SSS--------------------
S-------------------------------------------------------------------------------------------------------------------------------------------------------------
S-------------------------------------------------------------------------------------------------------------------------------------------------------------
S-------------------------------------------------------------------------------------------------------------------------------------------------------------
S--M--------------------------------------------------------------------------------------------------------g-g------------------g-g------------------------F-
XXXXXXXXXXXXXXXXXXXXXXXXXXX--XXXXXXXXXXXXXXXXXXXXXXXXXXXXXXXXXXXXXXXX--XXXXXXXXXXXXXXXXXXXXXXXXXXXXXXXXXXXXXXXXXXXXXXXXXXXXXXXXXXXXXXXXXXXXXX--XXXXXXXXXX--XXX
XXXXXXXXXXXXXXXXXXXXXXXXXXX--XXXXXXXXXXXXXXXXXXXXXXXXXXXXXXXXXXXXXXXX--XXXXXXXXXXXXXXXXXXXXXXXXXXXXXXXXXXXXXXXXXXXXXXXXXXXXXXXXXXXXXXXXXXXXXX--XXXXXXXXXX--XXX
