--------------------------------------------------------------------------------------------------------------------------------------------------------------
--------------------------------------------------------------------------------------------------------------------------------------------------------------
--------------------------------------------------------------------------------------------------------------------------------------------------------------
---SSS---SSSSSS------SSS------------SSS---------SSSSSS------------SSS---------------------------------------------SSS---------SSSSSS---------SSS------SSS-----
--------------------------------------------------------------------------------------------------------------------------------------------------------------
--------------------------------------------------------------------------------------------------------------------------------------------------------------
------------------------------SSS------------------------------------------SSS---SSS--------------SSS-------------------------------SSS------------------SSS--
--------------------------------------------------------------------------------------------------------------------------------------------------------------
--------------------------------------------------------------------------------------------------------------------------------------------------------------
S--------------------SSS---------SSSSSS---------------SSS-------SSSSSSSS------------------------------SSS------SSS------SSS------------SSS-------SSSSS--------
S-----------------------------------------g##---------------------------------------------------------------------------------g##-----------------------------
S-----------------------------------------###-----------------------------------------------SS--------------------------------###-----------------------------
S------------------TT-------------------g####--SSS---------SSS------------------------------SS------------------------------g####--SSS------SSS---------------
S--M---------------TT-------------------#####---------------------r-------------------------SS------------------------------#####------------------r--------F-
XXXXXXXXXXXXXXXXXXXXXXXXXXXXXX--XXXXXXXXXXXXX-------------------XXXXXXXXXXXXXXXXXXXXXXXXXX--XX--XXXXXXXXXXXXXXXXXXXXXXXXXXXXXXXXX----------------XXXXXXXX--XXX
XXXXXXXXXXXXXXXXXXXXXXXXXXXXXX--XXXXXXXXXXXXX-------------------XXXXXXXXXXXXXXXXXXXXXXXXXX--XX--XXXXXXXXXXXXXXXXXXXXXXXXXXXXXXXXX----------------XXXXXXXX--XXX
