-----------------------------------------------------------------------------------------------------------------------------------------------------------------------------------------------------
-----------------------------------------------------------------------------------------------------------------------------------------------------------------------------------------------------
-----------------------------------------------------------------------------------------------------------------------------------------------------------------------------------------------------
----------------------------------------------------------------------------------------------------------------------------------------------------------------------------SSSSS--------------------
-----------------------------------------------------------------------------------------------------------------------------------------------------------------------------------------------------
-----------------------------------------------------------------------------------------------------------------------------------------------------------------------------------------------------
---------------------------------------------------------------------------------LSSS--------------------------------------------------------------------------------------------LSSS---------SSSS---
-----------------------------------------------------------------------------------------------------------------------------------------------------------------------------------------------------
-----------------------------------------------------------------------------------------------------------------------------------------------------------------------g-----------------------------
------------------------------------------------------------------------------------------------------------------------g----------------------------------------------#-----------------------------
----------------------------------------------TT---------------------------------2--------------------------------------TT----------------------------TT--------------##---------2-------------------
----------------------------------------------TT------------------------------------------------------------------------TT----------------------------TT-------------###-----------------------------
----------------------------------------------TT------------------------------------------------------------------------TT----?-----------------------TT------------####-------------------------F---
--M----k--------------------------------------TT----k-----------------------------kk----k-------------------------------TT----------------------------TT-----------#####----------kk----k--------X---
XXXXXXXXX---------------------------------XXXXXXXXXXXX------------------------XXXXXXXXXXXX---------------------------XXXXXX------------------------XXXXXX------XXXXXXXXXXXXXXXXXXXXXXXXXXX---XXXXXXXX
XXXXXXXXX---------------------------------XXXXXXXXXXXX------------------------XXXXXXXXXXXX---------------------------XXXXXX------------------------XXXXXX------XXXXXXXXXXXXXXXXXXXXXXXXXXX---XXXXXXXX
