----------------------------------------------------------------------------------------------------------------------------------------------------------------------------------------------------------------------
----------------------------------------------------------------------------------------------------------------------------------------------------------------------------------------------------------------------
----------------------------------------------------------------------------------------------------------------------------------------------------------------------------------------------------------------------
------------SSS---------------------------------------------------------------------------------------------------------SSS--------------------------------------S----------------------------------------------------
------------------------------------------------------------------------------------------------------------------------------------------------------------------------------------------------------------K---------
-------------------------------------------------------------------------------k--------------------------------------------------------------------------------------------------------------------------------------
---------------------SSS------------------SSS------------------SSSSS----------SSS---------------------------------------------------------------------------------------------------------------------------##--------
-----------------------------------------------------------------------------------------------------------------------------------------------------------------------------------------------------------###--------
-------------------------------------------------------------------------------------------------------------------------------------TT-------------------------------------------------------------------####--------
------------------------SSS----------------------------------------------------------------------------------------------------------TT------------------------------------------------------------------#####--------
-----SSS------------------------------------------------------------2-------------------------------------------TT-------------------TT----------------------------------------------------------------TT#####--------
------------------------------------------------------------------TT------------------------------------------TTTT-------------------TT---------------------------------------------------------------#TT#####--------
---------------------------------------------TTTT-----TTT---TTT---TT----TTTT-----TTTTTTT-----TTT------------TTTTTT---------TT--------TT---TTT-----TT--------TTT---TTT------------TT-------TTT--------##TT#####-----F--
---M-----------------------------------------TTTT-----TTT---TTT---TT----TTTT-----TTTTTTT-----TTT------------TTTTTT---------TT--------TT---TTT-----TT--------TTT---TTT------------TT-------TTT-------###TT#####-----#--
XXXXXXXXXX---------------------XXXXXXXXXXXXXXXXXXXXXXXXXXXXXXXXXXXXXXXXXXXXXXXXXXXXXXXXXXXXXXXXXXXXXXXXXXXXXXXXXXXXXXXXXXXXXXXXXXXXXXXXXXXXXXXXXXXXXXXXXXXXXXXXXXXXXXXXXXXXXXXXXXXXXXXXXXXXXXXXXXXXXXXXXXXXXXXXXXXXXXX
XXXXXXXXXX---------------------XXXXXXXXXXXXXXXXXXXXXXXXXXXXXXXXXXXXXXXXXXXXXXXXXXXXXXXXXXXXXXXXXXXXXXXXXXXXXXXXXXXXXXXXXXXXXXXXXXXXXXXXXXXXXXXXXXXXXXXXXXXXXXXXXXXXXXXXXXXXXXXXXXXXXXXXXXXXXXXXXXXXXXXXXXXXXXXXXXXXXXX
