--------------------------------------------------------------------------------------------------------------------------------------------------------------------------------
--------------------------------------------------------------------------------------------------------------------------------------------------------------------------------
--------------------------------------------------------------------------------------------------------------------------------------------------------------------------------
--------------------------------------------------------------------------------------------------------------------------------------------------------------------------------
--------------------------------------------------------------------------------------------------------------------------------------------------------------------------------
--------------------------K---------------------------------------------------------------k-------------------------------------------------------------------------------------
----------------------SSSSS---------------------------------------------------------------##------------------------------------------------------------------------------------
-----------------------------------------------------------------------------------------###------------------------------------------------------------------------------------
----------------------------------------------------------------------------------------####------------------------------------------------------------------------------------
-----------------------K----------------------SS---------------------------------------#####------------------------------------------------------------------------------------
----------------------SSSSS-----------------------------------------------------------######------------------------------------------------------------------------------------
-------------------------K---#------------------------------------------TT-----------#######------------------------------------------------------------------------------------
-----------B-----------------#---------TT----------TT-----------TT------TT----------########---------B------B---------B-------------TT-----B--------------------------------F---
-M---------b-----------------#---------TT----------TT-----------TT------TT---------#########---------b------b---------b-------------TT-----b--------------------------------#---
XXXXXXXXXXXXXXXXXXXXXXXXXXXXXXXXXXXX--XXXXXXXXXX--XXXXXXXXXXXXXXXXXXXXXXXXXXXXXXXX-XXXXXXXXXXXXXXXXXXXXXXXXXXXXXXXXXXXXXXXXXXXXXX--XXXXXXXXXXXXXXXXXXXXXXXXXXXXXXXXXXXXXXXXXXXXX
XXXXXXXXXXXXXXXXXXXXXXXXXXXXXXXXXXXX--XXXXXXXXXX--XXXXXXXXXXXXXXXXXXXXXXXXXXXXXXXX-XXXXXXXXXXXXXXXXXXXXXXXXXXXXXXXXXXXXXXXXXXXXXX--XXXXXXXXXXXXXXXXXXXXXXXXXXXXXXXXXXXXXXXXXXXXX
