------------------------------------------------------------------------------------------------------------------------------------------------------------------------------------------------------------------------------
------------------------------------------------------------------------------------------------------------------------------------------------------------------------------------------------------------------------------
------------------------------------------------------------------------------------------------------------------------------------------------------------------------------------------------------------------------------
------------------------------------------------------------------------------------------------------------------------------------------------------------------------------------------------------------------------------
------------------------------------------------------------------------------------------------------------------------------------------------------------------------------------------------------------------------------
----------------------------------y-------------------------------------------------------------------------------------------------------------------------------------------------------------------------------------------
----------------------------------##------------------------------------------------------------------------------------------------------------------------------------------------------------------------------------------
--------------------------------y###------------------------------------------------------------------------------------------------------------------------------------------------------------------------------------------
--------------------------------####------------------------------------------------------------------------------------------------------------------------------------------------------------------------------------------
-------------------------------#####-----------------------------------------------------------------------oo-----------------------------------------------------------------------------------------------------------------
------------------------------######-------------------TT-------------------------------------------------o--o----------------------------------------------------------------------------------------------------------------
-----------------------------#######-------------------TT--------------------#--------------------------------------------------#---------------------------------------------------------------------------------------------
----------------------------########-------------------TT--------------------#--------------------------------------------------#------------------------------------------------------------------------TT---------------F---
-M---------------------y---#########---y------------y--TT----------y---------#----y--------------------y------------------------#----y------------------y-------y----------------------------------------TT--------y------#---
XXXXXXXXXXXXXXXX--XXXXXXXXXXXXXXXXXXXXXXXXXXXXXXXXXXXXXXXXXXXXXXXXXXXXXXXXXXXX--XXXXXXXXXXXXXXXXXXXXXXXXXXXXXXXXXXXXXXXXXXXXXXXXX--XXXXXXXXXXXXXX--XXXXXXXXXXXXXXXXXXXXXXXXXXXXXXXXXXXXXXXXXXXXXXXXXXXXXXXXXXXXXXXXXXXXXXXXXXX
XXXXXXXXXXXXXXXX--XXXXXXXXXXXXXXXXXXXXXXXXXXXXXXXXXXXXXXXXXXXXXXXXXXXXXXXXXXXX--XXXXXXXXXXXXXXXXXXXXXXXXXXXXXXXXXXXXXXXXXXXXXXXXX--XXXXXXXXXXXXXX--XXXXXXXXXXXXXXXXXXXXXXXXXXXXXXXXXXXXXXXXXXXXXXXXXXXXXXXXXXXXXXXXXXXXXXXXXXX
