------------------------------------------------------------------------------------------------------------------------------------------------------
------------------------------------------------------------------------------------------------------------------------------------------------------
------------------------------------------------------------------------------------------------------------------------------------------------------
------------------------------------------------------------------------------------------------------------------------------------------------------
------------------------------------------------------------------------------------------------------------------------------------------------------
------------------------------------------------------------------------------SSS---------------------------------------------------------------------
------------------------------------------------------------------------------------------------------------------------------------SS----------------
---------------oo----------------oo-------------------------------------------------------------------------------------------------------------------
------------------------------------------------------------------------------------------------------------------------------------------------------
-------------------------------------------------------------------------------------------------R----------------------------------------------------
------------------------------------------------------------------------------------------------------------------------------------------------------
------------------------------------------------------------------------------------------%%%%%-------------------------------------------------------
------------------------------------------------------------------------------------------||||-----------------------------------------------------F--
-M-----------------------------------------------------%%%%----------------oo-------------||||--------------------------------oo-------------------#--
XXXXXXXXXXXXXXXXXXXXXXXXXXXXXXXXXXXXXXXXXXXXXXXXXXXXX---||--------------------------------||||------------------------------------------------XXXXXXXX
XXXXXXXXXXXXXXXXXXXXXXXXXXXXXXXXXXXXXXXXXXXXXXXXXXXXX---||--------------------------------||||------------------------------------------------XXXXXXXX
