-------------------------------------------------------------------------------------------------------------------------------------------------------------------------------------------------------------------------------------------------------------------------------------------------------------------------------------------------------------------------------------
-------------------------------------------------------------------------------------------------------------------------------------------------------------------------------------------------------------------------------------------------------------------------------------------------------------------------------------------------------------------------------------
-------------------------------------------------------------------------------------------------------------------------------------------------------------------------------------------------------------------------------------------------------------------------------------------------------------------------------------------------------------------------------------
-------------------------------------o----------------------------------------------------------------------------------------------------------------------------------------------------------------------------------------------------------------oo-----------------------------------------------------------------------------------------------------------------------------
-------------------------------------------------------------------------------------------------------------------------------------------------------------------------------------------------------------------------------------------------------------------------------------------------------------------------------------------------------------------------------------
---------------------------------------------------------------------------------------------------------------------------------------------------------------------------------------------------------------------------------------------------------------------------------------------------------------------------------------#---------------------------------------------
---------------------oo---------------------------------------------------------------------------------------------------------------------------------------------------------------------------------------------------------------------------------------------------------------##----------------------------------------------##---------------------------------------------
--------------------------------------------------------------------------------------------------------------------------------------------------------------------------------------------------------------------------------------------------------------------------------------##----------------------------------------------##---------------------------------------------
------------------------------------------------------------------------------------------------------------------------------------------------------------------------------------------------------------------------------------------------------------------------------------#-##--------------------------------------------#-##---------------------------------------------
--------------------------------------------------------------------------------------------------------------------------o---------------------------------------------------------------------------------o-----------------------------------------------------------------------#-##-----------------SSSSS----------------------#-##------------o--------------------------------
-------------------------------------------------------------------------------------------------------------------------------------TT-------------------------------------------------------------------------------------------------------------------------------------------#-#-##------------------------------------------#-#-##--------TT-----------------------------------
-------------------------------------------------------------------------------------------------------------------------------------TT-------------------------------------------------------------------------------------------------------------------------------------------#-#-##------------------------------------------#-#-##--------TT-----------------------------------
-------------------------------------------------------------------------------------------------------------------------------------TT------------------------------------TT---------------#------------------------------#-----------TT----------------------oo----------TT---#-#-#-##-----------------------------#-----TT---#-#-#-##--------TT-------------------------------F---
-M-----------------------------------------------------------------------------------------------------------------------------------TT------------------k--------k--------TT---------------#------------------------------#-----------TT----------------------------------TT---#-#-#-##-----------------------------#-----TT---#-#-#-##--------TT----k--ggg------------ggg------#---
XXXXXXX-----------------------------------------------------------------------------------------------------------------X--------XXXXXXXXXXXX-X-XXXX-XXXXXXXXXXXXXXXXXXXXXXXXXXXXX-XXXXXXXXXXXXXXXXXXXXXX-X-XXXXXXXXXXXXXXXXXXXXXXXXXXXXXXXXXXXXX-----X-----------------XXXXXXX-X-X-X-XXXXXXXX--------------XXXXXXXXXXXXXXXXXXX-X-X-X-XXXXXXXXXXXXXXXXXXXXXXXXXXXXXXXXXXXXXXXXXXXXXXX
XXXXXXX-----------------------------------------------------------------------------------------------------------------X--------XXXXXXXXXXXX-X-XXXX-XXXXXXXXXXXXXXXXXXXXXXXXXXXXX-XXXXXXXXXXXXXXXXXXXXXX-X-XXXXXXXXXXXXXXXXXXXXXXXXXXXXXXXXXXXXX-----X-----------------XXXXXXX-X-X-X-XXXXXXXX--------------XXXXXXXXXXXXXXXXXXX-X-X-X-XXXXXXXXXXXXXXXXXXXXXXXXXXXXXXXXXXXXXXXXXXXXXXX
