----------------------------------------------------------------------------------------------------------------------------------------------------------------------------------------------------------
----------------------------------------------------------------------------------------------------------------------------------------------------------------------------------------------------------
----------------------------------------------------------------------------------------------------------------------------------------------------------------------------------------------------------
----------------------------------------------------------------------------------------------------------------------------------------------------------------------------------------------------------
----------------------------------------------------------------------------------------------------------------------------------------------------------------------------------------------------------
----------------------------------------------------------------------------------------------------------------------------------------------------------------------------------------------------------
--------------------------------------------##------------------------------------------------------------------------------------------------------------------------------------------------------------
-------------------------------------------###------------------------------------------------------------------------------------------------------------------------------------------------------------
------------------------------------------####------------------------------------------------------------------------------------------------------------------------------------------------------------
-----------------------------------------#####---------------------------------------1--------------------------------------------------------------------------------------------------------------------
----------!-----------------------------######------------------------------------------------------------------------------------------------------------------------------------------------------------
---------------------------------------#######-------------------------------------------------------------------------------------------------tt---------------------------------------------------------
--------------------------------------########---------------------tt----------------------tt----------tt--------------------------------------tt------------tt---------------------------------------F---
---M---------------gg-g------g-g-----#########------------gg-g-----tt-----g-g--------------tt----------tt--------g-g---------------------------tt-g----------tt---------------------------------------#---
XXXXXXXXXXXXXXXXXXXXXXXXXXXXXXXXXXXXXXXXXXXXXXXXXXXXXXXXXXXXXXXXXXXXXXXXXXXXXXXXXXXXXXXXXXXXXXXXXXXXXXXXXXXXXXXXXXXXXXXXXXXXXXXXXXXXXXXXXXXXXXXXXXXXXXXXXXXXXXXXXXXXXXXXXXXXXXXXXXXXXXX--XXXXXXXXXXXXXXXXX
XXXXXXXXXXXXXXXXXXXXXXXXXXXXXXXXXXXXXXXXXXXXXXXXXXXXXXXXXXXXXXXXXXXXXXXXXXXXXXXXXXXXXXXXXXXXXXXXXXXXXXXXXXXXXXXXXXXXXXXXXXXXXXXXXXXXXXXXXXXXXXXXXXXXXXXXXXXXXXXXXXXXXXXXXXXXXXXXXXXXXXX--XXXXXXXXXXXXXXXXX
