----------------------------------------------------------------------------------------------------------------------------------------------------------------------------------------------------------
----------------------------------------------------------------------------------------------------------------------------------------------------------------------------------------------------------
----------------------------------------------------------------------------------------------------------------------------------------------------------------------------------------------------------
----------------------------------------------------------------------------------------------------------------------------------------------------------------------------------------------------------
----------------------------------------------------------------------------------------------------------------------------------------------------------------------------------------------------------
----------------------------------------------------------------------------------------------------------------------------------------------------------------------------------------------------------
-------------------------------@---------------------------------------------------------------------##------------------------------------------SSS----S!!S----------------------------------------------
----------------------------------------------------------------------------------------------------###---------------------------------------------------------------------------------------------------
---------------------------------------------------------------------------------------------------####---------------------------------------------------------------------------------------------------
--------------------------------------------------------------------------------------------------#####---------------------------------------------------------------------------------------------------
-------------------------------!-----------------------##--#-------------------------------------######--------------------------------------------------SS-----------------------------------------------
------------------------------------------------------###--##-----------------------------------#######---------------------------------------------------------------------------------------------------
-----------------------------------------------------####--###---------------------------------########---------------------------tt------------------------------------------------------------------F---
---M-------------------------------------g-g--------#####--####--------------------g-g--------#########----------------g-g--------tt---------------------g----------------------------------g-g-------#---
XXXXXXXXXXXX--XXXX--XXXXXXXXXXXXXXXXXXXXXXXXXXXXXXXXXXXXXXXXXXXXXXXXXXXXXXXXXXXXXXXXXXXXXXXXXXXXXXXXXXXXXXXXXXXXXXXXXXXXXXXXXXXXXXXXXXXXXXXXXXXXXXXXXXXXXXXXXXXXXXXXXXXXXXXXXX--XXXXXXXXXXXXXXXXXXXXXXXXXX
XXXXXXXXXXXX--XXXX--XXXXXXXXXXXXXXXXXXXXXXXXXXXXXXXXXXXXXXXXXXXXXXXXXXXXXXXXXXXXXXXXXXXXXXXXXXXXXXXXXXXXXXXXXXXXXXXXXXXXXXXXXXXXXXXXXXXXXXXXXXXXXXXXXXXXXXXXXXXXXXXXXXXXXXXXXX--XXXXXXXXXXXXXXXXXXXXXXXXXX
