----------------------------------------------------------------------------------------------------------------------------------------------------------------------------------------------------------
----------------------------------------------------------------------------------------------------------------------------------------------------------------------------------------------------------
----------------------------------------------------------------------------------------------------------------------------------------------------------------------------------------------------------
---------------------------------------------------------------------------------------------------------------------SSS----------------------------------------%%%%--------------------------------------
----------------------SS-----------------------------------------------------------------------------------------------------------------------------------------||-----oo--------------------------------
-----------------------------------------------------------------------------------------------------------------------------------------------------------------||---------------------------------------
---------------SSS------------SSSSS-------------SSS-----------------------------------------------------------------------------------S--------------------------||---------------------------------------
-----------------------------------------------------------------------------------------------------------------------------------------------------------------||---------------------------------------
-----------------------------------------------------------------------------------------------------------------------------------------------------------------||---------------------------------------
---------------------------------------------------------------------------------------------------------------------------------SSS-----------------------------||---------------------------------------
--------------------------?--------------------------------------------------------------------------------------------------------------------------------------||----------------o----------------------
--------------------------------------------------------------SS-------------------------------------------------------------------------------------------------||---------------------------------------
------------------SSS-----------------------------------S--------------------------------------------------------------------------------------------------------||-----------------------------------F---
---M----------------------------------------------------------------------------------------------------------------------------------------SS-------------------||-----------------------------------#---
XXXXXXXXXXX-------------%%%------XXXXXX------------------------------XXX------------------------------XXXXXX---%%%---------XXX---------------------------------%%%%%-%%%---------------XXXXXX------XXXXXXX
XXXXXXXXXXX-------------||-------XXXXXX------------------------------XXX------------------------------XXXXXX---||----------XXX---------------------------------||||--|||---------------XXXXXX------XXXXXXX
