--------------------------------------------------------------------------------------------------------------------------------------------------------------
--------------------------------------------------------------------------------------------------------------------------------------------------------------
--------------------------------------------------------------------------------------------------------------------------------------------------------------
---------SSS------SSS------------------------------SSSSSS------SSSSSSSSSSSSSSSSSSSSSSSSSSSSSSSSS------SSS---------------SSS-----SSS----------------------SSS--
------------------------------------------------------------------SS--SSSSSS--SSSS------SSSS------------------------------------------------------------------
------------------------------------------------------------------SS--SSSSSS--SSSS---g--SSSS------------------------------------------------------------------
---------------------SSSSSS---SSS------------SSS----------------SS--------SS---S----SS-------------SSS---SSSSSS---------------------------------------SSS-----
----------------------------------------------------------------SS--------SS---S----SS------------------------------------------------------------------------
----------------------------------------------------------------SS--------SS---S----SS------------------------------------------------------------------------
S-----SSSSSSSSS------------------SSS---SSS------SSS------SSS----SS----ooooSS---SoU--SC--g-g-----------SSS----------------------------------------SSSSS--------
S---------------------------------------------------------------SSSS--SSSSSS---SSS--SS--SSSS-------------------------------g##--------------------------------
S-----------------------------------------------------------------SS-------------------------------------------------------###--------------------------------
S-----------------------------------------------------------------SS--------------------------------TT-------------------g####--SSS---------SSS---------------
S--M--------------------------------------------------------------------k--g-g----------------------TT-------------------#####---------------------r--------F-
XXXXXXXXXXXXXXXXXXXXXXXXXXXXXXXXXXXXXXXXXXXXXXXXXXXXXXXXXXXXXXXXXXXXXXXXXXXXXXXXXXXXXXXXXXXX---XXXXXXXXXXXXX--XXXXXXXXXXXXXXXX-------------------XXXXXXXX--XXX
XXXXXXXXXXXXXXXXXXXXXXXXXXXXXXXXXXXXXXXXXXXXXXXXXXXXXXXXXXXXXXXXXXXXXXXXXXXXXXXXXXXXXXXXXXXX---XXXXXXXXXXXXX--XXXXXXXXXXXXXXXX-------------------XXXXXXXX--XXX
