--------------------------------------------------------------------------------------------------------------------------------------------------------------------------------
--------------------------------------------------------------------------------------------------------------------------------------------------------------------------------
--------------------------------------------------------------------------------------------------------------------------------------------------------------------------------
-----------------------------------------------------------------------------------------------------------------------------------------USS------------------------------------
--------------------------------------------------------------------------------------------------------------------------------------------------------------------------------
------------------------------------------------------------------k-------------------------------------------------------------------------------------------------------------
------------------------------------------------------------------##------------------------------------------------------------------------------------------------------------
-----------------------------------------------------------------###------------------------------------------------------------------------------------------------------------
------------B---------------------------------------------------####----------------------------------------------------------------------B-------------------------------------
------------b--------------------------------------------------#####--------------------------------------SS------------------------------b-------------------------------------
----------SS#CS-----------------------------------------------######--------------------------------------------------------------------SS#CS-----------------------------------
-------------------------------------------------------------#######-------------------------------------------TT---------------------------------------------------------------
--------------K-B----TT-------TT--------------B-------------########----------------TT----------TT-------------TT-------TT------------------K-B-------TT-----B--------------F---
-M--------------b----TT-------TT--------------b------------#########----------------TT----------TT-------------TT-------TT--------------------b-------TT-----b--------------#---
XXXXXXXXXXXXXXXXXXXXXXXXXXXXXXXXXXXXXXXXXXXXXXXXXXXXXXXXXX-XXXXXXXXXXXXXXXXXXXXXX--XXXXXXXXXX--XXXXXXXXXXXXXXXXXXXXXX--XXXXXXXXXXXXXXXXXXXXXXXXXXXXXXXXXXXXXXXXXXXXXXXXXXXXXXXXX
XXXXXXXXXXXXXXXXXXXXXXXXXXXXXXXXXXXXXXXXXXXXXXXXXXXXXXXXXX-XXXXXXXXXXXXXXXXXXXXXX--XXXXXXXXXX--XXXXXXXXXXXXXXXXXXXXXX--XXXXXXXXXXXXXXXXXXXXXXXXXXXXXXXXXXXXXXXXXXXXXXXXXXXXXXXXX
