---------------------------------------------------------------------------------------------------------------------------------------------------------------------
---------------------------------------------------------------------------------------------------------------------------------------------------------------------
---------------------------------------------------------------------------------------------------------------------------------------------------------------------
------------------------------------------------------------SSoo-----------------------------------------------------------------------------------------------------
------------------------------------------------------------------------SSSS--------------------------SSS------------------------------------------------------------
---------------------------------------------------------------------------------------------------------------------------------------------------------------------
-------------------------------------------------------------------------------------------%%%%----------------------------------------------------------------------
-----------SS---------------------------------------------------SS--------------------------||-----------------------------------------------------------------------
--------------------------------------------------------------------------------------------||-----------------------------------------------------------------------
--------------------------------------------------------------------------------------------||-----------------------------------------------------------------------
--------------------------------------------------------------------SSS---------------------||-----------------------------------------------------------------------
--------------------------------------------------------------------------------------------||-----------------------------------------------------------------------
--------------------------------------------------------------------------------------------||---------------------------------------------------------------------F-
-M------------------------------------------------------------------------------------------||---------------------------------------------------------------------X-
XXXXXXXX--%%%%--------------%%%%------------------------------------------------------------||-XXXXXXXXXXXXXXXXXXXXXXXXXXXXXXXXXXXXXXXXXXXXXXXXXXXXXXXXXXXXXXXXXXXXXX
XXXXXXXX---||----------------||-------------------------------------------------------------||-XXXXXXXXXXXXXXXXXXXXXXXXXXXXXXXXXXXXXXXXXXXXXXXXXXXXXXXXXXXXXXXXXXXXXX
