-------------------------------------------------------------------------------------------------------------------------------------------------------------------------------------------
-------------------------------------------------------------------------------------------------------------------------------------------------------------------------------------------
-------------------------------------------------------------------------------------------------------------------------------------------------------------------------------------------
------SSSSSSSSS---------------SSS---------SSSSSS---------------SSS------------SSS------------------------SSS---SSS------------SSS------SSS------------------------SSS---SSS---------SSS----
-------------------------------------------------------------------------------------------------------------------------------------------------------------------------------------------
-------------------------------------------------------------------------------------------------------------------------------------------------------------------------------------------
------------------SSS------------SSS------------------SSS---------SSSSSS---SSS---SSS------SSSSSS------------SSS---------------------SSS-----SSSS---------SSS---------------SSS-------------
------------------------------------------------------------------------------------------------------------------------------------------------------------------------------------TT-----
------------------------------------------------------------------------------------------------------------------------------------------------------------------------------------TT-----
S----------------------------------------------------------SSSSSSS---------------------SSS---------SSS---SSS------------SSS------SSS------------------SSS---------SSS---------SSS---TT-----
S-----------------------------------------------------------------------------------------------------------------------------------------------------------------------------------TT----F
S-----------------------------------------------------------------------------------------------------------------------------------------------------------------------------------TT---SS
S--------------------SSS-----------SSSS------SSS------------------------------------------SSS---SSS---------------SSS------SSSSSS---SSS-----------SSSS---SSS---------------SSS------TT---SS
S-M---------------------------------------------------------------------------------------------------------------------------------------------------------------------------------TT---SS
XXXXXX---------XXX---------XXX---------------------XXX------------XXX-----------X---XXX---------------------XXX---------------------------XXX------------------XXX---------------XXXXXX--XX
XXXXXX---------XXX---------XXX---------------------XXX------------XXX-----------X---XXX---------------------XXX---------------------------XXX------------------XXX---------------XXXXXX--XX
