------------------------------------------------------------------------------------------------------------------------------------------------------
------------------------------------------------------------------------------------------------------------------------------------------------------
------------------------------------------------------------------------------------------------------------------------------------------------------
------------------------------------------------------------------------------------------------------------------------------------------------------
------------------------------------------------------------------------------------------------------------------------------------------------------
------------------------------------------------------------------------------------------------------------------------------------------------------
------------------------------------------------------------------------------------------------------------------------------------------------------
--------------------------------------------------------------------------SS-------------------SS-----------------------------------------------------
------------------------------------------------------------------------------------------------------------------------------------------------------
--------------------------------------------------------oo-------------------------------------------------------------------oo-----------------------
---------------------------------------------%%%%------------g-g------------------------------------------------------------------g-g-----------------
----------------------------------------------||-----------%%%%%%%--------------------------------------------------------------%%%%%%%---------------
------------------------------------SS--------||------------|||||----------------------------------------------------------------|||||-------------F--
-M-----------------%%%%-----------------------||------------|||||----------------------------------------------------------------|||||-------------#--
XXXXXXXXXXXXXXXXX---||------------------------||------------|||||----------------------------------------------------------------|||||--------XXXXXXXX
XXXXXXXXXXXXXXXXX---||------------------------||------------|||||----------------------------------------------------------------|||||--------XXXXXXXX
