-------------------------------------------------------------------------------------------------------------------------------------------------------------------------------------------------------------------------------------------------------------------------------------------------------------------------------------------------------------------------------------
-------------------------------------------------------------------------------------------------------------------------------------------------------------------------------------------------------------------------------------------------------------------------------------------------------------------------------------------------------------------------------------
-------------------------------------------------------------------------------------------------------------------------------------------------------------------------------------------------------------------------------------------------------------------------------------------------------------------------------------------------------------------------------------
-------------------------------------------------------------------------------------------------------------------------------------------------------------------------------------------------------------------------------------------------------------------------------------------------------------------------o-----------------------------------------------------------
-------------------------------------------------------------------------------------------------------------------------------------------------------------------------------------------------------------------------------------------------------------------------------------------------------------------------------------------------------------------------------------
---------------------------------------------------------------------------------------------------------------------------------------------------------------------------------------------------------oo--------------------------------------------------------------------------------------------------------------------------------------------------------------------------
--------------------------------------------------------------------------------------------------------------------------------------------------------------------##--------------------------------------------------------------------------------------------------------------------------------------------------------SSSSCSSS-----------------------------------------------
--------------------------------------------------------------------------------------------------------------------------------------------------------------------##---------------------------------------------------------------------------------------------------------------------------------------------------------------------------------------------------------------
------------------------------------------------------------------------------------------------------------------------------------------------------------------#-##---------------------------------------------------------------------------------------------------------------------------------------------------------------------------------------------------------------
------------------------------------------------------------------------------------------------------------------------------------oo----------------------------#-##----------------------------------------------------------------------------------------------------------------------------------------------------##---------------------------------------------------------
----------------------------------------------------------------------------------------------------------------------------------------------------------------#-#-##---------------------------------------------------------------------------------------------------------------------------------------------------###------2----#---------------------------------------------
----------------------------------------------------------------------------------------------------------------------------------------------------------------#-#-##------------------------------------------------------------------------------------------------TT------------------------------------------------####--------K--#---------------------------------------------
---------------------------------------------------------------------------------------------------------------------------------------------------------TT---#-#-#-##-------------------#---------------------------------------TT-------------------------TT--------TT-----------------------------------------------#####-----------#--------------------#--------------------F---
-M-------------------------------------------------------------------------------------------------------------------------------------------------------TT---#-#-#-##--k--------------kk#------k-----------k--------------------TT-------------------------TT--------TT------------k-------------------------------gg######-----------#---------k----------#--------------------#---
XXXXXXX-----------------X--------------------------------------------------------------------------------------------------------------------XXXXXXXXXXXXXXXX-X-X-X-XXXXXXXXXXXXXXXXXXXXXXXXXXXXXXXXXXXXXXXXXXXXXXXXXX-----XXXXXXXXXXXXXXXX--------------XXXXXXXXXXXXXXXXXXXXXX-XXXXXXXXXXXXX-X-XXXXXXXXXX-XXXXXXXXXXXXXXXXXXXXXXXXXXXXXXXXXXXXXXXXXXXXXXXXXXXXXXXX-----------XXXXXXX
XXXXXXX-----------------X--------------------------------------------------------------------------------------------------------------------XXXXXXXXXXXXXXXX-X-X-X-XXXXXXXXXXXXXXXXXXXXXXXXXXXXXXXXXXXXXXXXXXXXXXXXXX-----XXXXXXXXXXXXXXXX--------------XXXXXXXXXXXXXXXXXXXXXX-XXXXXXXXXXXXX-X-XXXXXXXXXX-XXXXXXXXXXXXXXXXXXXXXXXXXXXXXXXXXXXXXXXXXXXXXXXXXXXXXXXX-----------XXXXXXX
