------------------------------------------------------------------------------------------------------------------------------------------------------
------------------------------------------------------------------------------------------------------------------------------------------------------
------------------------------------------------------------------------------------------------------------------------------------------------------
---------------------SS-------------------------------------------------------------------------------------------------------------------------------
------------------------------------------------------------------------------------------------------------------%%%%--------------------------------
----oo--oo---------------------------------------------------------------------------------------------------------||---------------------------------
---------------------------------------SS--------------------------------------------------------------------------||---------------------------------
------------------------------oo-----------------------------------------------------------------------------------||---------------------------------
-------------------------------------------------------------------------------------------------------------------||---------------------------------
--------------------------------------------------------------------------oo---------------------------------------||---------------------------------
-------------------------------------------------------------------------------g-g---------------------------------||---%%%%--------------------------
-----------------------------------------------------------------------------%%%%%%%-------------------------------||----||---------------------------
------------------------------------------------------------------------------|||||--------------R-----------------||----||------------------------F--
-M--------%%%%----------------------------------------------------------------|||||--------------------------------||----||------------------------#--
XXXXXXXX---||-----------------------------------------------------------------|||||-------%%%%%--------------------||----||-------------------XXXXXXXX
XXXXXXXX---||-----------------------------------------------------------------|||||--------|||---------------------||----||-------------------XXXXXXXX
