------------------------------------------------------------------------------------------------------------------------------------------------------------------------------------------------------------------------------
------------------------------------------------------------------------------------------------------------------------------------------------------------------------------------------------------------------------------
------------------------------------------------------------------------------------------------------------------------------------------------------------------------------------------------------------------------------
------------------------------------------------------------------------------------------------------------------------------------------------------------------------------------------------------------------------------
------------------------------------------------------------------------------------------------------------------------------------------------------------------------------------------------------------------------------
-------------------------------------------------y----------------------------------------------------------------------------------------------------------------------------------------------------------------------------
-------------------------------------------------##------------------------------------------------------------------------------------------------------------------------------------------------------------Q-Q------------
-----------------------------------------------y###---------------------------------------------------------------------------------------------------------------------------------------------------------------------------
-----------------------------------------------####---------------------------------------------------------------------------------------------------------------------------------------------------------------------------
----------------------------------------------#####---------------------------------------------------------------------------------------------------------------------------------------------------------------------------
---------------------------------------------######------------------------------C-----------------------------------------------------------------------------------------------------------------------------Q-Q------------
--------------------------------------------#######--------------------------------------------------------------------------------------------------------------#------------------------------------------------------------
-------------------------------------------########--------------------------------------------------------------------------------------------------------------#--------------------------------------------------------F---
-M---------------------------------y------#########------------y----------------------------y-------------------------------------------------------------y------#----y-----------y-----y-----------y---------------------#---
XXXXXXXX----------------XXXXXXXXXXXXXXXXXXXXXXXXXXXXXXXXXXXXXXXXXXXXXXX----------XXXXXXXXXXXXXXXXX----------------------XXXXXXXXXXXXXXXXXXXXXXXXXXXXXXXXXXXXXXXXXX--XXXXXXXXXXXXXXXXXXXXXXXXXXXXXXXXXXXXXXX----XXXXXXXXXXXXXXX
XXXXXXXX----------------XXXXXXXXXXXXXXXXXXXXXXXXXXXXXXXXXXXXXXXXXXXXXXX----------XXXXXXXXXXXXXXXXX----------------------XXXXXXXXXXXXXXXXXXXXXXXXXXXXXXXXXXXXXXXXXX--XXXXXXXXXXXXXXXXXXXXXXXXXXXXXXXXXXXXXXX----XXXXXXXXXXXXXXX
