---------------------------------------------------------------------------------------------------------------------------------------------------------------------
---------------------------------------------------------------------------------------------------------------------------------------------------------------------
---------------------------------------------------------------------------------------------------------------------------------------------------------------------
---------------------------------------------------------------------------------------------------------------------------------------------------------------------
---SSS---------------------------------------------------------------------------------------SSSS--------------------------------------------SSS---------------------
---------------------------------------------------------------------------------------------------------------------------------------------------------------------
----------------------------------------------------------------------------------------------------------------------------------------------------------%%%%-------
-----------------------------------------------------------------------------SS----------------------------------------------------------------------------||--------
-----------------------------------------------------------------------------------------------------------------------------------------------------------||--------
-----------------------------------------------------------------------------------------------------------------------------------------------------------||--------
------------------------------------------------------%%%%%%------%%%%%%-----------------------------------------------------------------------------------||--------
-------------------------------------------------------||||--------||||------------------------------------------------ooooooo-----------------------------||--------
-------------------------------------------------------||||--------||||---------------------------------------------SSSS-----------------------------------||------F-
-M-------------------------------------------SSS-------||||--------||||-------------SSS------------------------------------------------SSS-----SSS---------||------X-
XXXXXXXX--%%%%--------------%%%%-----------------------||||--------||||---------------------------------------------------SSSS-----------------------------||-XXXXXXX
XXXXXXXX---||----------------||------------------------||||--------||||------------------------------------------------------------------------------------||-XXXXXXX
