-------------------------------------------------------------------------------------------------------------------------------------------------------------------------------------------------------------------------------------------------------------------------------------------------------------------------------------------------------------------------------------
-------------------------------------------------------------------------------------------------------------------------------------------------------------------------------------------------------------------------------------------------------------------------------------------------------------------------------------------------------------------------------------
-------------------------------------------------------------------------------------------------------------------------------------------------------------------------------------------------------------------------------------------------------------------------------------------------------------------------------------------------------------------------------------
---------------------------------------------------------------------------------------------------------------------------------------------------------------------------------------------------------oo----------------------------------oo--------------------------------------------------------------------------------------------------------o-----------------------------
-------------------------------------------------------------------------------------------------------------------------------------------------------------------------------------------------------------------------------------------------------------------------------------------------------------------------------------------------------------------------------------
---------------------------------------------------------------------------------------------------------------------------------------------------------------------------------------------------------------------------------------------------------------------------------------------#--------------------------------------------------------------------oo-----------------
---------------------------------------------------------------------------------------------------oo---------------------------------------------------------------------------------------------------------------------------------------------------------------------------------------##---------------------------------------------------------------------------------------
--------------------------------------------------------------------------------------------------------------------------------------------------------------------------------------------------------------------------------------------------------------------------------------------##---------------------------------------------------------------------------------------
---------------------------------------------------------------------------------------------------------------------oo-------------------------------------------------------------------------------------------------------------------------------------------------------------------#-##---------------------------------------------------------------------------------------
-----------------------------------------------------------------------------------------------------------------------------------------------------------------------------------------------------------------------------------##------------------------------------------o----------#-##-------------------------------------------------------------------o-------------------
-------------------------------------------------------------------------------------------------------------TT-------------------------------------------------------------------------------------------------------------------###---------------------------------------------------#-#-##---------------------------------------------------------------------------------------
-------------------------------------------------------------------------------TT----------------------------TT------------------------------------------------------------------------------------------------------------------####---------------------------------------------------#-#-##---------------------------------------------------------------------------------------
------#--------#-----------------------------------------#---------------------TT----------------------------TT---------------------------------------------------------------------TT------------------------------------------#####----------#---------------------------------TT---#-#-#-##-----------------------------------------------------------------------------------F---
-M----#--------#-----------------------ggg---------------#---------------------TT----------------------------TT---------------k------------k----------------------------------------TT---------------------------------------gg######--------kk#---------------------------------TT---#-#-#-##-----------------------------------------------------------------------------------#---
XXXXXXXXXXXXXXXXXXXXXXXXX-----------XXXXXXXXXXXXXXXX-XXXXXXXXXXXXXXXX-X-XXXXXXXXXXXXXXXX-XXXXXXXXXXX-XXXXXXXXXXXXXXXXX-----XXXXXX-X-XXXXXXXXXXXXXXXX-----------------------------XXXXXXXXXX-----------------------------XXXXXXXXXXXXXXXXXXXXXXXXXXXXXXXXXXXXX-XXXXXXXX--------XXXXXXX-X-X-X-XXXXXXXX-----------------------------------------------------------X------XX---XXXXXXXXXX
XXXXXXXXXXXXXXXXXXXXXXXXX-----------XXXXXXXXXXXXXXXX-XXXXXXXXXXXXXXXX-X-XXXXXXXXXXXXXXXX-XXXXXXXXXXX-XXXXXXXXXXXXXXXXX-----XXXXXX-X-XXXXXXXXXXXXXXXX-----------------------------XXXXXXXXXX-----------------------------XXXXXXXXXXXXXXXXXXXXXXXXXXXXXXXXXXXXX-XXXXXXXX--------XXXXXXX-X-X-X-XXXXXXXX-----------------------------------------------------------X------XX---XXXXXXXXXX
