--------------------------------------------------------------------------------------------------------------------------------------------------------------
--------------------------------------------------------------------------------------------------------------------------------------------------------------
--------------------------------------------------------------------------------------------------------------------------------------------------------------
------------------------SSS------------SSS------------------SSS---SSS---SSS------SSS---------SSSSSS------------SSSSSSSSSSSSSSSSSSSSSSSSSSSSSSSSS--------------
------------------------------------------------------------------------------------------------------------------SS--SSSSSS--SSSS------SSSS------------------
------------------------------------------------------------------------------------------------------------------SS--SSSSSS--SSSS---g--SSSS------------------
---------SSS------SSSSSS---SSS---------------------------------------SSS------SSS------SSS---------SSSSSSSSS----SS--------SS---S----SS----------------SSS-----
----------------------------------------------------------------------------------------------------------------SS--------SS---S----SS------------------------
----------------------------------------------------------------------------------------------------------------SS--------SS---S----SS------------------------
S-----------------------------------SSSSSS------------------------SSS---SSSSSS----------------------------------SS----ooooSS---SoU--SC--g-g-------------------
S---------------------------------------------------------------------------------------------------------------SSSS--SSSSSS---SSS--SS--SSSS------------------
S----------------------------------------------------------SS----------------------------------SS-----------------SS------------------------------------------
S----------------------------------------------------------SS----------------------------------SS-----------------SS------------------------------------------
S--M--------------------------------------------g-g--------SS--------------------g-g-----------SS-----------------------k--g-g------------------------------F-
XXXXXXXXXXXXXXXXXXXXXXXXXXXXXXXXXXXXXXXXXX--XXXXXXXXXXXXX--XX--XXXXXX--XXXXXXXXXXXXXXXXXXXXXX--XX--XXXXXXXXXXXXXXXXXXXXXXXXXXXXXXXXXXXXXXXXX---XXXXXXXXXX--XXX
XXXXXXXXXXXXXXXXXXXXXXXXXXXXXXXXXXXXXXXXXX--XXXXXXXXXXXXX--XX--XXXXXX--XXXXXXXXXXXXXXXXXXXXXX--XX--XXXXXXXXXXXXXXXXXXXXXXXXXXXXXXXXXXXXXXXXX---XXXXXXXXXX--XXX
