--------------------------------------------------------------------------------------------------------------------------------------------------------------
--------------------------------------------------------------------------------------------------------------------------------------------------------------
--------------------------------------------------------------------------------------------------------------------------------------------------------------
---SSS---SSS---SSS---------SSS---------------------------SSSSSS------------SSSSSS------------------------SSS---------SSS---SSS------------SSS---------SSS-----
--------------------------------------------------------------------------------------------------------------------------------------------------------------
--------------------------------------------------------------------------------------------------------------------------------------------------------------
------------------------------------------------------SSS---------------------------------------------SSS------SSS---------------------SSS---------SSS--------
--------------------------------------------------------------------------------------------------------------------------------------------------------------
--------------------------------------------------------------------------------------------------------------------------------------------------------------
S-----------------SSS-------------------SSSSS---SSS---------------------SSSSSS---------------------------SSS------------SSS-------SSSSS---SSSSSSSSS---SSS-----
S-----------------------------g##------------------------------g##--------------------------------------------------------------------------------------------
S-----------------------------###------------------------------###--------------------------------------------------------------------------------------------
S---------------------------g####--SSS-----------------------g####--SSS-------SSS---------SSS---SSSSSS---------SSSSSSSSS-----SSS------------------------------
S--M------------------------#####---------r------------------#####------------------------------------------------SS----------------r-----------------------F-
XXXXXXXXX--XXXX--XXXXXXXXXXXXXXXX-------XXXXXXXXXXXXXX--XXXXXXXXXX------------------------------------------------SS--------------XXXXXXXXXXXXXXXXXXXXXXX--XXX
XXXXXXXXX--XXXX--XXXXXXXXXXXXXXXX-------XXXXXXXXXXXXXX--XXXXXXXXXX----------------------------------------------------------------XXXXXXXXXXXXXXXXXXXXXXX--XXX
