----------------------------------------------------------------------------------------------------------------------------------------------------------------------------------------------------------
----------------------------------------------------------------------------------------------------------------------------------------------------------------------------------------------------------
----------------------------------------------------------------------------------------------------------------------------------------------------------------------------------------------------------
------------------------SSS------------------------------------------------------------------------------------------------------------------------------SS-----------------------------------------------
------------------------------------------------------------------------------------------------------------------------------------------------SSS-------------------------------------------------------
------------------------------------------------------------------------------------------------------------------#---------%%%%%-------------------------------------------------------------------------
-----------------------------S----------------------------------------------------------------------------------###----------|||----------------------------SSS-------------------------------------------
----------------------------------------------------------------------------------------------------------------###----------|||--------------------------------------------------------------------------
-------------------------------------------------------------------------------SSS------------------------------###----------|||--------------------------------------------------------------------------
------------SSS-------------------------------------------------------------------------------------------------###----------|||----------------------SS--------------------------------------------------
-----------------------------------------------SS---------------------------------------------------------------###----------|||-------------------------------------------------------------------SSS----
------------------------------------------------------------------------------------------------%%%-------------###----------|||--------------------------------------------------------------------------
-------------------------------------------------------------------------------------------------||---------------#----------|||----------------------------------------------------------------------F---
---M---------------------------------------------------------------------------------------------||----------k----#----------|||----------------------------------------------------------------------#---
XXXXXXXXXX-----------XXX------XXX---XXXXXX---------------------XXX-------SSS--------------XXX----||---XXXXXXXXXXXXXXX--------|||----%%%------XXX-----------%%%%------%%%---------------------------XXXXXXX
XXXXXXXXXX-----------XXX------XXX---XXXXXX---------------------XXX------------------------XXX----||---XXXXXXXXXXXXXXX--------|||----||-------XXX------------|||------||----------------------------XXXXXXX
