-----------------------------------------------------------------------------------------------------------------------------------------------------------------------------------------------------
-----------------------------------------------------------------------------------------------------------------------------------------------------------------------------------------------------
-----------------------------------------------------------------------------------------------------------------------------------------------------------------------------------------------------
-----------------------------------------------------------------------------------------------------------------------------------------------------------------------------------------------------
-----------------------------------------------------------------------------------------------------------------------------------------------------------------------------------------------------
-----------------------------------------------------------------------------------------------------------------------------------------------------------------------------------------------------
---------------?-------------------------C-----------------------------------------------------------------------------------------------------------------------------------------C-----------------
---------------------------------------------------------------------------------------------------------------------------XX------------------------------------------------------------------------
---------------------------------------------------------------------------------------------------------------------------XX------------------------------------------------------------------------
---------------------------------------------------?-----------------------------------------------------------------------XX------------------------------------------------------------------------
-------------C---------SUS--------------SS---------------------------------------------------------------------------------XX-----------------------------------------------------SS-----------------
---------------------------------------------------------------------------------------------------------------------------XX-----------------------------------------------------------TT-----------
-------------------------------------------------------------------------------------------------------------SSSSS---------XX-------------------------------------------?---------------TT-------F---
--M-----k---gg---------------------gg----k----k-----------------------------------------k----------------------------------XX-----k------------------------------------------------k----TT-------X---
XXXXXXXXXXXXXXXXXXXXXXXXXXXXXXXXXXXXXXXXXXXXXXXX------------------------------------XXXXXX------------------------------XXXXXXXXXXXX------------------------------------------XXXXXXXXXXXXXXXXXXXXXXX
XXXXXXXXXXXXXXXXXXXXXXXXXXXXXXXXXXXXXXXXXXXXXXXX------------------------------------XXXXXX------------------------------XXXXXXXXXXXX------------------------------------------XXXXXXXXXXXXXXXXXXXXXXX
