--------------------------------------------------------------------------------------------------------------------------------------------------------------------------------
--------------------------------------------------------------------------------------------------------------------------------------------------------------------------------
--------------------------------------------------------------------------------------------------------------------------------------------------------------------------------
--------------------USS----------------------------------------------------------------------------------------------------------U----------------------------------------------
--------------------------------------------------------------------------------------------------------------------------------------------------------------------------------
------------------------------------------------------------------------------------------k-------------------------------------------------------------------------------------
------------------------------------------------------------------------------------------##------------------------------------------------------------------------------------
-----------------------------------------------------------------------------------------###---------------------------------------SS-------------------------------------------
---------------------B-----------------------------------------B------------------------####--------------------------------------------#---------------------------------------
---------------------b-----------------------------------------b-----------------------#####-------------------------------------------##---------------------------------------
-------------------SS#CS-------------------------------------SS#CS--------------------######------------------------------------------###---------------------------------------
----------------------------------------B--------------------------------------------#######---------------------K------TT-----------####---------------------------------------
------B----------------K-B----B---------b----------B-------------K-B----------------########-----B-----------------B----TT----------#####----TT----------TT-------TT--------F---
-M----b------------------b----b---------B----------b---------------b---------------#########-----b-----------------b----TT---------######----TT----------TT-------TT--------#---
XXXXXXXXXXXXXXXXXXXXXXXXXXXXXXXXXXXXXXXXXXXXXXXXXXXXXXXXXXXXXXXXXXXXXXXXXXXXXXXXXX-XXXXXXXXXXXXXXXXXXXXXXXXXXXXXXXXXXXXXXXXXXXXXXX-XXXXXXXXXXXXXXXXXXX--XXXXXXXXXXXXXXXXXXXXXXXX
XXXXXXXXXXXXXXXXXXXXXXXXXXXXXXXXXXXXXXXXXXXXXXXXXXXXXXXXXXXXXXXXXXXXXXXXXXXXXXXXXX-XXXXXXXXXXXXXXXXXXXXXXXXXXXXXXXXXXXXXXXXXXXXXXX-XXXXXXXXXXXXXXXXXXX--XXXXXXXXXXXXXXXXXXXXXXXX
