------------------------------------------------------------------------------------------------------------------------------------------------------------------------------------------------------
------------------------------------------------------------------------------------------------------------------------------------------------------------------------------------------------------
------------------------------------------------------------------------------------------------------------------------------------------------------------------------------------------------------
------------------------------------------------------------------------------------------------------------------------------------------------------------------------------------------------------
------------------------------------------------------------------------------------------------------------------------------------------------------------------------------------------------------
------------------------------------------------------------------------------------------------------------------------------------------------------------------------------------------------------
-------------------------------------------------------------------------------------------------------------------------------SUS--------------------------------------------------------------------
------------------------------------------------------------------------------------------------------------------------------------------------------------------------------------------------------
----------------------------------------------------------------------------------------------------------------------------------------------------------------------TT------------------------------
----------------------------------------------------------------------------------------------------------------------------------------------------------------------TT------------------------------
------------------------------------------------------------------------------------------------------------------------------#####-----------------------------------##------------------------------
------------------------------------------------------------------------------------------------------------------------------#--------------------TT-----TT------------------------------------------
-----------------------------------------------------------------------------------------------------------------------------K#--------------------TT-----TT--------------------------------------F---
-M----------------------------------------------------------------------------------------------------------------------------#------------------kkTT-----TT--------------------------------------#---
XXXXXX---------------XXX------------------------------------XXXXXX---------------------------------------------------XXXXXXXXXXXX---XXXXXX---XXXXXXXXXXX--XXXXXXXX---XXX---XXX---XXX------XXXXXXXXXXXX
XXXXXX---------------XXX------------------------------------XXXXXX---------------------------------------------------XXXXXXXXXXXX---XXXXXX---XXXXXXXXXXX--XXXXXXXX---XXX---XXX---XXX------XXXXXXXXXXXX
