--------------------------------------------------------------------------------------------------------------------------------------------------------------------------------
--------------------------------------------------------------------------------------------------------------------------------------------------------------------------------
--------------------------------------------------------------------------------------------------------------------------------------------------------------------------------
--------------------------------------------------------------------------------------------------------------------------------------------------------------------------------
--------------------------------------------------------------------------------------------------------------------------------------------------------------------------------
------------------------------------------------------------------------------------------------------------------------------------------------------------k-------------------
------------------------------------------------------------------------------------------------------------------------------------------------------------##------------------
-----------------------------------------------------------------------------------------------------------------------------------------------------------###------------------
------------------------B---------------------------------------------------------------------------------------------------------------------------------####------------------
------------------------b---------------SS---------------------------------------------------------------------------------------------------------------#####------------------
----------------------SS#CS-----------------------------------------------------------------------------------------------------------------------------######------------------
------------TT-----------------------------------------------------------------------------------------------------------------------------------------#######------------------
------------TT-----TT-----K-B-------------------------------------------------TT-------------------TT------------------B---------TT----TT----B--------########-----B--------F---
-M----------TT-----TT-------b-------------------------------------------------TT-------------------TT------------------b---------TT----TT----b-------#########-----b--------#---
XXXXXXXXXXXXXXXXXXXXXXXXXXXXXXXXXXXXXXXXXXXXXXXXXXXXXXXXXXXXXXXXXXXXXXXXXXXXXXXXXXXXXXXXXXXXXXXXXXXXXXXXXXXXXXXXXXXXXXXXXXXXXXXXXXXXXXXXXXXXXXXXXXXX-XXXXXXXXXXXXXXXXXXXXXXXXXXX
XXXXXXXXXXXXXXXXXXXXXXXXXXXXXXXXXXXXXXXXXXXXXXXXXXXXXXXXXXXXXXXXXXXXXXXXXXXXXXXXXXXXXXXXXXXXXXXXXXXXXXXXXXXXXXXXXXXXXXXXXXXXXXXXXXXXXXXXXXXXXXXXXXXX-XXXXXXXXXXXXXXXXXXXXXXXXXXX
