--------------------------------------------------------------------------------------------------------------------------------------------------------------
--------------------------------------------------------------------------------------------------------------------------------------------------------------
--------------------------------------------------------------------------------------------------------------------------------------------------------------
---------SSS---------SSS---------------SSS------SSSSSSSSS---------SSSSSS---------------------SSS------------------------------SSS---------------SSS-----------
---------------------------------------------------SS---------------------------------------------------------------------------------------------------------
---------------------------------------------------SS---------------------------------------------------------------------------------------------------------
---SSS---------SSS------SSS---------SSS---SSS------------SSS------------SSS---------------SSS---SSS------------------------------------SSS---------SSS--------
--------------------------------------------------------------------------------------------------------------------------------------------------------------
--------------------------------------------------------------------------------------------------------------------------------------------------------------
S--------------------SSS---------------------SSS------SSS-------SSSSSSSS------------------------------SSS------------------SSS--------------------------------
S-----------g##-----------------------------------------------------------------------------------------------------------------------------------------------
S-----------###--------------------------------------------------------------------SS-------------------------------------------------------------------------
S---------g####--SSS----SSS---SSS---------------SSSSSS-----SSS---------------------SS----------------------------------------------g-#-#----------------------
S--M------#####---------------------------------------------------r----------------SS---------------------------------------------g#-#-#--------------------F-
XXXXXXXXXXXXXXX-------------------------------------------------XXXXXXXXXXXXXXXXX--XX--XXXXXX--XXXX--XXXXXXXXXX--XXXXXXXXXXXXXXXXXXXXXXXXXXXXXXXXXXXXXXXX--XXX
XXXXXXXXXXXXXXX-------------------------------------------------XXXXXXXXXXXXXXXXX--XX--XXXXXX--XXXX--XXXXXXXXXX--XXXXXXXXXXXXXXXXXXXXXXXXXXXXXXXXXXXXXXXX--XXX
