------------------------------------------------------------------------------------------------------------------------------------------------------------------------------------------------------------------------------
------------------------------------------------------------------------------------------------------------------------------------------------------------------------------------------------------------------------------
------------------------------------------------------------------------------------------------------------------------------------------------------------------------------------------------------------------------------
------------------------------------------------------------------------------------------------------------------------------------------------------------------------------------------------------------------------------
----------------------oooo----------------------------------------------------------------------------------------------------------------------------------------------------------------------------------------------------
-------------------------------------------y----------------------------------------------------------------------------------------------------------------------------------------------------------------------------------
-------------------------------------------##---------------------------------------------------------------------------------------------------------------------------------------------------------Q-Q---------------------
-----------------------------------------y###---------------------------------------------------------------------------------------------------------------------------------------------------------------------------------
-----------------------------------------####-------------------------------------------------------------------------------------------------------------------------------------y-------------------------------------------
----------------------------------------#####-------------------------------------------------------------------------------------------------------------------------------------##------------------------------------------
----------------------TT---------------######---------------------C--------------------------------------------------------------------------------------------------------------###------------------Q-Q---------------------
----------------------TT--------------#######-----------------------------------------------------------------------------------------------------------------------------------####------------------------------------------
----------------------TT-------------########----------------------------------------------------------------------------------------------------------------------------------#####--------------------------------------F---
-M--------------y--y--TT------------#########----y--y--------y---------------------y-------y--------------------------------------------y--y--y-------------------------------######----------y---------------------------#---
XXXXXXXXXXXXXXXXXXXXXXXXXXXXXXXXXXXXXXXXXXXXXXXXXXXXXXXXXXXXXXXXXXXXXXXXXXXXXXXXXXXXXXXXXXXXXXXXXXXXXXXXXXXXXXXXXXXXXXXXXXXXXXXXXXXXXXXXXXXXXXXXXXXXXXXXXX--XXXXX----------XXXXXXXXXXXXXXXXXXXXXXXXXXXXXXXX----------XXXXXXXXX
XXXXXXXXXXXXXXXXXXXXXXXXXXXXXXXXXXXXXXXXXXXXXXXXXXXXXXXXXXXXXXXXXXXXXXXXXXXXXXXXXXXXXXXXXXXXXXXXXXXXXXXXXXXXXXXXXXXXXXXXXXXXXXXXXXXXXXXXXXXXXXXXXXXXXXXXXX--XXXXX----------XXXXXXXXXXXXXXXXXXXXXXXXXXXXXXXX----------XXXXXXXXX
