----------------------------------------------------------------------------------------------------------------------------------------------------------------------------------------
----------------------------------------------------------------------------------------------------------------------------------------------------------------------------------------
----------------------------------------------------------------------------------------------------------------------------------------------------------------------------------------
----------------------------------------------------------------------------------------------------------------------------------------------------------------------------------------
----------------------------------------------------------------------------------------------------------------------------------------------------------------------------------------
---------------------------------------------------oo-----------------------------------------------------------------------------------------------------------------------------------
------------------------------------------------------------------------------------------------------------y---------------------------------------------------------------------------
----------------------------------------------------------------------------------------------------------#SSS--------------------------------------------------------------------------
---------------------------------------------------------------------------------------------------------##----------------------------------------------------oo-----------------------
--------------##-------------------------------y--------------------------------------------------------###1--------------------------------------------ooo---------------##------------
-------------###-------------------------------##-------------------------------------------------------###--------------------------------------------------------------###------------
------------####------------------------------###-----------------------------------------------------#-###--SSS-------------------------------------TT-----------------####------------
------------####-----------------------------####----------------------------------------------------##-###------------------------------------------TT-----------------####--------F---
----M------#####----------------------------#####-------------------y-----------------------------------###---------y--y-----y--------------------y--TT----------------#####--------#---
XXXXXXXXXXXXXXXX---XXXXXX--XXXXXXXXXXXXXXXXXXXXXX---XXXXXXXXXXXXXXXXXXXXX--XXXXXXXXXXXXXXXXXXX--XXXXXXXXXXXXXX---XXXXXXXXXXXXXXXXX--XXXXXXXXXXXXXXXXXXXXXXXXXXXXXXXXXXXXXXXX---XXXXXXXXX
XXXXXXXXXXXXXXXX---XXXXXX--XXXXXXXXXXXXXXXXXXXXXX---XXXXXXXXXXXXXXXXXXXXX--XXXXXXXXXXXXXXXXXXX--XXXXXXXXXXXXXX---XXXXXXXXXXXXXXXXX--XXXXXXXXXXXXXXXXXXXXXXXXXXXXXXXXXXXXXXXX---XXXXXXXXX
