-----------------------------------------------------------------------------------------------------------------------------------------------------------------------------------------------------
-----------------------------------------------------------------------------------------------------------------------------------------------------------------------------------------------------
-----------------------------------------------------------------------------------------------------------------------------------------------------------------------------------------------------
-----------------------------------------------------------------------------------------------------------------------------------------------------------------------------------------------------
-----------------------------------------------------------------------------------------------------------------------------------------------------------------------------------------------------
-----------------------------------------------------------------------------------------------------------------------------------------------------------------------------------------------------
----------------------QQQQQ-------------------------------------------------------------------------------------------------------SSSSS----------SSSS------------------------------------------------
---------------------------------------------------------------------------------------------------------------------------------------------------------------------XX------------------------------
-----------------------------------------------------------------------------------------------------g---------------------------------------------------------------XX------------------------------
------------------------k----------------------------------------------------------------------------#---------------------------------------------------------------XX------------------------------
----------------------?QQQQ-------------------------------------------------------------------------##---------------------------------------------------------------XX------------------------------
---------------------------------------------------------------------------------------------------###---------------------------------------------------------------XX------------------------------
--------------------------------------------------------------------------------------------------####---------------------------------------------------------------XX--------------------------F---
--M----k--------------------k--------------------------------------------------------------------#####----k----------------------------------------------------------XX-----k--------------------X---
XXXXXXXXX------------XXXXXXXXX---------------------------------------------------------------XXXXXXXXXXXXXXX------------------------------------------------------XXXXXXXXXXXX---------------XXXXXXXX
XXXXXXXXX------------XXXXXXXXX---------------------------------------------------------------XXXXXXXXXXXXXXX------------------------------------------------------XXXXXXXXXXXX---------------XXXXXXXX
