-----------------------------------------------------------------------------------------------------------------------------------------------------------------------------------------------------
-----------------------------------------------------------------------------------------------------------------------------------------------------------------------------------------------------
-----------------------------------------------------------------------------------------------------------------------------------------------------------------------------------------------------
------------------------------------------------------------------------------------------------------------------------------------------------------------?----------------------------------------
-----------------------------------------------------------------------------------------------------------------------------------------------------------------------------------------------------
-----------------------------------------------------------------------------------------------------------------------------------------------------------------------------------------------------
--------------------------------C----SSSS-------------LSSS------------------------------------------------------SSSSS---------------------------?----------------------------------------------------
------------------------------------------------XX---------------------------------------------------------------------------------------------------------------------------------------------------
------------------------------------------------XX---------------------------------------------------------------------------------------------------------------------------------------------------
------------------------------------------------XX---------------------------------------------------------------------------------------------------------------------------------------------------
-------------------------------SS---------------XX----2--------TT--------TT-------------------------------------------------------------TT---TT--------------------TT------#-------------------------
------------------------------------------------XX-------------TT--------TT-------------------------------------------------------------TT---TT--------------------TT------#-------------------------
------------------------------------------------XX-------------TT--------TT-------------------------------------------------------------TT---TT--------------------TT------##--------------------F---
--M----k------------------------k----k----------XX-----kk------TT--------TT----k--------------------------------------------------------TT---TT--------------------TT------##---gg------k--------X---
XXXXXXXXX------------------XXXXXXXXXXXX------XXXXXXXXXXXXXXXXXXXXX---XXXXXXXXXXXX---------------------------------------------------XXXXXXXXXXXX---------------XXXXXXXXXXXXXXXXXXXXXXXXXXX---XXXXXXXX
XXXXXXXXX------------------XXXXXXXXXXXX------XXXXXXXXXXXXXXXXXXXXX---XXXXXXXXXXXX---------------------------------------------------XXXXXXXXXXXX---------------XXXXXXXXXXXXXXXXXXXXXXXXXXX---XXXXXXXX
