----------------------------------------------------------------------------------------------------------------------------------------------------------------------------------------------------
----------------------------------------------------------------------------------------------------------------------------------------------------------------------------------------------------
----------------------------------------------------------------------------------------------------------------------------------------------------------------------------------------------------
----------------------------------------------------------------------------------------------------------------------------------------------------------------------------------------------------
----------------------------------------------------------------------------------------------------------------------------------------------------------------------------------------------------
----------------------------------------------------------------------k-----------------------------------------------------------------------------------------------------------------------------
---------------------------------------------------------------------##-----------------------------------------------------------------------------------------------------------------------------
--------------------------------------------------------------------###-----------------------------------------------------------------------------------------------------------------------------
------------------------------------------------------#-----------k####-----------------------------------------------------------------------------------------------------------------------------
------------------------------------------------------#-----------#####---------------------------------------------------SSS-----------------------------------------------------------------------
------------------------------------------------------#----------######-----------------------------------------------------------------------------------------------------------------------------
-----------------------------------------------------##---------#######-----------------------------------------------------------------------------------------------------------------------------
---------------------------------------TT-----------###--------########-------------------------------TT----------------------------------------TT-----------------------------------------------F--
-M---------------gg--------------------TT----------####-------#########------------gg-----------------TT----------------------------------------TT------------------------------------gg----k----#--
XXXXXXXXXXXXXXXXXXXXXXXXXXXX----XXXXXXXXXXXXXXXXXXXXXXX---XXXXXXXXXXXXXXXXXXXXXXXXXXXXXXXXXXXXXXXXXXXXXXXXXXXXXXXXXXXXXXX----XXXXX----XXXXXXXXXXXXXXXXXXXXXXX----XXXXXXXXXXXXXXXXXXXXXXXXXXXXXXXXXXX
XXXXXXXXXXXXXXXXXXXXXXXXXXXX----XXXXXXXXXXXXXXXXXXXXXXX---XXXXXXXXXXXXXXXXXXXXXXXXXXXXXXXXXXXXXXXXXXXXXXXXXXXXXXXXXXXXXXX----XXXXX----XXXXXXXXXXXXXXXXXXXXXXX----XXXXXXXXXXXXXXXXXXXXXXXXXXXXXXXXXXX
