------------------------------------------------------------------------------------------------------------------------------------------------------
------------------------------------------------------------------------------------------------------------------------------------------------------
------------------------------------------------------------------------------------------------------------------------------------------------------
---------------------------------------------SS-------------------------------------------------------------------------------------------------------
---------------------------------------------------%%%%-----------------------------------------------------------------------------------------------
----------------------------------------------------||------------------------------------------------------------------------------------------------
----------------------------------------------------||------------------------------------------------------------------------------------------------
----------------------------------------------------||---------------------------------------oo-------------------------------------------------------
----------------------------------------------------||------------------------------------------------------------------------------------------------
----------------------------------------------------||---------------------------%%%%%-------------------------------------------%%%%%----------------
----------------------------------------------------||---------------%%%%---------|||---------------------------------------------|||-----------------
----------------------------------------------------||----------------||----------|||---------------------------------------------|||-----------------
----------------------------------------------------||----------------||----------|||---------------------------------------------|||--------------F--
-M-----------------------------------------%%%%-----||----------------||----------|||---------------------------------------------|||--------------#--
XXXXXXXXXXXXXXXXXXXXXXXXXXXXXXXXXXXXXXXXX---||------||----------------||----------|||---------------------------------------------|||---------XXXXXXXX
XXXXXXXXXXXXXXXXXXXXXXXXXXXXXXXXXXXXXXXXX---||------||----------------||----------|||---------------------------------------------|||---------XXXXXXXX
