----------------------------------------------------------------------------------------------------------------------------------------------------------------------------------------------------------
----------------------------------------------------------------------------------------------------------------------------------------------------------------------------------------------------------
----------------------------------------------------------------------------------------------------------------------------------------------------------------------------------------------------------
------------------------------------------------------------SSS---------------------------------%%%%--------------o---------------------------------------------------------------------------------------
-------------------------------------------------------------------------------------------------||-------------------------------------------------------------------------------------------------------
----------k--------------------------------------------------------------------------------------||-------------------------------------------------------------------------------------------------------
---SSS---SSS-------------------------------------------------------------------------------------||-----------------------------------------------------------------------------------------------S-------
-------------------------------------------------------------------------------------------------||----------------SS-------------------------------------------TT------SSS-------------------------------
-------------------------------------------------------------------------------------------------||-------------------------------------------------------------TT----------------------------------------
---------------------------------------------------------------------------SSS-------------------||------------------------------------------------o------------TT----------------------------------------
-------------------------------------------------------------------------------------------------||------------------------------------------------------------SXXS---------------------------------------
-------------------------------------------------------------------------------------------------||--------------------------------------SS---------------------------------------------------------------
--------------o----------------------------------------------------------------------------------||---------------SSS------------------------SSS------------------------------------------------------F---
---M---------------------------------------------------------------------------------------------||---------------------------------------------------------------------------------------------------#---
XXXXXXXXX------------------------------------XXXXXX---XXX---------------------XXX----------------||---------XXX-----------%%%%-----------------------X------XXXXXX---%%%---XXX---------------------XXXXXXX
XXXXXXXXX------------------------------------XXXXXX---XXX---------------------XXX----------------||---------XXX------------|||-----------------------X------XXXXXX----||---XXX---------------------XXXXXXX
