----------------------------------------------------------------------------------------------------------------------------------------------------------------------------------------
----------------------------------------------------------------------------------------------------------------------------------------------------------------------------------------
----------------------------------------------------------------------------------------------------------------------------------------------------------------------------------------
----------------------------------------------------------------------------------------------------------------------------------------------------------------------------------------
----------------------------------------------------------------------------------------------------------------------------------------------------------------------------------------
----------------------------------------------------------------------------------------------------------------------------------------------------------------------------------------
-------------------------------------------------------------------------------------------------------------------------------------------###------------------------------###---------
-----------------------------------y-------------------------------------------------------------------------------------------------------###------------------------------###---------
---------------------------------#SS--o-------------------------------------------------------------------------------------------------y--###---------------------------y--###---------
--------------------------------##-------------------------------------------------------------------------------------------ooo--------#--###---------------------------#--###---------
-------------------------------###--SC-------------------------------------------------------------------------------------------------##--###---------------ooo--------##--###---------
------------------------------####----------------------------------------------------------------------------------------TT---------y###--###------------------------y###--###---------
------------------------------####---SSS----------------------------------------------------------------------------------TT-------y-####--###----------------------y-####--###-----F---
----M------------------------#####----------------y--------y-----------------------------------y--------------------y--y--TT------#######--###----------y--y-------#######--###-----#---
XXXXXXXXXXXXXXXXXXXXXXXXXXXXXXXXXX------XXXXXXXXXXXXXXXXXXXXXXXXXXXXXXXXXXXX---XXXXXXXXXXXXXXXXXXXXXXXXXXXXXXXXXXXXXXXXXXXXXXXXXXXXXXXXXX--XXXXXXXXXXXXXXXXXXXXXXXXXXXXXXX--XXXXXXXXXXXX
XXXXXXXXXXXXXXXXXXXXXXXXXXXXXXXXXX------XXXXXXXXXXXXXXXXXXXXXXXXXXXXXXXXXXXX---XXXXXXXXXXXXXXXXXXXXXXXXXXXXXXXXXXXXXXXXXXXXXXXXXXXXXXXXXX--XXXXXXXXXXXXXXXXXXXXXXXXXXXXXXX--XXXXXXXXXXXX
