------------------------------------------------------------------------------------------------------------------------------------------------------
------------------------------------------------------------------------------------------------------------------------------------------------------
------------------------------------------------------------------------------------------------------------------------------------------------------
---------------------------------------------------------------------------------------------------------------------------------------SS-------------
--------------------------------SS--------------------------------------------------------------------------------------------------------------------
-------------------------------------------------------oo--oo------------------------------------------------------oo--oo-----------------------------
------------------SS--------------------------------------------------------------R-------------------------------------------------------------------
------------------------------------------------------------------------------------------------------------------------------------------------------
---------------------------------------------------------------------------%%%%%----------------------------------------------------------------------
---------------------------------------------------------------------------||||-----------------------------------------------------------------------
---------------------------------------------------------------------------||||-----------------------------------------------------------------------
---------------------------------------------------------------------------||||-----------------------------------------------------------------------
---------------------------------------------------------------------------||||---------------------------------R----SS----------------------------F--
-M-----------------------------------------%%%%----------------------------||||--------------------------------------------------------------------#--
XXXXXXXXXXXXXXXXXXXXXXXXXXXXXXXXXXXXXXXXX---||-----------------------SSS---||||--------------------------%%%%%--------------------------------XXXXXXXX
XXXXXXXXXXXXXXXXXXXXXXXXXXXXXXXXXXXXXXXXX---||-----------------------------||||---------------------------|||---------------------------------XXXXXXXX
