-------------------------------------------------------------------------------------------------------------------------------------------------------------------------------------------
-------------------------------------------------------------------------------------------------------------------------------------------------------------------------------------------
-------------------------------------------------------------------------------------------------------------------------------------------------------------------------------------------
------------SSS------SSS---------------SSS---------------------------SSSSSS------------------------------------SSS---SSS------------SSS---------------------------------SSS------SSSSSS----
-------------------------------------------------------------------------------------------------------------------------------------------------------------------------------------------
-------------------------------------------------------------------------------------------------------------------------------------------------------------------------------------------
-----------------------------------SSSS------SSS------------SSS-----------------------------------------SSSS------------SSS------SSS---------------SSS-----SSSS---SSSSSS-------------------
------------------------------------------------------------------------------------------------------------------------------------------------------------------------------------TT-----
------------------------------------------------------------------------------------------------------------------------------------------------------------------------------------TT-----
S--------------SSSSSS---SSS---------------SSS------------------------------------------------------SSS------SSS------------SSS---------------------------------SSS------------------TT-----
S-----------------------------------------------------------------------------------------------------------------------------------------------------------------------------------TT----F
S------------------------------SSS---------------------------------------------------------------------------------------------------------------------SSS--------------------------TT---SS
S-----------------------------------SSSSSS---SSS---------------------------------SSS---SSS------SSS---------------SSS------------------SSSSSS---------------SSS------SSS------------TT---SS
S-M---------------------------------------------------------------------------------------------------------------------------------------------------------------------------------TT---SS
XXXXXXXXX------------XXX---XXX---------------------XXXXXX------------XXX---------------------------------------------------------XXX----------XXXXX------------------------------XXXXXX--XX
XXXXXXXXX------------XXX---XXX---------------------XXXXXX------------XXX---------------------------------------------------------XXX----------XXXXX------------------------------XXXXXX--XX
