-----------------------------------------------------------------------------------------------------------------------------------------------------------------------------------------------------
-----------------------------------------------------------------------------------------------------------------------------------------------------------------------------------------------------
-----------------------------------------------------------------------------------------------------------------------------------------------------------------------------------------------------
----------------------------------------------------------------------------------------------------------------------------------------------------------------SSSS---------------------------------
-----------------------------------------------------------------------------------------------------------------------------------------------------------------------------------------------------
-----------------------------------------------------------------------------------------------------------------------------------------------------------------------------------------------------
----------------------QQQQQ------------------------------------------------------------------------------------------LSSS----------------------------------------------------------------------------
-----------------------------------------------------------------------------------------------------------------------------------------------------------------------------------------------------
-----------------------------------------------------------------------------------------------------------------------------------------------------------------------------------------------------
------------------------k---------SSSSS--------------------------------------------------------------------------------------------------------------------------------------------------------------
----------------------?QQQQ---------------------------------------------------------------------TT---------SUS-------2-------------------------------------------------------------------------------
------------------------------------------------------------------------------------------------TT-------------------------------------------------------------------#-------------------------------
-------------SSSS-------------------------------------------------------------------------------TT---------------------------------------------------------------K---#---------------------------F---
--M----k--------------------k--------------------------------k----------------------------------TT--------------------kk----k----------------------------------------#------k--------------------X---
XXXXXXXXX------------XXXXXXXXX---------------------------XXXXXX------------------------------XXXXXX------XXXXXXXXXXXXXXXXXXXXX------------------------------XXXXXXX--XXXXXXXXX---------------XXXXXXXX
XXXXXXXXX------------XXXXXXXXX---------------------------XXXXXX------------------------------XXXXXX------XXXXXXXXXXXXXXXXXXXXX------------------------------XXXXXXX--XXXXXXXXX---------------XXXXXXXX
