--------------------------------------------------------------------------------------------------------------------------------------------------------------------------------
--------------------------------------------------------------------------------------------------------------------------------------------------------------------------------
--------------------------------------------------------------------------------------------------------------------------------------------------------------------------------
---------------------------------------------------------U----------------------------------------------------------------------------------------------------------------------
--------------------------------------------------------------------------------------------------------------------------------------------------------------------------------
--------------------------------------------------------------------------------------------------------------------------------------------------------------------------------
-------------------------SSSSS-----USS------------------------------------------------------------------------------------------------------------------------------------------
-----------------------------------------------------------SS-------------------------------------------------------------------------------------------------------------------
---------------k------------------------------------------------#-------------------k-------------------------------------------------------------------------------------------
---------------##---------K------------------------------------##-------------------##------------------------------------------------------------------------------------------
--------------###--------SSSSS--------------------------------###------------------###------------------------------------------------------------------------------------------
-------------####-----------K---#---B------------------------####-----------------####-------------------------------------------------------------------B----------------------
------------#####-----TT--------#---b-----------------------#####--------B-------#####-----------------B----------------------------B-----------TT-------b-----------TT-----F---
-M---------######-----TT--------#---B----------------------######--------b------######-----------------b----------------------------b-----------TT-------B-----------TT-----#---
XXXXXXXXXX-XXXXXXXXXXXXXXXXXXXXXXXXXXXXXXXXXXXXXXXXXXXXXXX-XXXXXXXXXXXXXXXXXXXX-XXXXXXXXXXXXXXXXXXXXXXXXXXXXXXXXXXXXXXXXXXXXXXXXXXXXXXXXXXXXXXXXXXXXXXXXXXXXXXXXXXXXXXXXXXXXXXXX
XXXXXXXXXX-XXXXXXXXXXXXXXXXXXXXXXXXXXXXXXXXXXXXXXXXXXXXXXX-XXXXXXXXXXXXXXXXXXXX-XXXXXXXXXXXXXXXXXXXXXXXXXXXXXXXXXXXXXXXXXXXXXXXXXXXXXXXXXXXXXXXXXXXXXXXXXXXXXXXXXXXXXXXXXXXXXXXX
