--------------------------------------------------------------------------------------------------------------------------------------------------------------
--------------------------------------------------------------------------------------------------------------------------------------------------------------
--------------------------------------------------------------------------------------------------------------------------------------------------------------
---SSS---------SSS------SSS------------SSSSSS---------SSSSSS------------SSSSSS------------------SSS---------------------SSS---------SSS---------------SSS-----
--------------------------------------------------------------------------------------------------------------------------------------------------------------
--------------------------------------------------------------------------------------------------------------------------------------------------------------
------------------SSS---------------SSS------------SSS---------------------------------------SSS---SSS------------SSSSSS-----------------------SSS------------
--------------------------------------------------------------------------------------------------------------------------------------------------------------
--------------------------------------------------------------------------------------------------------------------------------------------------------------
S-----SSS------------------------SSS------------SSS------SSS---SSS---------SSS---SSS---SSSSSS---------------------------------------------------------SSS-----
S-------------------------------------------------------------------------------------------------------------------------------------------------------------
S-------------------------------------------------------------------------------------------------------------------------------------------------------------
S-------------------------------------------------------------------------------------------------------------------------------------------------------------
S--M-----------------------------------------g-g------------------g-g------------------------g-g------------------------------------------------------------F-
XXXXXXXXXXXX--XXXXXXXXXXXXXXXXXXXXXXXXXXXXXXXXXXXXXXXXXXXXXXXXXXXXXXXXXX--XXXXXXXXXXXXXXXXXXXXXXXXXXXXXXXXXX--XXXXXXXXXXXXXXXXXXXXXX--XXXXXXXXXXXXXXXXXXX--XXX
XXXXXXXXXXXX--XXXXXXXXXXXXXXXXXXXXXXXXXXXXXXXXXXXXXXXXXXXXXXXXXXXXXXXXXX--XXXXXXXXXXXXXXXXXXXXXXXXXXXXXXXXXX--XXXXXXXXXXXXXXXXXXXXXX--XXXXXXXXXXXXXXXXXXX--XXX
