------------------------------------------------------------------------------------------------------------------------------------------------------
------------------------------------------------------------------------------------------------------------------------------------------------------
------------------------------------------------------------------------------------------------------------------------------------------------------
------------------------------------------------------------------------------------------------------------------------------------------------------
------------------------------------------------------------------------------------------------%%%%--------------------------------------------------
-------------------------------------------------------------------------------------------------||---------------------------------------------------
-------------------------------------------------------------------------------------------------||---------------------------------------------------
-------------------------------------------------------------------------------------------------||---------------------------------------------------
-------------------------------------------------------------------------------------------------||----oo--oo-----------------------------------------
-------------------------------------------------------------------------------------------------||---------------------------------------------------
-------------------------------------------------------------------------------------------------||---------------oo----------------------------------
-------------------------------------------------------------------------------------------------||---------------------------------------------------
-------------------------------------------------------------------------------------------------||------------------------------------------------F--
-M-----------------------------------------------------------%%%%--------------------------------||------------------------------------------------#--
XXXXXXXXXXXXXXXXXXXXXXXXXXXXXXXXXXXXXXXXXXXXXXXXXXXXXXXXXXX---||---------------------------------||-------------------------------------------XXXXXXXX
XXXXXXXXXXXXXXXXXXXXXXXXXXXXXXXXXXXXXXXXXXXXXXXXXXXXXXXXXXX---||---------------------------------||-------------------------------------------XXXXXXXX
