-----------------------------------------------------------------------------------------------------------------------------------------------------------------------------------------------------
-----------------------------------------------------------------------------------------------------------------------------------------------------------------------------------------------------
-----------------------------------------------------------------------------------------------------------------------------------------------------------------------------------------------------
-----------------------------------------------------------------------------------------------------------------------------------------------------------------------------------------------------
-----------------------------------------------------------------------------------------------------------------------------------------------------------------------------------------------------
-----------------------------------------------------------------------------------------------------------------------------------------------------------------------------------------------------
------------------------------------------------------?--------------?---------------------------------------------SSSSS-------------SSSSS----------QQQQQ--------------------------------------------
-----------------------------------------------------------------------------------------------------------------------------------------------------------------------------------------------------
-----------------------------------------------------------------------------------------------------------------------------------------------------------------------------------------------------
------------------------------------------------------------------------------------------------------------------------------------------------------k----------------------------------------------
--------------------------------------------------------------------------------------------------------SUS-----------------------------------------?QQQQ--------------------------------------------
----------TT------------------------#-----------------------------------------------#----------------------------------------------------------------------------------------------------------------
----------TT--------------------K---#-------------------------------------------K---#------------------------------------------------------------------------------------------------------------F---
--M-------TT-----------gg-----------#------k----------------------------------------#------k-----------------k--------------------------------------------k--------------------------------------X---
XXXXXXXXXXXXXXXXXXXXXXXXXXXXXXXXXX--XXXXXXXXX------------------------------XXXXXXX--XXXXXXXXX---------XXXXXXXXX------------------------------------XXXXXXXXX---------------------------------XXXXXXXX
XXXXXXXXXXXXXXXXXXXXXXXXXXXXXXXXXX--XXXXXXXXX------------------------------XXXXXXX--XXXXXXXXX---------XXXXXXXXX------------------------------------XXXXXXXXX---------------------------------XXXXXXXX
