-----------------------------------------------------------------------------------------------------------------------------------------------------------------------------------------------------
-----------------------------------------------------------------------------------------------------------------------------------------------------------------------------------------------------
-----------------------------------------------------------------------------------------------------------------------------------------------------------------------------------------------------
-----------------------------------------------------------------------------------------------------------------------------------------------------------------------------------------------------
------------------------------------------------------------------------------------------------------------------------------------XX---------------------------------------------------------------
------------------------------------------------------------------------------------------------------------------------------------XX---------------------------------------------------------------
-------------------------------------------------------------------------SSSSS----------SSSSS---------------------------------------XX---------------------------------------------------------------
------------------------------------------------------------------------------------------------------------------------------------XX---------------------------------------------------------------
--------------------------------------------------------------------------------------------------g---------------------------------XX---------------------------------------------------------------
--------------------------------------------------------------------------------------------------#---------------------------------XX---------------------------------------------------------------
-------------------------------------------------------------------------------------------------##---#-----------------------------XX---------------------------------------------------------------
-------------------------------------------------TT---------------------------------------------###---#-----------------------------XX---------------------------------------------------------------
-------------------------------------------------TT----------------------------SSSSS-----------####---##----------------------------XX-----------------------------------------------------------F---
--M----k-----------------------------------------TT----k--------------------------------------#####---##---gg------k----------------XX-----k-----------------------------------------------------X---
XXXXXXXXX------------------------------------XXXXXXXXXXXX------------------------------XXXXXXXXXXXXXXXXXXXXXXXXXXXXXX------------XXXXXXXXXXXX------------------------------------------------XXXXXXXX
XXXXXXXXX------------------------------------XXXXXXXXXXXX------------------------------XXXXXXXXXXXXXXXXXXXXXXXXXXXXXX------------XXXXXXXXXXXX------------------------------------------------XXXXXXXX
