-----------------------------------------------------------------------------------------------------------------------------------------------------------------------------------------------------
-----------------------------------------------------------------------------------------------------------------------------------------------------------------------------------------------------
-----------------------------------------------------------------------------------------------------------------------------------------------------------------------------------------------------
-------------------------------------SSSS-------------------------------------------------------------------?----------------------------------------------------------------------------------------
-----------------------------------------------------------------------------------------------------------------------------------------------------------------------------------------------------
-----------------------------------------------------------------------------------------------------------------------------------------------------------------------------------------------------
-----------------------------SSCSS-------------------------------------------C---------------------------?--------------?------QQQQQ----------------------------SSSSS--------------------------------
-----------------------------------------------------------------------------------------------------------------------------------------------------------------------------------------------------
-----------------------------------------------------------------------------------------------------------------------------------------------------------------------------------------------------
----------------------------------------------------------------------------------------------------------------SSSS-------------k-------------------------------------------------------------------
---------------------------QQQQ--QQQ----------------------------Q-----------SS-------------------------------------------------?QQQQ----------------Q------------------------------------------------
-----------------------------------------------------------------------------------------------------------------------------------------------------------------------------------------------------
----------------------------------------------SSSS-----------------------------------------------------------------------------------------------------------------------------------------------F---
--M----k-----------------------------k-------------------------K-K-----------k----k--------------------------------------------------k-------------K-K----k--------------------------------------X---
XXXXXXXXX------------------XXXXXXXXXXXX---------------------XXXXXXXXXXXXXXXXXXXXXXXX------------------------------------------XXXXXXXXX------XXXXXXXXXXXXXXX---------------------------------XXXXXXXX
XXXXXXXXX------------------XXXXXXXXXXXX---------------------XXXXXXXXXXXXXXXXXXXXXXXX------------------------------------------XXXXXXXXX------XXXXXXXXXXXXXXX---------------------------------XXXXXXXX
