-------------------------------------------------------------------------------------------------------------------------------------------------------------------------------------------
-------------------------------------------------------------------------------------------------------------------------------------------------------------------------------------------
-------------------------------------------------------------------------------------------------------------------------------------------------------------------------------------------
---------SSS------SSS---SSS------------SSSSSS---SSS-----------SSSS------------------------SSS---------SSSSSS---SSSSSS---------------SSS---------------SSS------SSS---SSSSSS---SSS---SSSSS--
-------------------------------------------------------------------------------------------------------------------------------------------------------------------------------------------
-------------------------------------------------------------------------------------------------------------------------------------------------------------------------------------------
---SSSSSS---------------------SSS------------------------SSS------------------------SSS------------------------------SSS------------------------SSS------SSS-------------------------------
------------------------------------------------------------------------------------------------------------------------------------------------------------------------------------TT-----
------------------------------------------------------------------------------------------------------------------------------------------------------------------------------------TT-----
S--------------SSS------------------SSS------------SSS-----------SSSS---------SSS---------------------SSS---------------------------------SSS------------------------SSS------------TT-----
S-----------------------------------------------------------------------------------------------------------------------------------------------------------------------------------TT----F
S-----------------------------------------------------------------------------------------------------------------------------------------------------------------------------------TT---SS
S--------------------------------------------------------------------------------SSS---------------------SSSSSS---SSS------------------------SSS---------------SSS------------------TT---SS
S-M---------------------------------------------------------------------------------------------------------------------------------------------------------------------------------TT---SS
XXXXXX--------------X------------XXX------------------XXX----SSS--------XXXXXX---------XXX------------------------------XXX------XXX------------------XXX------------------------XXXXXX--XX
XXXXXX--------------X------------XXX------------------XXX---------------XXXXXX---------XXX------------------------------XXX------XXX------------------XXX------------------------XXXXXX--XX
