------------------------------------------------------------------------------------------------------------------------------------------------------
------------------------------------------------------------------------------------------------------------------------------------------------------
------------------------------------------------------------------------------------------------------------------------------------------------------
---------------------------------------%%%%%-------------------------------------------------------SS-------------------------------------------------
----------------------------------------|||----------------------------------------------------------------------------------------------SS-----------
----------------------------------------|||-----------------------------------------------------------------------------------------------------------
----------------------------------------|||--------------------SS-------------------------------------------------------------------------------------
------------------------oo--------------|||-----------------------------------------------------------%%%%--------------------------------------------
----------------------------------------|||------------------------------------------------------------||---------------------------------------------
----------------------------------------|||-------------------------------------oo--------------SS-----||------------------------%%%%%----------------
----------------------------------------|||-----------------------%%%%---------------g-g---------------||------------oo-----------|||-----------------
----------------------------------------|||------------------------||--------------%%%%%%%-------------||-------------------------|||-----------------
----------------------------------------|||-----------SS-----------||---------------|||||--------------||-------------------------|||--------------F--
-M--------------------%%%%--------------|||------------------------||---------------|||||--------------||-------------------------|||--------------#--
XXXXXXXXXXXXXXXXXXXX---||---------------|||------------------------||---------------|||||--------------||-------------------------|||---------XXXXXXXX
XXXXXXXXXXXXXXXXXXXX---||---------------|||------------------------||---------------|||||--------------||-------------------------|||---------XXXXXXXX
