---------------------------------------------------------------------------------------------------------------------------------------------------------------------
---------------------------------------------------------------------------------------------------------------------------------------------------------------------
---------------------------------------------------------------------------------------------------------------------------------------------------------------------
---------------------------------------------------------------------------------------------------------------------------------------------------------------------
---------------------SSS-----------------------------------------------------SS--------------------------------------------------------------------------------------
---------------------------------------------------------------------------------------------------------------------------------------------------------------------
-------------------------------------------------------------------------------------%%%%----------------------------------------------------------------------------
--------------------------------------------------------------------------------------||-----------------------------------------------------------------------------
--------------------------------------------------------------------------------------||-----------------------------------------------------------------------------
--------------------------------------------------------------------------------------||-----------------------------------------------------------------------------
--------------------------------------------------------------------------------------||-----------------------------------------------------------------------------
-----------------------------------ooooooo--------------------------------------------||-----------------------------------------------------------------------------
--------------------------------SSSS--------------------------------------------------||---------------------------------------------------------------------------F-
-M------------------------------------------------------------------------------------||---------------------------------------------------------------------------X-
XXXXXXXX--%%%%------------------------SSSS--------------------------------------------||-XXXXXXXXXXXXXXXXXXXXXXXXXXXXXXXXXXXXXXXXXXXXXXXXXXXXXXXXXXXXXXXXXXXXXXXXXXXX
XXXXXXXX---||-------------------------------------------------------------------------||-XXXXXXXXXXXXXXXXXXXXXXXXXXXXXXXXXXXXXXXXXXXXXXXXXXXXXXXXXXXXXXXXXXXXXXXXXXXX
