----------------------------------------------------------------------------------------------------------------------------------------------------------------------------------------------------------------------
----------------------------------------------------------------------------------------------------------------------------------------------------------------------------------------------------------------------
----------------------------------------------------------------------------------------------------------------------------------------------------------------------------------------------------------------------
------------------------------------------------------------------------------------------------------------SSS---------------------------------------------------SSS-------------------------------------------------
----------------------------------------------------------------------------------------------------------------------------------------------------------------------------------------------------------------------
----------------------------------------------------------------------------------------------------------------------------------------------------------------------------------------------------------------------
------------------------------------------------------------------------------------------------------------------------------------SSS--------------S--------------------------S--------------------------------S----
---------------------------------------------------------------------------------------------------------------------------TT--------------------------------------------------------------------------------TT-------
----------------------TT---------------------------------------------------------------------------------------------------TT--------------------------------------------------------------------------------TT-------
----------------------TT---------------------------------------------------------------------------------------------------TT--------------------------------------------------------------------------------TT-------
-----SSS--------------TT--------------------------------------------SSS----------------------------------------------------XX-------------------------------------------------------------------------------SXXS------
----------------------TT----------------------------------------------------------------------------------------------------------------------------------------------------------------------------------------------
---------------tt-----TT---tt----TT-------TTTT----------TT-----TT----------------------TTT---TT--------------------------------------TT--------TT-----TT--TT------TTTT------------------TT----TT----------TT-------F--
---M-----------tt-----TT---tt----TT-------TTTT----------TT-----TT----------------------TTT---TT--------------------------------------TT--------TT-----TT--TT------TTTT------------------TT----TT----------TT-------#--
XXXXXXXXXXXXXXXXXXXXXXXXXXXXXXXXXXXXXXXXXXXXXXXXXXXXXXXXXXXXXXXXXXXXXXXXXXXXXXXXXXXXXXXXXXXXXXXXXXXXXXXXXXXXXXXXXXXXXXXXXXXXXXXXXXXXXXXXXXXXXXXXXXXXXXXXXXXXXXXXXXXXXXXXXXXXXXXXXXXXXXXXXXXXXXXXXXXXXXXXXXXXXXXXXXXXXX
XXXXXXXXXXXXXXXXXXXXXXXXXXXXXXXXXXXXXXXXXXXXXXXXXXXXXXXXXXXXXXXXXXXXXXXXXXXXXXXXXXXXXXXXXXXXXXXXXXXXXXXXXXXXXXXXXXXXXXXXXXXXXXXXXXXXXXXXXXXXXXXXXXXXXXXXXXXXXXXXXXXXXXXXXXXXXXXXXXXXXXXXXXXXXXXXXXXXXXXXXXXXXXXXXXXXXX
