-------------------------------------------------------------------------------------------------------------------------------------------------------------------------------------------------------------------------------------------------------------------------------------------------------------------------------------------------------------------------------------
-------------------------------------------------------------------------------------------------------------------------------------------------------------------------------------------------------------------------------------------------------------------------------------------------------------------------------------------------------------------------------------
-------------------------------------------------------------------------------------------------------------------------------------------------------------------------------------------------------------------------------------------------------------------------------------------------------------------------------------------------------------------------------------
-------------------------------------------------------------------------------------------------------------------------------------------------------------------------------------o-----------------------------------------------------------------------------------------------------------------------------------------------------------------------------------------------
-------------------------------------------------------------------------------------------------------------------------------------------------------------------------------------------------------------------------------------------------------------------------------------------------------------------------------------------------------------------------------------
-------------------------------------------------------------------------------------------------------------------------------------------------------------------------------------------------------------------------------------------------------------------------------------------------------------------------------------------------------------------------------------
---------------------------------------------------------------------------------------------------------------------------------------------------------------------------------------------------------------------------------------------oo----------------------------------------------oo--------------------------------------------------------------------------------------
-------------------------------------------------------------------------------------------------------------------------------------------------------------------------------------------------------------------------------------------------------------------------------------------------------------------------------------------------------------------------------------
-------------------------------------------------------------------------------------------------------------------------------------------------------------------------------------------------------------------------------------------------------------------------------------------------------------------------------------------------------------------------------------
------------------------------------------------------------------------------------------------------------------------------------------------------------------------------------------------------------------------------------------------oo----------------------------------------------------------------------------o----------------------------------------##------------
----------------------------------------------------------------------------------------------------------------------------------------------------------------------------------------------------------------------------------TT----------------------------------------------------------------------------------------------------------------------------------###------------
-------TT-------------------------------------------------------------------------------------TT----------------------------------------------------------------------------------------------------------------------------------TT---------------------------------------------------------------------------------oo----------------------------------------------####------------
-------TT------------TT------------#---TT----------#--------------------------#---------------TT------TT-------------------------#------------------------------------------------------------------------------------------------TT--------------------------------------------------------------------------------------------------------------------------------#####--------F---
-M-----TT------ggg---TT------------#---TT----------#--------------------------#------ggg------TT-----kTT----------------k--------#------------------------------------------------------------------------------------------------TT------------------------------------------------------------------------------------------------------ggg--------------------gg######--------#---
XXXXXXXXXXXXXXXXXXXXXXXXXXXXXXXXXXXXXXXXXXXXXXXXXXXXXXXXXX-XXXXX-XXXXXXXXXXXXXXXXXXXXXXXXXXXXXXXXXXXXXXXXXXXX-XXXXXXXXXXXXXXXXXXXXXXXXXXXXX-XXXXXXXXXXXXXXXXXXX-X-XXXX-----------------------------------------XXXXXXXXXXXXXXXXXXXXXXXXX--------------------------------------------------------------------------------------XXXXXX-X-XXXXXXXXXXXXXXXX-XXXXXXXXXXXXXXXXXXXXXXXXXXXXX
XXXXXXXXXXXXXXXXXXXXXXXXXXXXXXXXXXXXXXXXXXXXXXXXXXXXXXXXXX-XXXXX-XXXXXXXXXXXXXXXXXXXXXXXXXXXXXXXXXXXXXXXXXXXX-XXXXXXXXXXXXXXXXXXXXXXXXXXXXX-XXXXXXXXXXXXXXXXXXX-X-XXXX-----------------------------------------XXXXXXXXXXXXXXXXXXXXXXXXX--------------------------------------------------------------------------------------XXXXXX-X-XXXXXXXXXXXXXXXX-XXXXXXXXXXXXXXXXXXXXXXXXXXXXX
