----------------------------------------------------------------------------------------------------------------------------------------------------------------------------------------------------
----------------------------------------------------------------------------------------------------------------------------------------------------------------------------------------------------
----------------------------------------------------------------------------------------------------------------------------------------------------------------------------------------------------
----------------------------------------------------------------------------------------------------------------------------------------------------------------------------------------------------
----------------------------------------------------------------------------------------------------------------------------------------------------------------------------------------------------
-------------------------------------------------------------------------------------------k--------------------------------------------------------------------------------------------------------
------------------------------------------------------------------------------------------##------SSQSSS?SSS--------------------SSC-----------------------------------------------------------------
-----------------------------------------------------------------------------------------###--------------------------------------------------------------------------------------------------------
----------------------------------------------------g#---------------------#-----------k####--------------------------------------------------------------------------------------------------------
---------------------------------------------------g##---------------------#-----------#####--------K---------------------------SSS-----------------------------------------------------------------
---------------------------------------------------###---------------------#----------######------SSSSSSSSSSS---------------------------------------------------------------------------------------
--------------------------------------------------####--------------------##---------#######--------------------------------------------------------------------------------------------------------
-------------------------------------------------#####-------------------###--------########-----------------------------------------------------------------------------------------------------F--
-M------------------------gg----k-----gg--------######------------------####-------#########------------------------------------------------------------gg---------------------------------------#--
XXXXXXXXXXXXXXXXXXXXXXXXXXXXXXXXXXXXXXXXXXXXXXXXXXXXXX--XXXXXXXX----XXXXXXXX---XXXXXXXXXXXXXXXXXXXXXXXXXXXXXXXXX----XXXXXXXXXXX----XXXXXXXXXXX----XXXXXXXXXXXXXXXXXXXXXXXXXXXXXXXXXXXXXXXXXXXXXXXXXX
XXXXXXXXXXXXXXXXXXXXXXXXXXXXXXXXXXXXXXXXXXXXXXXXXXXXXX--XXXXXXXX----XXXXXXXX---XXXXXXXXXXXXXXXXXXXXXXXXXXXXXXXXX----XXXXXXXXXXX----XXXXXXXXXXX----XXXXXXXXXXXXXXXXXXXXXXXXXXXXXXXXXXXXXXXXXXXXXXXXXX
