------------------------------------------------------------------------------------------------------------------------------------------------------------------------------------------------------------------------------
------------------------------------------------------------------------------------------------------------------------------------------------------------------------------------------------------------------------------
------------------------------------------------------------------------------------------------------------------------------------------------------------------------------------------------------------------------------
------------------------------------------------------------------------------------------------------------------------------------------------------------------------------------------------------------------------------
------------------------------------------------------------------------------------------------------------------------------------------------------------------------------------------------------------------------------
-------------y----------------------------------------------------------------------------------------------------------------------------------------------------------------------------------------------------------------
-------------##---------------------------------------------------------------------------------------------------------------------------------------------------------------------------------------------------------------
-----------y###-----------------------------------------------------oooo-----------------------------------------------------------------oooo---------------------------------------------------------------------------------
-----------####---------------------------------------------------------------------------------------------------------------------------------------------------------------------------------------------------------------
----------#####---------------------------------------------------------------------------------------------------------------------------------------------------------------------------------------------------------------
---------######---------------------------------------------------------------------------------------------------------------------------------------------------------------------------------------------------------------
--------#######---------------------------------------------------#-------------------------------------#------------------------------#--------------------------------------------------------------------------------------
-------########---------------------------------------------------#-------------------------------------#---------------TT-------------#----------------------------------------------------------------------------------F---
-M----#########-------y-------------------------------------------#------------------y------------------#----y-----y----TT--------y----#---------------y------------------------------------------------------------------#---
XXXXXXXXXXXXXXXXXXXXXXXXXXXXXXXX-------------------------------XXXXXXXXXXXXXXXXXXXXXXXXXXXXXXXXXXXXXXXXXX--XXXXXXXXXXXXXXXXXXXXXXXXXXXXXXXXXXXXXXXXXXXXXXXXXXX----------------------------------------------------XXXXXXXXXXXX
XXXXXXXXXXXXXXXXXXXXXXXXXXXXXXXX-------------------------------XXXXXXXXXXXXXXXXXXXXXXXXXXXXXXXXXXXXXXXXXX--XXXXXXXXXXXXXXXXXXXXXXXXXXXXXXXXXXXXXXXXXXXXXXXXXXX----------------------------------------------------XXXXXXXXXXXX
