-------------------------------------------------------------------------------------------------------------------------------------------------------------------------------------------
-------------------------------------------------------------------------------------------------------------------------------------------------------------------------------------------
-------------------------------------------------------------------------------------------------------------------------------------------------------------------------------------------
------SSSSSS------SSS--------SSSS---------SSS------SSS---SSS------------------------SSSSSSSSSSSSSSS---SSS---SSS------------SSS---------SSS---------SSS------------------------------SSS----
-------------------------------------------------------------------------------------------------------------------------------------------------------------------------------------------
-------------------------------------------------------------------------------------------------------------------------------------------------------------------------------------------
---------------------------------------SSS---------------------SSS---------------------------------------SSS------------SSS-----SSSS------------------------SSS----------------------------
------------------------------------------------------------------------------------------------------------------------------------------------------------------------------------TT-----
------------------------------------------------------------------------------------------------------------------------------------------------------------------------------------TT-----
S-----SSSSSS---SSS------------------SSS---------SSS---------SSS---------------------------SSS--------SSSS------------------------------------------SSS---------------------SSS------TT-----
S------------------------------------------------------------------------------------TT--------------------------------------------------TT-----------------------------------------TT----F
S--------------------------------------------------------------------------------TT--TT-----------------------------------------------#--TT--##-------------------------------------TT---SS
S----------------------------------------------------SSSSS----------------tt-----TT--TT----------------------------------------------##--TT--##-SSS---SSS---------------------------TT---SS
S-M-----------------------------------------------------------------------tt----kTT--TT-------------------------------------------kk-##--TT--##-------------------------------------TT---SS
XXXXXX------------XXX---XXX------------------XXX------------------------XXXXXXXXXXXXXXX--X-------SSS-----XXX---XXX------XXXXXXXXXXXXXXX--XX--XX-------------XXX------XXX---------XXXXXX--XX
XXXXXX------------XXX---XXX------------------XXX------------------------XXXXXXXXXXXXXXX--X---------------XXX---XXX------XXXXXXXXXXXXXXX--XX--XX-------------XXX------XXX---------XXXXXX--XX
