----------------------------------------------------------------------------------------------------------------------------------------------------------------------------------------------------------
----------------------------------------------------------------------------------------------------------------------------------------------------------------------------------------------------------
----------------------------------------------------------------------------------------------------------------------------------------------------------------------------------------------------------
------------------------------------------------------------------------SSS------------------------------------------------------SS-------------------------------------------------SSSSSSSS--------------
----------------------------------------------------------------------------------------------------------------------------------------------------------------------------------------------------------
----------------------------oo------------------------------------oo---------------------------------------------------%%%%--------------%%%%-------------------------------------------------------------
---------------------SCS-------------------------------------------------------------------------------------------------||----------------||--------------------------------------------------S----------
-------------------------------------------------------------------------------------------------------------------------||----------------||-------------------------------------------------------------
---------------------------------------------------------------------%%%----------------------------------------%%%%%----||----------------||-------------------------------------------------------------
------------SSS-------------------------------------------------------||-----------------------------------------|||-----||---------oo-----||-------------------------------------------------------------
----------------------2---------------%%%%------------------SS!S------||-----------------------------------------|||-----||----------------||-------------------------------------------------------------
---------------------------------------||-----------------------------||-----------------------------------------|||-----||----------------||----------------SSS------------------------------------------
---------------------------------------||-----------------------------||---------------------------------SSS-----|||-----||----------------||---SSSSSS----------------------------------SS---SSS------F---
---M-----------------------------------||-----------------------------||-----------------------------------------|||-----||----------------||---------------------------------------------------------#---
XXXXXXXXX-------XX---XXX----oo---XXX---||-------------------XXX-------||---XXX---------------------XXX-----------|||-----||----------------||------------XXX------------XXX------------------------XXXXXXX
XXXXXXXXX-------XX---XXX---------XXX---||-------------------XXX-------||---XXX---------------------XXX-----------|||-----||----------------||------------XXX------------XXX------------------------XXXXXXX
