--------------------------------------------------------------------------------------------------------------------------------------------------------------------------------
--------------------------------------------------------------------------------------------------------------------------------------------------------------------------------
--------------------------------------------------------------------------------------------------------------------------------------------------------------------------------
------------------------------------------------------------------------------------------------------------------------------------------------U-------------------------------
--------------------------------------------------------------------------------------------------------------------------------------------------------------------------------
--------------------------------------------------------------------------------------------K---------------------------------------------------------------------k-------------
----------------------------------------------------------------------------------------SSSSSS----1----------------------------SSSSS------------------------------##------------
--------------------------------------------------------------------------------------------------------------------------------------------------SS-------------###------------
-------------------------------------------------------------------------------------------------------------------------------------------------------#--------####------------
-----------------------------------------------------------------------------------------K--------------------------------------K-------------SS------##-------#####------------
---------------------------------------------------------------------------------------SSSSSSS---------------------------------SSSSS-----------------###------######------------
---------------------------------------------------------------------------------TT---------------TT------------------------------K---#----B--------####-----#######------------
-------------------------------------B-----TT----------------------------B-------TT---------------TT----------------------------------#----b-------#####----########--------F---
-M-----------------------------------b-----TT----------------------------b-------TT---------------TT----------------------------------#----B------######---#########--------#---
XXXXXXXXXXXXXXXXXXXXXXXXXXXXXXXXXXXXXXXXXXXXXXXXXXXXXXXXXXXXXXXXXXXXXXXXXXXXXX--XXXXXXXXXXXXXXXXXXXXXXXXXXXXXXXXXXXXXXXXXXXXXXXXXXXXXXXXXXXXXXXXX-XXXXXXXXXXXXXXXXXXXXXXXXXXXXXX
XXXXXXXXXXXXXXXXXXXXXXXXXXXXXXXXXXXXXXXXXXXXXXXXXXXXXXXXXXXXXXXXXXXXXXXXXXXXXX--XXXXXXXXXXXXXXXXXXXXXXXXXXXXXXXXXXXXXXXXXXXXXXXXXXXXXXXXXXXXXXXXX-XXXXXXXXXXXXXXXXXXXXXXXXXXXXXX
