------------------------------------------------------------------------------------------------------------------------------------------------------------------------------------------------------
------------------------------------------------------------------------------------------------------------------------------------------------------------------------------------------------------
------------------------------------------------------------------------------------------------------------------------------------------------------------------------------------------------------
------------------------------------------------------------------------------------------------------------------------------------------------------------------------------------------------------
------------------------------------------------------------------------------------------------------------------------------------------------------------------------------------------------------
------------------------------------------------------------------------------------------------------------------------------------------------------------------------------------------------------
----------------------------------------------------------------------##------------------------------------------------------------------------------------------------------------------------------
----------------------------------------------------------------------##------------------------------------------------------------------------------------------------------------------------------
-------------------------------------TT-------------------------------##------------------------------------------------------------------------------------------------------------------------------
-------------------------------------TT------------------------K---#--##------------------------------------------------------------------------------------------------------------------------------
----------------------------#LSS-----##---------------------------##--##------------------------------------------------------------------------------------------------------------------------------
----------------------------#------------------------------------###--##---------------------------------------------#--------------------------------------------------------------------------------
----------------------------#-----------*---TT-----*------------####--------------------------------------------*----#----------------------------------------------------------------------------F---
-M--------k---ggg---------kk#-----------*---TT-----*-----K-----#####-----------ggg-------------ggg-------ggg----*----#----ggg--------ggg---------ggg---------ggg-------------ggg-------ggg--------#---
XXXXXXXXXXXXXXXXXXXXXXXXXXXXXXXXX---XXXXXXXXXXXXXXXXXXXXXXXXXXXXXXXXXXXXXXXXXXXXXXXXXXXXXXXXXXXXXXXXXXXXXXXXXXXXXXX--XXXXXXXXXXXXXXXXXXXXXXXXXXXXXXXXXXXXXXXXXXXXXXXXXXXXXXXXXXXXXXXXXXXXXXXXXXXXXXXXX
XXXXXXXXXXXXXXXXXXXXXXXXXXXXXXXXX---XXXXXXXXXXXXXXXXXXXXXXXXXXXXXXXXXXXXXXXXXXXXXXXXXXXXXXXXXXXXXXXXXXXXXXXXXXXXXXX--XXXXXXXXXXXXXXXXXXXXXXXXXXXXXXXXXXXXXXXXXXXXXXXXXXXXXXXXXXXXXXXXXXXXXXXXXXXXXXXXX
