------------------------------------------------------------------------------------------------------------------------------------------------------------------------------------------------------------------------------
------------------------------------------------------------------------------------------------------------------------------------------------------------------------------------------------------------------------------
------------------------------------------------------------------------------------------------------------------------------------------------------------------------------------------------------------------------------
------------------------------------------------------------------------------------------------------------------------------------------------------------------------------------------------------------------------------
------------------------------------------------------------------------------------------------------------------------------------------------------------------------------------------------------------------------------
----------------------------------------------------------------------------------------------------------------------y-----------------------------------y-------------------------------------------------------------------
------------------------------------------------------------------------------------------------Q---------------------##----------------------------------##------------------------------------------------------------------
--------------------------------------------------------------------------------------------------------------------y###--------------------------------y###------------------------------------------------------------------
--------------------------------------------------------------------------------------------------------------------####--------------------------------####------------------------------------------------------------------
-----------------------------------------------------------------oo------------------------------------------------#####-------------------------------#####------------------------------------------------------------------
----------------------------------------------------------------o--o----------------------------?-----------------######---C--------------------------######---C--------------------------------------------------------------
--------------------------------------------------------------------------------------------TT-------------------#######-----------------------------#######------------------------------------------------------------------
------------------TT------------------------------------------------------------------------TT------------------########----------------------------########--------------------------------------------------------------F---
-M----------------TT------------------------------------------------------------------------TT-----------------#########---------------------------#########-----------------------------y--------------------------------#---
XXXXXXXXXXXXXXXXXXXXXXXXXXXXX----XXXXXXXXXXXXXXXXXXXXXXXXXXXXXXXXXXXXXXXXXXXXXXXXXXXXXXXXXXXXXXXXXXXXXXXXXXXXXXXXXXXXXXXXXXXXXXXXXXXXXXXXXXXXXXXXXXXXXXXXXXXXXXXXXXXXXXXX--XXXXXXXXXXXXXXXXXXXXXXXXXXXXXXXXXXXXXXXXXXXXXXXXXXX
XXXXXXXXXXXXXXXXXXXXXXXXXXXXX----XXXXXXXXXXXXXXXXXXXXXXXXXXXXXXXXXXXXXXXXXXXXXXXXXXXXXXXXXXXXXXXXXXXXXXXXXXXXXXXXXXXXXXXXXXXXXXXXXXXXXXXXXXXXXXXXXXXXXXXXXXXXXXXXXXXXXXXX--XXXXXXXXXXXXXXXXXXXXXXXXXXXXXXXXXXXXXXXXXXXXXXXXXXX
