------------------------------------------------------------------------------------------------------------------------------------------------------------------------------------------------------
------------------------------------------------------------------------------------------------------------------------------------------------------------------------------------------------------
------------------------------------------------------------------------------------------------------------------------------------------------------------------------------------------------------
------------------------------------------------------------------------------------------------------------------------------------------------------------------------------------------------------
------------------------------------------------------------------------------------------------------------------------------------------------------------------------------------------------------
------------------------------------------------------------------------------------------------------------------------------------------------------------------------------------------------------
----------------------------------------------------------------------------------##-------------------------------------------------SUS--------------------------------------------------------------
----------------------------------------------------------------------------------##------------------------------------------------------------------------------------------------------------------
-------------------------------------------------TT-------------------------------##------------------------------------------------------------------------------------------------------------------
-------------------------------------------------TT------------------------K---#--##------------------------------------------------------------------------------------------------------------------
----------------------------------------#LSS-----##---------------------------##--##------------------------------------------------#####-------------------------------------------------------------
----------------------------------------#------------------------------------###--##------------------------------------------------#-----------------------------------------------------------------
----------------------------------------#-----------*---TT-----*------------####---------------------------------------------------K#-------------------------------------------------------------F---
-M--------k---ggg--------ggg----------kk#-----------*---TT-----*-----K-----#####-----------ggg---------ggg---------ggg--------------#--------------ggg-------ggg-------------ggg-------ggg--------#---
XXXXXXXXXXXXXXXXXXXXXXXXXXXXXXXXXXXXXXXXXXXXX---XXXXXXXXXXXXXXXXXXXXXXXXXXXXXXXXXXXXXXXXXXXXXXXXXXXXXXXXXXXXXXXXXXXXXXXXXXXXXXXXXXXXXXX----XXXXXXXXXXXXXXXXXXXXXXXXXXXXXXXXXXXXXXXXXXXXXXXXXXXXXXXXXXX
XXXXXXXXXXXXXXXXXXXXXXXXXXXXXXXXXXXXXXXXXXXXX---XXXXXXXXXXXXXXXXXXXXXXXXXXXXXXXXXXXXXXXXXXXXXXXXXXXXXXXXXXXXXXXXXXXXXXXXXXXXXXXXXXXXXXX----XXXXXXXXXXXXXXXXXXXXXXXXXXXXXXXXXXXXXXXXXXXXXXXXXXXXXXXXXXX
