------------------------------------------------------------------------------------------------------------------------------------------------------------------------------------------------------------------------------
------------------------------------------------------------------------------------------------------------------------------------------------------------------------------------------------------------------------------
------------------------------------------------------------------------------------------------------------------------------------------------------------------------------------------------------------------------------
------------------------------------------------------------------------------------------------------------------------------------------------------------------------------------------------------------------------------
------------------------------------------------------------------------------------------------------------------------------------------------------------------------------------------------------------------------------
----------------------------------------y-----------------------------------------------------------------------------------------------------y-------------------------------------------------------------------------------
----------------------------------------##------------------------------------------------------Q---------------------------------------------##------------------------------------------------------------------------------
--------------------------------------y###--------------------------------------------------------------------------------------------------y###------------------------------------------------------------------------------
--------------------------------------####--------------------------------------------------------------------------------------------------####------------------------------------------------------------------------------
-------------------------------------#####-------------------------------------------------------------------------------------------------#####------------------------------------------------------------------------------
------------------------------------######---C--------------------------------------------------?-----------------------------------------######---C--------------------------------------------------------------------------
-----------------------------------#######--------------------------------#-----------------TT-------------------------------------------#######------------------------------------------------------------------------------
----------------------------------########------TT------------------------#-----------------TT------------------------------------------########--------------------------------------------------------------------------F---
-M---------------y---------------#########------TT------------------------#----y--y---------TT-----------------------------------------#########-----------------------------------------------y--------------------------#---
XXXXXXXXXXXXXXXXXXXXXXXXXXXXXXXXXXXXXXXXXXXXXXXXXXXXXXXXXXX---XXX--XXXXXXXX--XXXXXXXXXXXXXXXXXXXXXXXXXXXXXXXXXXXXXXXXXXXX--XXXXXXXXXXXXXXXXXXXXXXXXXXXXXXXXXXXXXXXXXXXXXXXXXXXXXXXXXXXXXXXXXXXXXXXXXXXX--XXXXXXXXXXXXXXXXXXXXX
XXXXXXXXXXXXXXXXXXXXXXXXXXXXXXXXXXXXXXXXXXXXXXXXXXXXXXXXXXX---XXX--XXXXXXXX--XXXXXXXXXXXXXXXXXXXXXXXXXXXXXXXXXXXXXXXXXXXX--XXXXXXXXXXXXXXXXXXXXXXXXXXXXXXXXXXXXXXXXXXXXXXXXXXXXXXXXXXXXXXXXXXXXXXXXXXXX--XXXXXXXXXXXXXXXXXXXXX
