----------------------------------------------------------------------------------------------------------------------------------------------------------------------------------------------------------
----------------------------------------------------------------------------------------------------------------------------------------------------------------------------------------------------------
----------------------------------------------------------------------------------------------------------------------------------------------------------------------------------------------------------
----------------------------------------------------------------------------------------------------------------------------------------------------------------------------------------------------------
----------------------------------------------------------------------------------------------------------------------------------------------------------------------------------------------------------
----------------------------------------g-----------------------------------------------------------------------------------------------------------------------------------------------------------------
--------------------------------------SSSSSSSS---SSS!--------------@-----------SSS----S!!S--------------------------------------------------------------------##------------------------------------------
-------------------------------------------------------------------------------------------------------------------------------------------------------------###------------------------------------------
-------------------------------------g----------------------------------------------------------------------------------------------------------------------####------------------------------------------
-----------------------------------------------------------------------------------------------------------------------------------------------------------#####------------------------------------------
-----------------------------------S@S--------------C-----SU----!--!--!-----S----------SS------#--#----------##--#----------------------------------------######------------------------------------------
----------------------------------------------------------------------------------------------##--##--------###--##--------------------------------------#######------------------------------------------
---------------------------------------------------------------------------------------------###--###------####--###-----tt--------------------------tt-########--------------------------------------F---
---M-------------------------------------------------g-g--------k-----------------gg-g-g----####--####----#####--####----tt---------------------gg---tt#########--------------------------------------#---
XXXXXXXXXXXXXXXXXXXXXXXXXXXXXXXXXXXXXXXXXXXX---XXXXXXXXXXXXXXXXXXXXXXXXXXXXXXXXXXXXXXXXXXXXXXXXXXXXXXXXXXXXXXXX--XXXXXXXXXXXXXXXXXXXXXXXXXXXXXXXXXXXXXXXXXXXXXXXXXXXXXXXXXXXXXXXXXXXXXX--XXXXXXXXXXXXXXXXX
XXXXXXXXXXXXXXXXXXXXXXXXXXXXXXXXXXXXXXXXXXXX---XXXXXXXXXXXXXXXXXXXXXXXXXXXXXXXXXXXXXXXXXXXXXXXXXXXXXXXXXXXXXXXX--XXXXXXXXXXXXXXXXXXXXXXXXXXXXXXXXXXXXXXXXXXXXXXXXXXXXXXXXXXXXXXXXXXXXXX--XXXXXXXXXXXXXXXXX
