--------------------------------------------------------------------------------------------------------------------------------------------------------------------------------
--------------------------------------------------------------------------------------------------------------------------------------------------------------------------------
--------------------------------------------------------------------------------------------------------------------------------------------------------------------------------
------------------------------------------------------------------------------------------------------------------------------------------------U-------------------------------
--------------------------------------------------------------------------------------------------------------------------------------------------------------------------------
--------------------------------------------------------------------------------------------------K---------------------------------------------------------------k-------------
----------------------------------------------------------------------------------------------SSSSSS----1----------------------SSSSS------------------------------##------------
--------------------------------------------------------------------------------------------------------------------------------------------------SS-------------###------------
-------------------------------------------------------------------------------------------------------------------------------------------------------#--------####------------
-----------------------------------------------------------------------------------------------K--------------------------------K-------------SS------##-------#####------------
---------------------------------------------------------------------------------------------SSSSSSS---------------------------SSSSS-----------------###------######------------
------------------------------------TT-------------------------------------------------TT---------------TT------------------------K---#----B--------####-----#######------------
-------------------------------B----TT----TT-----B-----TT----------------------B-------TT---------------TT----------------------------#----b-------#####----########--------F---
-M-----------------------------b----TT-k--TT-----b-----TT----------------------b-------TT---------------TT----------------------------#----B------######---#########--------#---
XXXXXXXXXXXXXXXXXXXXXXXXXXXXXXXXXXXXXXXXXXXXXXXXXXXXXXXXXXXXXXXXXXXXXXXXXXXXXXXXXXXX--XXXXXXXXXXXXXXXXXXXXXXXXXXXXXXXXXXXXXXXXXXXXXXXXXXXXXXXXXXX-XXXXXXXXXXXXXXXXXXXXXXXXXXXXXX
XXXXXXXXXXXXXXXXXXXXXXXXXXXXXXXXXXXXXXXXXXXXXXXXXXXXXXXXXXXXXXXXXXXXXXXXXXXXXXXXXXXX--XXXXXXXXXXXXXXXXXXXXXXXXXXXXXXXXXXXXXXXXXXXXXXXXXXXXXXXXXXX-XXXXXXXXXXXXXXXXXXXXXXXXXXXXXX
