----------------------------------------------------------------------------------------------------------------------------------------------------------------------------------------
----------------------------------------------------------------------------------------------------------------------------------------------------------------------------------------
----------------------------------------------------------------------------------------------------------------------------------------------------------------------------------------
----------------------------------------------------------------------------------------------------------------------------------------------------------------------------------------
----------------------------------------------------------------------------------------------------------------------------------------------------------------------------------------
----------------------------------------------------------------------------------------------------------------------------------------------------------------------------------------
-----------------------------------------------------------------------------------US------------------------###---------------------###------------------------------------------------
-------------------------------------------------------------------------------------------------------------###---------------------###------------------------------------------------
----------------------------------------------------------------------------------------------------------y--###------------------y--###------------------------------------------------
----------------------------------------------------------------------------------------------------------#--###------------------#--###------------------------------------------------
----------------------------------------------------------------------------------####--SSC--------------##--###-----------------##--###-----------------------------------------QQ-----
-----------------------------------------------------------------------------y-#####-------------------y###--###---------------y###--###------------------------------------------------
--------------------------------------------------------------------------y-######---------------------####--###---------------####--###--------------------------------------------F---
----M---------y-y---------------y-y---------------y-y--------------------#######----------------------#####--###--------------#####--###----------y-y---------------y-y-------------#---
XXXXXXXXXXXXXXXXXXXX--XXXXXXXXXXXXXXXX--XXXXXXXXXXXXXXXX--XXXXXXXXX--XXXXXXXXX------XX--XXXXXXXXX---XXXXXXX--XXXXXXXXXXXX---XXXXXXX--XXXXXXXXXXXXXXXXXXX--XXXXXXXXXXXXXXXX--XXXXXXXXXXXX
XXXXXXXXXXXXXXXXXXXX--XXXXXXXXXXXXXXXX--XXXXXXXXXXXXXXXX--XXXXXXXXX--XXXXXXXXX------XX--XXXXXXXXX---XXXXXXX--XXXXXXXXXXXX---XXXXXXX--XXXXXXXXXXXXXXXXXXX--XXXXXXXXXXXXXXXX--XXXXXXXXXXXX
