----------------------------------------------------------------------------------------------------------------------------------------------------------------------------------------
----------------------------------------------------------------------------------------------------------------------------------------------------------------------------------------
----------------------------------------------------------------------------------------------------------------------------------------------------------------------------------------
----------------------------------------------------------------------------------------------------------------------------------------------------------------------------------------
----------------------------------------------------------------------------------------------------------------------------------------------------------------------------------------
----------------------------------------------------------------------------------------------------------------------------------------------------------------------------------------
------------------------------------------------------y---------------------2------------------------------------------US------------------------###---------------------###------------
----------------------------------------------------#SSS-----------------------------------------------------------------------------------------###---------------------###------------
---------------------------------------oo----------##-----------------------------------------------------------------------------------------y--###------------------y--###------------
-----------------------------------y--------------###1--------------ooo-----------------------------------------------------------------------#--###------------------#--###------------
-------------------------ooo-------##-------------###-----------------------2----------------------QQ-----------------####--SSC--------------##--###-----------------##--###------------
----------------------------------###-----------#-###--SSS-------TT----------------------------------------------y-#####-------------------y###--###---------------y###--###------------
---------------------------------####----------##-###------------TT-------------------------------------------y-######---------------------####--###---------------####--###--------F---
----M---------y-y---------------#####-------------###---------y--TT-------y--y--------y-y--------------------#######----------------------#####--###--------------#####--###--------#---
XXXXXXXXXXXXXXXXXXXX--XXXXXXXXXXXXXXX---XXXXXXXXXXXXXXXX---XXXXXXXXXXXXXXXXXXXXXXXXXXXXXXXXX--XXXXXXXXX--XXXXXXXXX------XX--XXXXXXXXX---XXXXXXX--XXXXXXXXXXXX---XXXXXXX--XXXXXXXXXXXXXXX
XXXXXXXXXXXXXXXXXXXX--XXXXXXXXXXXXXXX---XXXXXXXXXXXXXXXX---XXXXXXXXXXXXXXXXXXXXXXXXXXXXXXXXX--XXXXXXXXX--XXXXXXXXX------XX--XXXXXXXXX---XXXXXXX--XXXXXXXXXXXX---XXXXXXX--XXXXXXXXXXXXXXX
