--------------------------------------------------------------------------------------------------------------------------------------------------------------------------------
--------------------------------------------------------------------------------------------------------------------------------------------------------------------------------
--------------------------------------------------------------------------------------------------------------------------------------------------------------------------------
------------------------------------------------------------------------------------------------------------------------------------------------U-------------------------------
--------------------------------------------------------------------------------------------------------------------------------------------------------------------------------
--------------------------------------------------------------------------------K---------------------------------------------------------------------------------k-------------
----------------------------------------------------------------------------SSSSSS----1----------------------------------------SSSSS------------------------------##------------
--------------------------------------------------------------------------------------------------------------------------------------------------SS-------------###------------
---------------------------------------B---------------------------------------------------------------------------------------------------------------#--------####------------
---------------------------------------b-------------------------------------K--------------------------------------------------K-------------SS------##-------#####------------
--------------QQQQ-------------------SS#CS---------------------------------SSSSSSS---------------------------------------------SSSSS-----------------###------######------------
-------------------K-B-----K---B-------------------------------------TT---------------TT------------------------------------------K---#----B--------####-----#######------------
---------------------b---------b---------K-B-----TT----------B-------TT---------------TT----------------------------------------------#----b-------#####----########--------F---
-M-------------------b---------B-----------b-----TT----------b-------TT---------------TT----------------------------------------------#----B------######---#########--------#---
XXXXXXXXXXXXXXXXXXXXXXXXXXXXXXXXXXXXXXXXXXXXXXXXXXXXXXXXXXXXXXXXXX--XXXXXXXXXXXXXXXXXXXXXXXXXXXXXXXXXXXXXXXXXXXXXXXXXXXXXXXXXXXXXXXXXXXXXXXXXXXXX-XXXXXXXXXXXXXXXXXXXXXXXXXXXXXX
XXXXXXXXXXXXXXXXXXXXXXXXXXXXXXXXXXXXXXXXXXXXXXXXXXXXXXXXXXXXXXXXXX--XXXXXXXXXXXXXXXXXXXXXXXXXXXXXXXXXXXXXXXXXXXXXXXXXXXXXXXXXXXXXXXXXXXXXXXXXXXXX-XXXXXXXXXXXXXXXXXXXXXXXXXXXXXX
