-----------------------------------------------------------------------------------------------------------------------------------------------------------------------------------------------------------
-----------------------------------------------------------------------------------------------------------------------------------------------------------------------------------------------------------
-----------------------------------------------------------------------------------------------------------------------------------------------------------------------------------------------------------
-----------------------------------------------------------------------------------------------------------------------------------------------------------------------------------------------------------
---------------------------------------------------------------------------------------------------------------------------------------------------------------------------XX------------------------------
----------------------------------------------------------------------------------------------------------------------------------------------------oo---------------------XX---------------------K--------
-----------------------------------------------------------------------------------------------------------------------------------------------------------------------C---XX------------------------------
---------------------------------------------------------------------------------------------------------------------------------------------------------------------------XX------------------------------
---------------------------------------------------------------------------------------------------------------------------------------------------------------------------XX------------------------------
-------------------------------------------------------------------------------------------o-------------------------------------------------------------------------------XX------------------------------
----------------------------------------------------------------------------------------------------------------------------------------------------------------------SS---XX------------------------------
----------------------------------------oo-------------------------------------------------------------------k-----------------------TT----------------------TT------------XX------------------------------
------------------------------------------------------------TT-----------------------------------------------------------------------TT--------K-------------TT------------XX--------------------------F---
---M-----ggg---ggg-----g---------------------ggg------------TT-k-----------r-------------------g---g-----------------------gg-----y--TT---------------ggg----TT---k--ggg---XX--------y--y---ggg--------X---
XXXXXXXXXXXXXXXXXXXXXXXXXXXXXXXXXXXXXXXXXXXXXXXXXXXXXXXXXXXXXXXXXXXXXXXXXXXXXXXXXXXXXXXXXXXXXXXXXXXXXXXXXXXX---XXXXXXXXXXXXXXXXXXXXXXXXXXXXXXXXXXXXXXXXXXXXXXXXXXXXXXXXXXXXXXXXXXXXXXXXXXXXXXXXXXXXXXXXXXXX
XXXXXXXXXXXXXXXXXXXXXXXXXXXXXXXXXXXXXXXXXXXXXXXXXXXXXXXXXXXXXXXXXXXXXXXXXXXXXXXXXXXXXXXXXXXXXXXXXXXXXXXXXXXX---XXXXXXXXXXXXXXXXXXXXXXXXXXXXXXXXXXXXXXXXXXXXXXXXXXXXXXXXXXXXXXXXXXXXXXXXXXXXXXXXXXXXXXXXXXXX
