------------------------------------------------------------------------------------------------------------------------------------------------------------------------------------------------------------
------------------------------------------------------------------------------------------------------------------------------------------------------------------------------------------------------------
------------------------------------------------------------------------------------------------------------------------------------------------------------------------------------------------------------
------------------------------------------------------------------------------------------------------------------------------------------------------------------------------------------------------------
---------------------------------------------------------------------------------------------------------------------------------------------------------------------------------------------XX-------------
---------------------------------------------------------------------------------------------------------------------------------------------------------------------------------------------XX-------------
-----------------------------------------------------------------------------------------------------------------------------------------------------------------------------------------C---XX-------------
---------------------------------------------------------------------------------------------------------------------------------------------------------------------------------------------XX-------------
---------------------------------------------------------------------------------------------------------------------------------------------------------------------------------------------XX-------------
--------------------------------o-------------------------------------------------------------------------------------------------------------------------------------o----------------------XX-------------
---------------------------------------------------------------------------------------------------------------------------------------------------------QQ-----------------------------SS---XX-------------
--------------------#---------------------------------ooo---------------------------------------------------------------------------------ooo----------------------------------TT------------XX-------------
--------------------#--------------------------------------------------------------------------------------------------------------------------------------K-------------------TT------------XX---------F---
---M------k-----k---#------------------ggggg-------------r------------------------------------gg-----------------------g----ggK--------------r------gg---------k-----ggg-ggg---TT--g----y----XX---------#---
XXXXXXXXXXXXXXXXXXXXXXXXXXXXXXXXXXXXXXXXXXXXXXXXXXX--XXXXXXXXXXXXXXXXXX---XXX--XXXXXXXXXXXXXXXXXXXXXXXXXXX--XXXXXXXXXXXXXXXXXXXXXXXXXXXXXXXXXXXXXXXXXXXXXXXXXXXXXXXXXXXXXXXXXXXXXXXXXXXXXXXXXXXXXXXXXXXXXXXX
XXXXXXXXXXXXXXXXXXXXXXXXXXXXXXXXXXXXXXXXXXXXXXXXXXX--XXXXXXXXXXXXXXXXXX---XXX--XXXXXXXXXXXXXXXXXXXXXXXXXXX--XXXXXXXXXXXXXXXXXXXXXXXXXXXXXXXXXXXXXXXXXXXXXXXXXXXXXXXXXXXXXXXXXXXXXXXXXXXXXXXXXXXXXXXXXXXXXXXX
