--------------------------------------------------------------------------------------------------------------------------------------------------------------------------------
--------------------------------------------------------------------------------------------------------------------------------------------------------------------------------
--------------------------------------------------------------------------------------------------------------------------------------------------------------------------------
------------------------------------------------------------------------------------------------------------------------------------------------U-------------------------------
--------------------------------------------------------------------------------------------------------------------------------------------------------------------------------
------------------------------------------------------------------------------------------------------------------------------------------------------------------k-------------
-------------------------------------------------------------------------------------------------------------------------------SSSSS------------------------------##------------
--------------------------------------------------------------------------------------------------------------------------------------------------SS-------------###------------
-------------------------------------------------------------------------------------------------------------------------------------------------------#--------####------------
--------------------------------------------------------------------------------------------------------------------------------K-------------SS------##-------#####------------
-------------------------------------------------------------------------------------------------------------------------------SSSSS-----------------###------######------------
----------------------------------------------------------------------------------------------------------------------------------K---#----B--------####-----#######------------
-------------B-----TT-----------------------------------------------------------------------------------------------------------------#----b-------#####----########--------F---
-M-----------b-----TT-----------------------------------------------------------------------------------------------------------------#----B------######---#########--------#---
XXXXXXXXXXXXXXXXXXXXXXXXXXXXXXXXXXXXXXXXXXXXXXXXXXXXXXXXXXXXXXXXXXXXXXXXXXXXXXXXXXXXXXXXXXXXXXXXXXXXXXXXXXXXXXXXXXXXXXXXXXXXXXXXXXXXXXXXXXXXXXXXX-XXXXXXXXXXXXXXXXXXXXXXXXXXXXXX
XXXXXXXXXXXXXXXXXXXXXXXXXXXXXXXXXXXXXXXXXXXXXXXXXXXXXXXXXXXXXXXXXXXXXXXXXXXXXXXXXXXXXXXXXXXXXXXXXXXXXXXXXXXXXXXXXXXXXXXXXXXXXXXXXXXXXXXXXXXXXXXXX-XXXXXXXXXXXXXXXXXXXXXXXXXXXXXX
