----------------------------------------------------------------------------------------------------------------------------------------------------------------------------------------
----------------------------------------------------------------------------------------------------------------------------------------------------------------------------------------
----------------------------------------------------------------------------------------------------------------------------------------------------------------------------------------
----------------------------------------------------------------------------------------------------------------------------------------------------------------------------------------
----------------------------------------------------------------------------------------------------------------------------------------------------------------------------------------
----------------------------------------------------------------------------------------------------------------------------------------------------------------------------------------
-------------------------------------------------------------------------------------------------------------------------------------------------------------------------###------------
-------------------------------------------------------------------------------------------------------------------------------------------------------------------------###------------
----------------------------------------------------------------------------------------------------------------------------------------------------------------------y--###------------
----------------------------------------------------------------------------------------------------------------------------------------------------------------------#--###------------
---------------------------------------------------------------QQ----------------------------------------------------------------------------------------------------##--###------------
-------------------------------------------------------------------------------------------------------------------------------------------------------------------y###--###------------
-------------------------------------------------------------------------------------------------------------------------------------------------------------------####--###--------F---
----M---------y-y---------------y-y---------------y-y---------------y-y---------------y-y---------------y-y---------------y-y---------------y-y-------------------#####--###--------#---
XXXXXXXXXXXXXXXXXXXX--XXXXXXXXXXXXXXXX--XXXXXXXXXXXXXXXX--XXXXXXXXXXXXXXXX--XXXXXXXXXXXXXXXX--XXXXXXXXXXXXXXXX--XXXXXXXXXXXXXXXX--XXXXXXXXXXXXXXXX--XXXXXXXXX---XXXXXXX--XXXXXXXXXXXXXXX
XXXXXXXXXXXXXXXXXXXX--XXXXXXXXXXXXXXXX--XXXXXXXXXXXXXXXX--XXXXXXXXXXXXXXXX--XXXXXXXXXXXXXXXX--XXXXXXXXXXXXXXXX--XXXXXXXXXXXXXXXX--XXXXXXXXXXXXXXXX--XXXXXXXXX---XXXXXXX--XXXXXXXXXXXXXXX
