----------------------------------------------------------------------------------------------------------------------------------------------------------------------------------------------------------
----------------------------------------------------------------------------------------------------------------------------------------------------------------------------------------------------------
----------------------------------------------------------------------------------------------------------------------------------------------------------------------------------------------------------
----------------------------------------------------------------------------------------------------------------------------------------------------------------------------------------------------------
----------------------------------------------------------------------------------------------------------------------------------------------------------------------------------------------------------
----------------------------------------------------------------------------------------------------------------------------------------------------------------------------------------------------------
----------------------------------------!---------------------------##------------------------------------------------------------------------------------!-----------------------------------------------
-------------------------------------------------------------------###------------------------------------------------------------------------------------------------------------------------------------
------------------------------------------------------------------####------------------------------------------------------------------------------------------------------------------------------------
-----------------------------------------------------------------#####------------------------------------------------------------------------------------------------------------------------------------
----------------------------------!---S@S!S---------------------######------------------------------------------------tt----------------------------!---S@S!S---------------------------------------------
---------------------------------------------------------------#######----------------------------------------tt------tt----------------------------------------------------------------------------------
----------------------------------------------tt-----------tt-########----------------------------------------tt------tt----------------------------------------tt------------------------------------F---
---M-----------------------------------g------tt------gg---tt#########----------------------------------------tt-g----tt---------------------------------g------tt------------------------------------#---
XXXXXXXXXXXXXXXXXXXXXXXXXXX--XXXXXXXXXXXXXXXXXXXXXXXXXXXXXXXXXXXXXXXXXXXXXXXXXXXXXXXXXXXXXXXXXXXXXX--XXXXXXXXXXXXXXXXXXXXXXXXXXXXXXXXXXXXXXXXXXXXXXXXXXXXXXXXXXXXXXXXXXXXXXXXXXXXXXXXXX--XXXXXXXXXXXXXXXXX
XXXXXXXXXXXXXXXXXXXXXXXXXXX--XXXXXXXXXXXXXXXXXXXXXXXXXXXXXXXXXXXXXXXXXXXXXXXXXXXXXXXXXXXXXXXXXXXXXX--XXXXXXXXXXXXXXXXXXXXXXXXXXXXXXXXXXXXXXXXXXXXXXXXXXXXXXXXXXXXXXXXXXXXXXXXXXXXXXXXXX--XXXXXXXXXXXXXXXXX
