------------------------------------------------------------------------------------------------------------------------------------------------------------------------------------------------------------------------------
------------------------------------------------------------------------------------------------------------------------------------------------------------------------------------------------------------------------------
------------------------------------------------------------------------------------------------------------------------------------------------------------------------------------------------------------------------------
------------------------------------------------------------------------------------------------------------------------------------------------------------------------------------------------------------------------------
------------------------------------------------------------------------------------------------------------------------------------------------------------------------------------------------------------------------------
----------------------------------------------------------------------------------------------y-----------------------------------------------------------------------------------------------y-------------------------------
----------------------------------------------------------------------------------------------##----------------------------------------------------------------------------------------------##------------------------------
--------------------------------------------------------------------------------------------y###--------------oooo----------oooo------------oooo--------------------------------------------y###------------------------------
--------------------------------------------------------------------------------------------####--------------------------------------------------------------------------------------------####------------------------------
-------------------------------------------------------------------------------------------#####-------------------------------------------------------------------------------------------#####------------------------------
------------------------------------------------------------------------------------------######---C---------------------TT--------------TT-----------------------------------------------######---C--------------------------
-----------------------------------------------------------------------------------------#######------------#------------TT--------------TT----------------------------------------------#######------------------------------
----------------------------------------------------------------------------------------########------------#------------TT--------------TT---------------------------------------------########--------------------------F---
-M---------------------------------------------------------------y---------------------#########------------#---------y--TT---y------y---TT--------------------------------------------#########--------------------------#---
XXXXXXXXXXXXX--XXXXXXXXXXXXXXXXXXXXXXXXXXXXXXXXXXXXXXXXXXXXXXXXXXXXXXXXXXXXXXXXXXXXXXXXXXXXXXXXXXXXXXXXXXXXXXXXXXXXXXXXXXXXXXXXXXXXXXXXXXXXXXXXXXXXXXXXXXXXXXXXXXXXXXXXXXXXXXXXXXXXXXXXXXXXXXXXXXXXXXXXXXXXXXXXXXXXXXXXXXXXXXX
XXXXXXXXXXXXX--XXXXXXXXXXXXXXXXXXXXXXXXXXXXXXXXXXXXXXXXXXXXXXXXXXXXXXXXXXXXXXXXXXXXXXXXXXXXXXXXXXXXXXXXXXXXXXXXXXXXXXXXXXXXXXXXXXXXXXXXXXXXXXXXXXXXXXXXXXXXXXXXXXXXXXXXXXXXXXXXXXXXXXXXXXXXXXXXXXXXXXXXXXXXXXXXXXXXXXXXXXXXXXX
