------------------------------------------------------------------------------------------------------------------------------------------------------
------------------------------------------------------------------------------------------------------------------------------------------------------
------------------------------------------------------------------------------------------------------------------------------------------------------
--------------------------------oo------------------------------------------------------------------------------oo------------------------------------
-------------------------------------g-g-----------------------------------------------------------------------------g-g------------------------------
----oo----------------ooor---------%%%%%%%------------------------------------------------------------ooor---------%%%%%%%----------------------------
---------------------%%%%%----------|||||------------------------------------------------------------%%%%%----------|||||-----------------------------
----------------------|||-----------|||||----oo-------------------------------------------------------|||-----------|||||----oo-----------------------
----------------------|||-----------|||||-------------------------------------------------------------|||-----------|||||-----------------------------
----------------------|||-----%%%%%-|||||-------------------------------------------------------------|||-----%%%%%-|||||-----------------------------
-------------------%%%%%%%%----|||--|||||----------------------------------------------------------%%%%%%%%----|||--|||||-----------------------------
--------------------||||||-----|||--|||||-----------------------------------------------------------||||||-----|||--|||||-----------------------------
--------------------||||||--o--|||--|||||-----------------------------------------------------------||||||--o--|||--|||||--------------------------F--
-M-----------%%%%---||||||-%%%-|||--|||||----------------------------------------------------%%%%---||||||-%%%-|||--|||||--------------------------#--
XXXXXXXXXXX---||----||||||--|--|||--|||||-------------------------------------------XXXXXXX---||----||||||--|--|||--|||||-------------------XXXXXXXXXX
XXXXXXXXXXX---||----||||||--|--|||--|||||-------------------------------------------XXXXXXX---||----||||||--|--|||--|||||-------------------XXXXXXXXXX
