-------------------------------------------------------------------------------------------------------------------------------------------------------------------------------------------
-------------------------------------------------------------------------------------------------------------------------------------------------------------------------------------------
-------------------------------------------------------------------------------------------------------------------------------------------------------------------------------------------
S---------------SSSSSSS-----SSSS----SSSSSSSSSSS-----SSSS--------SSSS------------SSSS--------SSSS------------SSSSSSSSSSSSSSSSSSSSSSSSSSSSSSSSSSSS----SSSS-------SSSSSSSSSSSSSSSSS----SSSSSSS
S-----------------------------------------------------------------------------------------------------------------------SSSSSSSSSSSSSSSSSSSSSSSS--------------------SSSSSSSSSSSS-----------
S-----------------------------------------------------------------------------------------------------------------------SSSSSSSSSSSSSSSSSSSCSSSS--------------------SSSSSSSSSSSS-----------
S-----------------------------------------------------------------------------------------------------------------------SSSSSSSSSSSSSSSSSSSSSSSS------------CSS-----SSSSSSSSSSSS-----------
S-------------------------------------------------------------------------------------------------------------------------------------------------------------------S---------------TT-----
S------------------------------------------------------------------------------------------------------------------------------------------------------SSS--2-------S---------------TT-----
S------------------------------------------------------------------------------------------------------------------------------------------ggg-------------2-2--------oooooo--------TT-----
S-----------------------------------------------------------------------------------------TT------------------------------SSSSSS?-SSSSSSSSSSSSSS--QQQ---------2------USSSSSS----#---TT----F
S-------------------------------------------------------------------------------------TT--TT------------------------------SSSSS---SSSSSSSSSSSSSS-------------------------------##---TT---SS
S------------------------------------------------------------------------------tt-----TT--TT------------------------------SSSSS---SSSSSSSSSSSSSS------------------------------###---TT---SS
S-M----------------------------------------------------------------------------tt----kTT--TT-----------------------------------oooSSSSSSSSSSSSSS------------------------kk---####--kTT---SS
XXXXXXXXXXXXXXX--------------------------------------------------------------XXXXXXXXXXXXXXX--XXXXXXXXXXXXXXXXX--XX--X---XXXXXXXXXXXXXXXXXXXXXXXXXXXX------XXXXXXXXXXXXXXXXXXXXXXXXXXXX--XX
XXXXXXXXXXXXXXX--------------------------------------------------------------XXXXXXXXXXXXXXX--XXXXXXXXXXXXXXXXX--XX--X---XXXXXXXXXXXXXXXXXXXXXXXXXXXX------XXXXXXXXXXXXXXXXXXXXXXXXXXXX--XX
