-------------------------------------------------------------------------------------------------------------------------------------------------------------------------------------------
-------------------------------------------------------------------------------------------------------------------------------------------------------------------------------------------
-------------------------------------------------------------------------------------------------------------------------------------------------------------------------------------------
S-------SSSSSSSS------------SSSS----SSSSSSSSSSSSSSSSS---------------SSSSSSSS------------SSSSSSSSSSSS--------SSSS----SSSSSSSS--------SSSS------------SSSSSSSSSSSS----SSSSSSSSSSSSSSSSSSSS---
S-------------------------------------------------------------------------------------------------------------------------------------------------------------------SSSSSSSSSSSS-----------
S-------------------------------------------------------------------------------------------------------------------------------------------------------------------SSSSSSSSSSSS-----------
S-------------------------------------------------------------------------------------------------------------------------------------------------------------------SSSSSSSSSSSS-----------
S-------------------------------------------------------------------------------------------------------------------------------------------------------------------S---------------TT-----
S-------------------------------------------------------------------------------------------------------------------------------------------------------------------S---------------TT-----
S---------------------------------------------------------------------------------------------------------------------------------------------------------------------oooooo--------TT-----
S-------------------------------------------------------------------------------------------------------------------------------------------------------------TT-----USSSSSS----#---TT----F
S---------------------------------#-----------------------------------------------------------------------------------------------------------------------TT--TT---------------##---TT---SS
S--------------------------------##-SSS------------------------------------------------------------------------------------------------------------tt-----TT--TT--------------###---TT---SS
S-M-----------------------------###----------------------------------------------------------------------------------------------------------------tt----kTT--TT--------kk---####--kTT---SS
XXXXXXXXXXXXXXXXXXXXXXXXXXXXXXXXXXX--------------------------------------------------------------------------------------------------------------XXXXXXXXXXXXXXX--XXXXXXXXXXXXXXXXXXXXX--XX
XXXXXXXXXXXXXXXXXXXXXXXXXXXXXXXXXXX--------------------------------------------------------------------------------------------------------------XXXXXXXXXXXXXXX--XXXXXXXXXXXXXXXXXXXXX--XX
