-------------------------------------------------------------------------------------------------------------------------------------------------------------------------------------------------------------------------------------------------------------------------------------------------------------------------------------------------------------------------------------
-------------------------------------------------------------------------------------------------------------------------------------------------------------------------------------------------------------------------------------------------------------------------------------------------------------------------------------------------------------------------------------
-------------------------------------------------------------------------------------------------------------------------------------------------------------------------------------------------------------------------------------------------------------------------------------------------------------------------------------------------------------------------------------
-------------------------------------------------------------------------------------------------------------------------------------------------------------------------------------------------------------------------------------------------------------------------------------------------------------------------------------------------------------------------------------
-------------------------------------------------------------------------------------------------------------------------------------------------------------------------------------------------------------------------------------------------------------------------------------------------------------------------------------------------------------------------------------
-------------------------------------------------------------------------------------------------------------------------------------------------------------------------------------------------------------------------------------------------------------------------------------------------------------------------------------------------------------------------------------
---------------------------------------------------------------##--------------------------------------------------------------------------------------------------------------------------------------------------------------------------------------------------------------------------------------SSSSCSSS----------------------------------------------------------------------
---------------------------------------------------------------##--------------------------------------------------------------------------------------------------------------------------------------------------------------------------------------------------------------------------------------------------------------------------------------------------------------------
-------------------------------------------------------------#-##--------------------------------------------------------------------------------------------------------------------------------------------------------------------------------------------------------------------------------------------------------------------------------------------------------------------
-------------------------------------------------------------#-##--------------------SSUSSSSS------------------------------------------------------------------------------------------------------------------------------------------------------------------------o---------------------------------------------------------------------------------------------------------------
-----------------------------------------------------------#-#-##-------------------------------------------------------------------------------------------------------------------------------------------------------------------------------------------------------------------------------------#----2----#------------------##------------------------------------------------
-----------------------------------------------------------#-#-##--------TT---------------------------------------------------------------------------------------------------------------------------------------------------------------------------------------------------------------------------#------K--#------------------##--------------------TT--------------------------
----------------------------------------------------TT---#-#-#-##--------TT---------------------------------------------------------------------------------------------------------#-----------------------------------------------------------------------------------------------------------------#---------#-----------TT---#-##--------------------TT----------------------F---
-M--------------------------------------------------TT---#-#-#-##--------TT-----------------------------------------------------------------------------k---------------------------#-----------------------------------k------------------------------------------------------------------------ggg--#---------#-----------TT---#-##--------------------TT----------------------#---
XXXXXXXXXX--------------------------------------XXXXXXXX-X-X-X-XXXXXXXXXXXXXXXXXXXXXXXXXXXXXXXXXXX--------------------------------------------------XXXXXXXXXXX-----------------XXXXXXXXXXX-------------------------XXXXXXXXXXX-------------------------------------XXXXXX------------------XXXXXXXXXXXXXXXXXXXXXXXXXXXXXXXXXXXX-X-XXXXXXXX---------XXXXXXXXXXXXXX------XXXXXXXXXXXXX
XXXXXXXXXX--------------------------------------XXXXXXXX-X-X-X-XXXXXXXXXXXXXXXXXXXXXXXXXXXXXXXXXXX--------------------------------------------------XXXXXXXXXXX-----------------XXXXXXXXXXX-------------------------XXXXXXXXXXX-------------------------------------XXXXXX------------------XXXXXXXXXXXXXXXXXXXXXXXXXXXXXXXXXXXX-X-XXXXXXXX---------XXXXXXXXXXXXXX------XXXXXXXXXXXXX
