-------------------------------------------------------------------------------------------------------------------------------------------------------------------------------------------
-------------------------------------------------------------------------------------------------------------------------------------------------------------------------------------------
-------------------------------------------------------------------------------------------------------------------------------------------------------------------------------------------
S-------SSSSSSSSSSSS----SSSSSSSSSSSSSSSSSSSSSSSSSSSSSSSSSSSSSSSSSSSSSSSSSSSSSSSSSSSSSSSSSSSSSSSSSSSSSSSSSSSS------------------------SSSS----SSSS--------------------SSSSSSSSSSSS-----------
S-----------------------SSSSSSSSSSSSSSSSSSSSSSSSSSSSSSSSSSSSSSSSSSSSSSSSSSSSSSSSSSSSSSSSSSSSSSSSSSSSSSSS------------------------------------------------------------SSSSSSSSSSSS-----------
S-----------------------SSSSSSSSSSSSSSSSSSSSSSSSSSSSSSSSSSSSSSSSSSSSSSSSSSSSSSSSSSSSSSSSSSSSSSSSSSSCSSSS------------------------------------------------------------SSSSSSSSSSSS-----------
S-----------------------SSSSSSSSSSSSSSSSSSSSSSSSSSSSSSSSSSSSSSSSSSSSSSSSSSSSSSSSSSSSSSSSSSSSSSSSSSSSSSSS------------------------------------------------------------SSSSSSSSSSSS-----------
S-------------------------------------------------------------------------------------------------------------------------------------------------------------------S---------------TT-----
S-------------------------------------------------------------------------------------------------------------------------------------------------------------------S---------------TT-----
S--------------------------------------------------------------------------------------------------ggg----------------------------------------------------------------oooooo--------TT-----
S-------------------------SSSSSS?-SSSSSSSSSSSSSSSSSSSSSSSSSSSSSSSSSSSSSSSSSSSSSSSSSSSSSSSSSSSSSSSSSSSSSS--QQ---------------------------------------------------------USSSSSS----#---TT----F
S-------------------------SSSSS---SSSSSSSSSSSSSSSSSSSSSSSSSSSSSSSSSSSSSSSSSSSSSSSSSSSSSSSSSSSSSSSSSSSSSS--------------------------------------------------#--------------------##---TT---SS
S-------------------------SSSSS---SSSSSSSSSSSSSSSSSSSSSSSSSSSSSSSSSSSSSSSSSSSSSSSSSSSSSSSSSSSSSSSSSSSSSS-------------------------------------------------##-SSS---------------###---TT---SS
S-M----------------------------oooSSSSSSSSSSSSSSSSSSSSSSSSSSSSSSSSSSSSSSSSSSSSSSSSSSSSSSSSSSSSSSSSSSSSSS------------------------------------------------###-------------kk---####--kTT---SS
XXXXXXXXXXXXXXX--XX--X---XXXXXXXXXXXXXXXXXXXXXXXXXXXXXXXXXXXXXXXXXXXXXXXXXXXXXXXXXXXXXXXXXXXXXXXXXXXXXXXXXXXXXXXXXXXXXXXXXXXXXXXXXXXXXXXXXXXXXXXXXXXXXXXXXX-----XXXXXXXXXXXXXXXXXXXXXXX--XX
XXXXXXXXXXXXXXX--XX--X---XXXXXXXXXXXXXXXXXXXXXXXXXXXXXXXXXXXXXXXXXXXXXXXXXXXXXXXXXXXXXXXXXXXXXXXXXXXXXXXXXXXXXXXXXXXXXXXXXXXXXXXXXXXXXXXXXXXXXXXXXXXXXXXXXX-----XXXXXXXXXXXXXXXXXXXXXXX--XX
