---------------------------------------------------------------------------------------------------------------------------------------------------------------------------------------------------------
---------------------------------------------------------------------------------------------------------------------------------------------------------------------------------------------------------
---------------------------------------------------------------------------------------------------------------------------------------------------------------------------------------------------------
----------------------------------------------------SSS-------------------------------------------------------------SSSS--------SSSS------------------------------------U---------------------------SSSS-
---------------------------------------------------------------------------------------------------------------------------------------------------------------------------------------------------------
--------------------------------ooo-----------------------------------------------------------------o----------------------------------------------------------------------------------------------------
-------------------------------%%%%-------------------------------------------------------------------------------------------SS-------------------------------------------------Q-Q---------------------
--------------------------------||----------SSSS--------------------------------------------------------------------------------------------------------------------------SS-----------------------------
--------------------------------||-----------------------------------------------------------------------------------------------------------------------------------SSS---------------------------------
--------------------------------||----------------------oo---------------------------------------------------------------------------------------------------R-------------------------------------------
--------------------------------||---------------------%%%%------------------------------------------------------------------------------SS------------------------g-------------Q-Q---------------------
--------#-----------------------||----------------------||----------------------------------------------SSSS---------------------------------------------------%%%%%%%-----------------------------------
--------#-----------------------||----------------------||------------------------------------------------------------------------------------------------------|||||----------------------------------F-
---M----#-----------------------||----------------------||------------------------------------------------------------------------------------------------------|||||----------------------------------#-
XXXXXXXXXXXXXXX-----------------||-XXXXXXXXXXXXXXX------||------------------------------------------------------------------------------------------------------|||||-----------XXXXXX----------XXXXXXXXX
XXXXXXXXXXXXXXX-----------------||-XXXXXXXXXXXXXXX------||------------------------------------------------------------------------------------------------------|||||-----------XXXXXX----------XXXXXXXXX
