---------------------------------------------------------------------------------------------------------------------------------------------------------------------
---------------------------------------------------------------------------------------------------------------------------------------------------------------------
---------------------------------------------------------------------------------------------------------------------------------------------------------------------
---------------------------------------------------------------------------------------------------------------------------------------------------------------------
-----------------------------------------------------------------------------------------------------------------------------------------------------oo--------------
---------------------------------------------------------------------------------------------------------------------------------------------------------------------
--------------------------------------------------------------------------------------------------------------------------------------SS---------------%%%%----------
------------------------------------------------------------------------------------------------------------------------------------------------SSS-----||-----------
---------------------------------oo---------------------------------------------------------------------------------------------------------------------||-----------
--------------------------------------------------------------------------------------------------------------------------------------------------------||-----------
----------------%%%%---------------%%%%-------------------------------------%%%%%%----SS----------------------------------------------------------------||-----------
-----------------||---------SSS-----||---------------------------------SSS---||||-----------------------------------------------------------------------||-----------
-----------------||-----------------||---------------------------------------||||-----------------------------------------------------------------------||---------F-
-M---------------||-----------------||---------------------------------------||||-----------------------------------------------------------------------||---------X-
XXXXXXXXXXX--%%%%||%%%%-------------||---------------------------------------||||-----------------------------------------%%%%%-----------%%%%%---------||-XXXXXXXXXX
XXXXXXXXXXX---||-||-||--------------||---------------------------------------||||------------------------------------------|||-------------|||----------||-XXXXXXXXXX
