--------------------------------------------------------------------------------------------------------------------------------------------------------------
--------------------------------------------------------------------------------------------------------------------------------------------------------------
--------------------------------------------------------------------------------------------------------------------------------------------------------------
S-----SS------------------SS----------------------------------------------------------------------------------------------------------------------------------
S-------------------------------------------------------------------------------------------------------------------------------------------------------------
S-------------------------------------------------------------------------------------------------------------------------------------------------------------
S-------------------------------------------------------------------------------------------------------------------------------------------------------------
S-------------------------------------------------------------------------------------------------------------------------------------------------------------
S-------------------------------------------------------------------------------------------------------------------------------------------------------------
S----------------------------------------------------------------------------C--------------------------------------------------------------------------------
S----------------------------TT----------------------------------------#-#-----------------------------------TT---------------------------@QQQQ---------------
S----------------------TT----TT-----------SS-------------------------#-#-#-#---#-----------------------TT----TT-----------SS----------------------------------
S----------------------TT----TT----TT-----SS---------------------g-#-#-#-#-#---#-#---------------------TT----TT----TT-----SS----------------------------------
S--M------------g-g-g--TT----TT--g-TT-----SS--------------------g#-#-#-#-#-#-E-#-#--------------g-g-g--TT----TT--g-TT-----SS--------------------------------F-
XXXXXXXXXXXXXXXXXXXXXXXXXXXXXXXXXXXXXXXX--XX--XXXXXXXXXXXXXXXXXXXXXXXXXXXXXXXXXXXXXXXXXXXXXXXXXXXXXXXXXXXXXXXXXXXXXXXXXX--XX--XXXXXXXXXXXXXXXXXXXXXXXXXXX--XXX
XXXXXXXXXXXXXXXXXXXXXXXXXXXXXXXXXXXXXXXX--XX--XXXXXXXXXXXXXXXXXXXXXXXXXXXXXXXXXXXXXXXXXXXXXXXXXXXXXXXXXXXXXXXXXXXXXXXXXX--XX--XXXXXXXXXXXXXXXXXXXXXXXXXXX--XXX
