---------------------------------------------------------------------------------------------------------------------------------------------------------------------
---------------------------------------------------------------------------------------------------------------------------------------------------------------------
---------------------------------------------------------------------------------------------------------------------------------------------------------------------
----------------------------------------ooo--------------------------------------------------------------------------------------------------------------------------
----------------------------------------%%%--------------------------------------------------------------------------------------------------------------------------
---------------------------------------------------------------------------------------------------------------------------------------------------------------------
--------------------------------%%%%------------------------------%%%%-------SS---%%%%--------------------------%%%%-------------------------------------------------
---------------------------------------------------------------------------------------------------------------------------------------------------------------------
---------------------------------------------------------------------------------------------------------------------------------------------------------------------
---------------------------------------------%%%%------oooo----------------------------------------------------------------------------------------------------------
----------------%%%%------SS---------SS-----------------------%%%%--------------------------------------%%%%--------------------------------------SS-----------------
----------------------------------------%%%%%%-----------------------------------------------------SSS---------------------------------------------------------------
-------------------------------------------------------------------------------------------------------------------------------------------------------------------F-
-M-----------------------------------------------------------------------------------------------------------------------------------------------------------------X-
XXXXXXXXXXX--%%%%--%%%%-------------------------%%%%%%%%%-%%%%------%%%%%%----------------%%%%%------------------------------------------------------------XXXXXXXXXX
XXXXXXXXXXX------------------------------------------------------------------------------------------------------------------------------------------------XXXXXXXXXX
