----------------------------------------------------------------------------------------------------------------------------------------------------------------------------------------------------------------------
----------------------------------------------------------------------------------------------------------------------------------------------------------------------------------------------------------------------
----------------------------------------------------------------------------------------------------------------------------------------------------------------------------------------------------------------------
----------------------------------------------------------------------------------------------------------------------------------------------------------------------------------------------------------------------
----------------------------------------------------------------------------------------------------------------------------------------------------------------------------------------------------------------------
--------------------------------------------------------------------------------------------------------------------------------------------------------------g-------------------------------------------------------
--------------------------------------------------------SSSSSSS-------------------------------------SSSSSSS---------------------------------------------------SSSSS---------------------------------------------------
--------------------------------------------------------------------------------------------------------------------------------------------------------------------------TT------------------------------------------
--------------------------------------------------------------------------------------------------------------------------------------------------------------------------TT------------------------------------------
--------------------------------------------------------------------------------------------------------------------------------------------------------------------------TT------------------------------------------
-----------SSS-----------SSS-------------TT------------------------------------------------------------------------------------------SSS---------------------------------SXXS-----------------------------------------
--------------------------------------K--TT-----------------------------TT--------------------------------------------------------------------------------------------------------------------------------------------
------------------TT--TT-----------------TT---------------------------TTTT------------------------------------------------TTTT----------------------------------------TT------TT--------------------------TT-------F--
---M--------------TT--TT-----------------TT---------------------------TTTT------------------------------------------------TTTT----------------------------------------TT------TT--------------------------TT-------#--
XXXXXXXX-X-XXXXXXXXXXXXXXXXXXXXXXXXXXXXXXXXXXXXXXX------------------XXXXXXXXXXXXXX--------------------------------------XXXXXXXXXXXXXXXXXX--------------------------XXXXXXXXXXXXXXXXXX------------------XXXXXXXXXXXXXX
XXXXXXXX-X-XXXXXXXXXXXXXXXXXXXXXXXXXXXXXXXXXXXXXXX------------------XXXXXXXXXXXXXX--------------------------------------XXXXXXXXXXXXXXXXXX--------------------------XXXXXXXXXXXXXXXXXX------------------XXXXXXXXXXXXXX
