----------------------------------------------------------------------------------------------------------------------------------------------------------------------------------------------------------------------
----------------------------------------------------------------------------------------------------------------------------------------------------------------------------------------------------------------------
----------------------------------------------------------------------------------------------------------------------------------------------------------------------------------------------------------------------
----------------------------------------------------------------------------------------------------------------------------------------------------------------------------------------------------------------------
----------------------------------------------------------------------------------------------------------------------------------------------------------------------------------------------------------------------
----------------------------------------------------------------------------------------------------------------------------------------------------------------------------------------------------------------------
-----------------------------------------------------------------------------------------------------------------------------------------------------------SSS----------------------SSSSSSS---------------------------
----------------------------------------------------------------------------------------------------------------------------------------------------------------------------------------------------------------------
----------------------------------------------------------------------------------------------------------------------------------------------------------------------------------------------------------------------
----------------------------------------------------------------------------------------------------------------------------------------------------------------------------------------------------------------------
-----------------------------------------------------------------TT------------------------------------------------------TT--------------TT----------------SSS--------------SSSSS-------------TT----------------------
-----------------------------------------------------------------TT---------------------------------------------------K--TT--------------TT-----TT------------------------------------------TTTT----------------------
----------------------------------------------------------TT-----TT-----------------------------------------------TT-----TT--------------TT-----TT--------------------------------TT--TT--TTTTTT-------------------F--
---M------------------------------------------------------TT-----TT-----------------------------------------------TT-----TT--------------TT-----TT--------------------------------TT--TT--TTTTTT-------------------#--
XXXXXXXXXX----------------------------------------------XXXXXXXXXXXXXXXXXX--------------------------------------XXXXXXXXXXXXXXXXXXXXXXXXXXXXXXXXXXXXXXXX-X-XXXXXXX--------------XXXXXXXXXXXXXXXXXXXXXXXXXXXXXXXXXXXXXX
XXXXXXXXXX----------------------------------------------XXXXXXXXXXXXXXXXXX--------------------------------------XXXXXXXXXXXXXXXXXXXXXXXXXXXXXXXXXXXXXXXX-X-XXXXXXX--------------XXXXXXXXXXXXXXXXXXXXXXXXXXXXXXXXXXXXXX
