-------------------------------------------------------------------------------------------------------------------------------------------------------------------------------------------------------------------------------------------------------------------------------------------------------------------------------------------------------------------------------------
-------------------------------------------------------------------------------------------------------------------------------------------------------------------------------------------------------------------------------------------------------------------------------------------------------------------------------------------------------------------------------------
-------------------------------------------------------------------------------------------------------------------------------------------------------------------------------------------------------------------------------------------------------------------------------------------------------------------------------------------------------------------------------------
-------------------------------------------------------------------------------------------------------------------------------------------------------------------------------------------------------------------------------------------------------------------------------------------------------------------------------------------------------------------------------------
-------------------------------------------------------------------------------------------------------------------------------------------------------------------------------------------------------------------------------------------------------------------------------------------------------------------------------------------------------------------------------------
-------------------------------------------------------------------------------------------------------------------------------------------------------------------------------------------------------------------------------------------------------------------------------------------------------------------------------------------------------------------------------------
---------------------------------------------------------------------------------------SSSSCSSS--------------------------------------------------------------------------------------------------------------------------------------------------------------------------------------------------------------------##----------------------------------------------------------------
-------------------------------------------------------------------------------------------------------------------------------------------------------------------------------------------------------------------------------------------------------------------------------------------------------------------##----------------------------------------------------------------
-----------------------------------------------------------------------------------------------------------------------------------------------------------------------------------------------------------------------------------------------------------------------------------------------------------------#-##----------------------------------------------------------------
---------------------------------------------------------------------------------------------------------------------------------------------------------------tt------------------------------------------------------------------------------------------------------------------------o-----------------------#-##---------------------------------oo-----------------------------
--------------------------------------------------------------------------------------#----2----#----------------------------------------------------------TT--tt----------------------------------------------------------------------------------------------------------------------------------------------#-#-##----------------------------------------------------------------
--------------------------------------------------------------------------------------#------K--#------------------------------------------------------TT--TT--tt----------------------------------------------------------------------------------------------------------------------------------------------#-#-##----------------------------------------------------------------
------------------------------------------------#-------------------------------------#---------#---------------------------------------#--------------TT--TT--tt---------------------------------------------------------------------------------------------------------------------------------------TT---#-#-#-##------------------------------------------------------------F---
-M----------------------------------------------#--------------------------------ggg--#---------#---------------------------------------#---------ggg--TT--TT--tt-----k--ggg----------------------------------------------------------------------------------------------------------------------------TT---#-#-#-##------------------------------------------------------------#---
XXXXXXXXXX----------------------------------XXXXXXXXXXX---------------------XXXXXXXXXXXXXXXXXXXXXXXXXXXXXX--------------------------XXXXXXXXXXXXXXXXXX-XX--XX--XXXXXXXXXXXXXXXXXXX------------------------------------------------------------------------------------------------------XXXXXX------XXXXXXXX-X-X-X-XXXXXXXX-------------------------------------------------XXXXXXXXX
XXXXXXXXXX----------------------------------XXXXXXXXXXX---------------------XXXXXXXXXXXXXXXXXXXXXXXXXXXXXX--------------------------XXXXXXXXXXXXXXXXXX-XX--XX--XXXXXXXXXXXXXXXXXXX------------------------------------------------------------------------------------------------------XXXXXX------XXXXXXXX-X-X-X-XXXXXXXX-------------------------------------------------XXXXXXXXX
