------------------------------------------------------------------------------------------------------------------------------------------------------------------------------------------------------------
------------------------------------------------------------------------------------------------------------------------------------------------------------------------------------------------------------
------------------------------------------------------------------------------------------------------------------------------------------------------------------------------------------------------------
----------------------------------------------------------------------------------------SSSS------------------------------------------------------------------------SSSS----SSSS----------------------------
------------------------------------------------------------------------------------------------------------------------------------------------------------------------------------------------------------
------------------------------------------------------------------------------------------------------------------------------------------------------------------------------------------------------------
-----------SSSSS-------------------------Q-Q--------------------SSS----------------------------------LSSS---------------------------------------------------------------------------------------------------
------------------------------------------------------------------------------------------------------------------------SSS------------------o--------------------------------------------------------------
-------------------------------------------------------------------------------------------------g----------------------------------------------------------------------------------------------------------
-------------------------------------------------------------------------------------------------#----------------------------------------------------------------------------------------------------------
-----------------------------------------Q-Q----TT----------------------------------------------##---2-----#------------------------------------------------------------------------------------------------
------------------------------------------------TT--------------------------SSSS---------------###---------#-----------------------------------------------------------------------------------SSSSS--------
----------------------------------------------TTTT--------------------------------------------####---------#--------------------------------------------------------------------------------------------F---
-M--------------------------------------gg----TTTT-------------------------------------------#####------kk-#----------------------k---------------------------------------------------------------------#---
XXXXXXXXXX------------------------------XXXXXXXXXXXXXXXXXXXXXX--------------------------XXXXXXXXXXXXXXXXXXXXXXXXXX--------------XXXXXX--------------------------------------------------------------XXXXXXXX
XXXXXXXXXX------------------------------XXXXXXXXXXXXXXXXXXXXXX--------------------------XXXXXXXXXXXXXXXXXXXXXXXXXX--------------XXXXXX--------------------------------------------------------------XXXXXXXX
