-------------------------------------------------------------------------------------------------------------------------------------------------------------------------------------------
-------------------------------------------------------------------------------------------------------------------------------------------------------------------------------------------
-------------------------------------------------------------------------------------------------------------------------------------------------------------------------------------------
S-------SSSS--------SSSSSSSSSSSS--------SSSS------------------------SSSSSSSS--------SSSSSSSSSSSSSSSS----------------SSSS--------SSSS----SSSSSSSS----SSSSSSSSSSSSSSSSSSSSSSSSSSSS-----------
S-----------------------------------------------------------------------------------------------------------------------------------------------------------SSSSSSSSSSSSSSSSSSSS-----------
S-----------------------------------------------------------------------------------------------------------------------------------------------------------SSSSSSSSSSSSSSSSSSSS-----------
S-----------------------------------------------------------------------------------------------------------------------------------------------------------SSSSSSSSSSSSSSSSSSSS-----------
S-----------------------------------------------------------------------------------------------------------------------------------------------------------S-----------------------TT-----
S-----------------------------------------------------------------------------------------------------------------------------------------------------------S-----------------------TT-----
S-------------------------------------------------------------------------------------------------------------------------------------------------------------oooooooooooooo--------TT-----
S-----------------------------------------------------------------------------------------------------TT-----------------------------------------------------USSSSSSSSSSSSSS----#---TT----F
S-------------#---------------#-------------------------------------------------------------------TT--TT-----------------------------------------------------------------------##---TT---SS
S------------##-SSS----------##-SSS--------------------------------------------------------tt-----TT--TT----------------------------------------------------------------------###---TT---SS
S-M---------###-------------###------------------------------------------------------------tt----kTT--TT----------------------------------------------------------------kk---####--kTT---SS
XXXXXXXXXXXXXXX-----XXXXXXXXXXX----------------------------------------------------------XXXXXXXXXXXXXXX--XXXXXXXXXXXXXXXXXXXXXXXXXXXXXXXXXXXXXXXXXXXXXXXXXXXXXXXXXXXXXXXXXXXXXXXXXXXXX--XX
XXXXXXXXXXXXXXX-----XXXXXXXXXXX----------------------------------------------------------XXXXXXXXXXXXXXX--XXXXXXXXXXXXXXXXXXXXXXXXXXXXXXXXXXXXXXXXXXXXXXXXXXXXXXXXXXXXXXXXXXXXXXXXXXXXX--XX
