----------------------------------------------------------------------------------------------------------------------------------------------------------------------------------------
----------------------------------------------------------------------------------------------------------------------------------------------------------------------------------------
----------------------------------------------------------------------------------------------------------------------------------------------------------------------------------------
----------------------------------------------------------------------------------------------------------------------------------------------------------------------------------------
----------------------------------------------------------------------------------------------------------------------------------------------------------------------------------------
----------------------------------------------------------------------------------------------------------------------------------------------------------------------------------------
------------------------------------------2------------------------------------------###---------------------US-------------------------------------------------------------------------
-------------------------------------------------------------------------------------###-----------------------------------------------------------------------y------------------------
----------------------------------------------------------------------------------y--###-----------------------------------------------y---------------------#SS--o---------------------
----------------------------------------------------------------------------------#--###-----------------------------------------------XSS-?Q---------------##--------------------------
--------------2---------------------------2--------------------------------------##--###--------------------####--SSC-----------------XX-------------------###--SC--------2-------------
-------------------------------------------------------------------------------y###--###---------------y-#####-----------------------XXX------------------####--------------------------
-------------------------------------------------------------------------------####--###------------y-######------------------------XXXX-------y---------#####---SSS----------------F---
----M-------y--y------------------------y--y----------------------------------#####--###-----------#######-------------------------XXXXX---SSSSS-----y--######----------y--y--------#---
XXXXXXXXXXXXXXXXXXXXXXXXXXXXXXXXXXXXXXXXXXXXXXXXXXXXXXXXXXXXXXXXXXXXXXXXXXXXXXXXXXX--XXXXXXXX--XXXXXXXXX------XX--XXXXXXXXXXXXXXXXXXXXXX-------XX-XXXXXXXXXXXX------XXXXXXXXXXXXXXXXXXXX
XXXXXXXXXXXXXXXXXXXXXXXXXXXXXXXXXXXXXXXXXXXXXXXXXXXXXXXXXXXXXXXXXXXXXXXXXXXXXXXXXXX--XXXXXXXX--XXXXXXXXX------XX--XXXXXXXXXXXXXXXXXXXXXX-------XX-XXXXXXXXXXXX------XXXXXXXXXXXXXXXXXXXX
