------------------------------------------------------------------------------------------------------------------------------------------------------
------------------------------------------------------------------------------------------------------------------------------------------------------
------------------------------------------------------------------------------------------------------------------------------------------------------
--------------------------------oo--------------------------------------------------------------------------------------------------------------------
-------------------------------------g-g--------------------------------------------------------------------------------------------------------------
----------------------ooor---------%%%%%%%-----------R------------------------------------------------------------------------------------------------
---------------------%%%%%----------|||||------------------g----oo------------------------------------------------------------------------------------
----------------------|||-----------|||||----oo--------%%%%%%-----------------------------------------------------------------------------------------
----------------------|||-----------|||||---------------||||------------------------------------------------------------------------------------------
----------------------|||-----%%%%%-|||||---------------||||-----SS-----------------------------------------------------------------------------------
-------------------%%%%%%%%----|||--|||||---------------||||------------------------------------------------------------------------------------------
--------------------||||||-----|||--|||||---------------||||------------------------------------------------------------------------------------------
--------------------||||||--o--|||--|||||---------------||||---------------------------------------------------------------------------------------F--
-M-----------%%%%---||||||-%%%-|||--|||||---------------||||---------------------------------------------------------------------------------------#--
XXXXXXXXXXX---||----||||||--|--|||--|||||---------------||||--------------------------------------------------------------------------------XXXXXXXXXX
XXXXXXXXXXX---||----||||||--|--|||--|||||---------------||||--------------------------------------------------------------------------------XXXXXXXXXX
