-------------------------------------------------------------------------------------------------------------------------------------------------------------------------------------------------------------------------------------------------------------------------------------------------------------------------------------------------------------------------------------
-------------------------------------------------------------------------------------------------------------------------------------------------------------------------------------------------------------------------------------------------------------------------------------------------------------------------------------------------------------------------------------
-------------------------------------------------------------------------------------------------------------------------------------------------------------------------------------------------------------------------------------------------------------------------------------------------------------------------------------------------------------------------------------
-------------------------------------------------------------------------------------------------------------------------------------------------------------------------------------------------------------------------------------------------------------------------------------------------------------------------------------------------------------------------------------
-------------------------------------------------------------------------------------------------------------------------------------------------------------------------------------------------------------------------------------------------------------------------------------------------------------------------------------------------------------------------------------
--------------------------------------------------------------------------------------------oo--------------------------------------------------------------------------oo----------------------------------------------oo--------------------------------------------------------------------------------------oo-------------------------------------------------------------------
-------------------------------------------------------------------------------------------------------------------------------------------------------------------------------------------------------------------------------------------------------------------------------------------------------------------------------------------------------------------------------------
-------------------------------------------------------------------------------------------------------------------------------------------------------------------------------------------------------------------------------------------------------------------------------------------------------------------------------------------------------------------------------------
-------------------------------------------------------------------------------------------------------------------------------------------------------------------------------------------------------------------------------------------------------------------------------------------------------------------------------------------------------------------------------------
---------------------1--------o--------o-----------------------------------------------------------------------------------------------------------------------------------------------------------------------------------------------------------------------------------------------------------------------------------------------------------------------tt--------------------
-----------------TT----------------TT----------------------------------------------------------------------------------------------------------------------------------------------------------------------------------------------------------------------------------------------------------------------------------------------------------------------TT--tt--------------------
-----------------TT----TT----------TT-----------------------K----------------------------------------------------------------------------------------------------------------------------------------TT------------------------------------------------------------------------------------------------------------------------------------------------TT--TT--tt--------------------
-----------------TT----TT----------TT-------------------------------------------------------------------------------------------------------------------------------------------------------#--------TT-------------------------------------------------------------------------------------------------------------------------#----------------------TT--TT--tt----------------F---
-M---------------TT---kTT----------TT-------------------------------k-----------------------------------------------------------------------------------------------------------------------#--------TT-------------------------------------------------------------------------------------------------------------------------#-----------------ggg--TT--TT--tt-----k--ggg-----#---
XXXXXXXXXXXXXXXXXXXXXXXXXXXXXXXXXXXXXXXXXXXXXX------XXXXXX-X-XX-XX-XXXXXXXX-------------------------------------------------------------------------------------------------------------XXXXXXXXXXXXXXXXXXXXXX--------------------------------------------------------------------------------------------------------------XXXXXXXXXXX-----XXXXXXXXXX-XX--XX--XXXXXXXXXXXXXXXXXXXXXX
XXXXXXXXXXXXXXXXXXXXXXXXXXXXXXXXXXXXXXXXXXXXXX------XXXXXX-X-XX-XX-XXXXXXXX-------------------------------------------------------------------------------------------------------------XXXXXXXXXXXXXXXXXXXXXX--------------------------------------------------------------------------------------------------------------XXXXXXXXXXX-----XXXXXXXXXX-XX--XX--XXXXXXXXXXXXXXXXXXXXXX
