----------------------------------------------------------------------------------------------------------------------------------------------------------------------------------------------------
----------------------------------------------------------------------------------------------------------------------------------------------------------------------------------------------------
----------------------------------------------------------------------------------------------------------------------------------------------------------------------------------------------------
----------------------------------------------------------------------------------------------------------------------------------------------------------------------------------------------------
----------------------------------------------------------------------------------------------------------------------------------------------------------------------------------------------------
------------------------------------------------------------k---------------------------------------------------------------------------------------------------------------------------------------
-----------------------------------------------------------##----------------------------------------------------------------------------------------------------------1-------USS------------------
----------------------------------------------------------###---------------------------------------------------------------------------------------------------------------------------------------
--------------------------------------------------------k####---------------------------------------------------------------------------------------------------------------------------------------
--------------------------------------------------------#####----------------------------------------------------------------------------------------------------------ggg--------------------------
-------------------------------------------------------######----------------------------------------------------------------------------------------------------##########---#---------------------
------------------------------------------------------#######---------------------------------------------------------------------------------------------------##--------#---#---------------------
------------TT---------------------------------------########-------------------TT----------------------TT--------------TT----------TT------------------TT-----###--------#---##-----------------F--
-M------k---TT--------------------------------------#########-----------------k-TT--------------------k-TT----------k---TT--------k-TT----------------k-TT----####--------#---##--gg-------------#--
XXXXXXXXXXXXXXXXXXXXXXXXXXXXXXXXXXXXXXXXXXXXXXXXXXXXXXXXXXXXXXXXXXXXXXXXXXXXXXXXXXXXXXXXXXXXXXXXXXXXXXXXXXXXXXXXXXXXXXXXXXXXXXXXXXXXXXXXXXXXXXXXXXXXXXXXXXXXXXXXXX--------X---XXXXXXXXXXXXXXXXXXXXXX
XXXXXXXXXXXXXXXXXXXXXXXXXXXXXXXXXXXXXXXXXXXXXXXXXXXXXXXXXXXXXXXXXXXXXXXXXXXXXXXXXXXXXXXXXXXXXXXXXXXXXXXXXXXXXXXXXXXXXXXXXXXXXXXXXXXXXXXXXXXXXXXXXXXXXXXXXXXXXXXXXX--------X---XXXXXXXXXXXXXXXXXXXXXX
