----------------------------------------------------------------------------------------------------------------------------------------------------------------------------------------------------------------------
----------------------------------------------------------------------------------------------------------------------------------------------------------------------------------------------------------------------
----------------------------------------------------------------------------------------------------------------------------------------------------------------------------------------------------------------------
----------------------------------------------------------------------------------------------------------------------------------------------------------------------------------------------------------------------
-----------------------------------------------------K-----------------------K-------------------------------K--------------------------------------------------------------------------------------------------------
--------------------------g-------------------------------------------------------------------------------------------------------------------------------------------------------------------------------------------
--------------------------SSSSS----------------------##----------------------##------------------------------##-------------------------------------SSSSSSS-----------------------------------------------------------
----------------------------------------------------###---------------------###-----------------------------###-------------------------------------------------------------------------------------------------------
---------------------------------------------------####--------------------####----------------------------####-------------------------------------------------------------------------------------------------------
--------------------------------------------------#####-------------------#####---------------------------#####---------------------------g---------------------------------------------------------------------------
---------TT-------------------------------------TT#####-----------------TT#####-------------------------TT#####---------------------------SSSSS-----------------------------------------------------------------------
---------TT----------------------TT------------#TT#####----------------#TT#####------------------------#TT#####-------------------------------------------------------------------------------------------------------
---------TT---------------TT-----TT-----------##TT#####---------------##TT#####---------------TT------##TT#####-------------------------------------------------------------------------------------------TT-------F--
---M-----TT---------------TT-----TT----------###TT#####--------------###TT#####---------------TT-----###TT#####-------------------------------------------------------------------------------------------TT-------#--
XXXXXXXXXXXXXXXXXX------XXXXXXXXXXXXXXXXXXXXXXXXXXXXXXXXXXXXXXXXXXXXXXXXXXXXXXXXXXXXXX------XXXXXXXXXXXXXXXXXXXXXXXXXX----------------------------------------------------------------------------------XXXXXXXXXXXXXX
XXXXXXXXXXXXXXXXXX------XXXXXXXXXXXXXXXXXXXXXXXXXXXXXXXXXXXXXXXXXXXXXXXXXXXXXXXXXXXXXX------XXXXXXXXXXXXXXXXXXXXXXXXXX----------------------------------------------------------------------------------XXXXXXXXXXXXXX
