--------------------------------------------------------------------------------------------------------------------------------------------------------------
--------------------------------------------------------------------------------------------------------------------------------------------------------------
--------------------------------------------------------------------------------------------------------------------------------------------------------------
S-----SS--------------------------------------------------------------SS--------------------------------------------------------------------------------------
S-------------------------------------------------------------------------------------------------------------------------------------------------------------
S-------------------------------------------------------------------------------------------------------------------------------------------------------------
S-------------------------------------------------------------------------------------------------------------------------------------------------------------
S-----------------------------------------------------------------------------------------------------------------------------SS------------------------------
S-------------------------------------------------------------------------------------------------------------------------------------------------------------
S----------------------------SSSSSSU-----------------C--------------------------------------------------------------------------------------------------------
S------------------g##-------------------------#-#------------------------------------------------------------------------------------------------------------
S------------------###-----------------------#-#-#-#---#------------------------------------------------------------------------------------------------------
S----------------g####--SSS--------------g-#-#-#-#-#---#-#----------------------------------------------------------------------------------------------------
S--M-------------#####---------r--------g#-#-#-#-#-#-E-#-#--------------------------------------------------------------------------------------------------F-
XXXXXXXXXXXXXXXXXXXXXX-------XXXXXXXXXXXXXXXXXXXXXXXXXXXXXXXXXXXXXXX---XXXXXXXXXXXXXXXXXXXXXXXXX---XXXXXXXXXXXXXXXXXXXXXXXXXXXXXXXXXXXXXXXXXXXXXXXXXXXXXX--XXX
XXXXXXXXXXXXXXXXXXXXXX-------XXXXXXXXXXXXXXXXXXXXXXXXXXXXXXXXXXXXXXX---XXXXXXXXXXXXXXXXXXXXXXXXX---XXXXXXXXXXXXXXXXXXXXXXXXXXXXXXXXXXXXXXXXXXXXXXXXXXXXXX--XXX
