------------------------------------------------------------------------------------------------------------------------------------------------------------------------------------------------------
------------------------------------------------------------------------------------------------------------------------------------------------------------------------------------------------------
------------------------------------------------------------------------------------------------------------------------------------------------------------------------------------------------------
------------------------------------------------------------------------------------------------------------------------------------------------------------------------------------------------------
------------------------------------------------------------------------------------------------------------------------------------------------------------------------------------------------------
------------------------------------------------------------------------------------------------------------------------------------------------------------------------------------------------------
-------------SUS--------------------------------------------------------------------------------------------------------------------------------------------------------------------------------------
------------------------------------------------------------------------------------------------------------------------------------------------------------------------------------------------------
---------------------------------------------------TT-------------------------------------------------------------------------------------------------------------------------------------------------
---------------------------------------------------TT-------------------------------------------------------------------------------------------------------------------------------------------------
------------#####-------------------------#LSS-----##-------------------------------------------------------------------------------------------------------------------------------------------------
------------#-----------------------------#-----------------------------------------------------------------K-----------------------------------------------------------------------------------------
-----------K#-----------------------------#-----------*---TT--------------------------------------------------------------------------------------------------------------------------------------F---
-M----------#---------------------------kk#-----------*---TT---------ggg------k---ggg---------k---ggg------------------ggg-------------------ggg-------------ggg-----------ggg--------------------#---
XXXXXXXXXXXXXXX----XXXXXXXXXXXXXXXXXXXXXXXXXXXX---XXXXXXXXXXXXXXXXXXXXXXXXXXXXXXXXXXXXXXXXXXXXXXXXXXXXXXXXXXXXXXXXXXXXXXXXXXXXXXXXXXXXXXXXXXXXXXXXXXXXXXXXXXXXXXXXXXXXXXXXXXXXXXXXXXXXXXXXXXXXXXXXXXXX
XXXXXXXXXXXXXXX----XXXXXXXXXXXXXXXXXXXXXXXXXXXX---XXXXXXXXXXXXXXXXXXXXXXXXXXXXXXXXXXXXXXXXXXXXXXXXXXXXXXXXXXXXXXXXXXXXXXXXXXXXXXXXXXXXXXXXXXXXXXXXXXXXXXXXXXXXXXXXXXXXXXXXXXXXXXXXXXXXXXXXXXXXXXXXXXXX
