----------------------------------------------------------------------------------------------------------------------------------------------------------------------------------------------------------------------
----------------------------------------------------------------------------------------------------------------------------------------------------------------------------------------------------------------------
----------------------------------------------------------------------------------------------------------------------------------------------------------------------------------------------------------------------
----------------------------------------------------------------------------------------------------------------------------------------------------------------------------------------------------------------------
-------------------------------------------------------------------------------------------------K--------------------------------------------------------------------------------------------------------------------
----------------------------------------------------------------------------------------------------------------------g-----------------------------------------------------------------------------------------------
-------------------------------------------------------------------------------------------------##-------------------SSSSS-------------------------------------------------------------------------------------------
------------------------------------------------------------------------------------------------###-------------------------------------------------------------------------------------------------------------------
-----------------------------------------------------------------------------------------------####-------------------------------------------------------------------------------------------------------------------
----------------------------------------------------------------------------------------------#####-------------------------------------------------------------------------------------------------------------------
-----------------------------------------------SSS------------------------------------------TT#####----------------------------SSS-----------------------------------tt-----------------SSSSSSS-----------------------
-------------------------------------------------------------------------------------------#TT#####---------------------------------------------------------TT-------tt-----------------------------------------------
--------------------------------------TT------------------------------------------TT------##TT#####-------------------TT----------------------------------TTTT-------tt-TT--------------------------------TT-------F--
---M----------------------------------TT------------------------------------------TT-----###TT#####-------------------TT----------------------------------TTTT-------tt-TT--------------------------------TT-------#--
XXXXXXXXXX--------------------------XXXXXXXX-X-XXXXXXX--------------------------XXXXXXXXXXXXXXXXXXXXXXXXXX----------XXXXXXXX-X-XXXXXXX------------------XXXXXXXXXXXXXXXXXXXXXXXXXX----------------------XXXXXXXXXXXXXX
XXXXXXXXXX--------------------------XXXXXXXX-X-XXXXXXX--------------------------XXXXXXXXXXXXXXXXXXXXXXXXXX----------XXXXXXXX-X-XXXXXXX------------------XXXXXXXXXXXXXXXXXXXXXXXXXX----------------------XXXXXXXXXXXXXX
