----------------------------------------------------------------------------------------------------------------------------------------------------------------------------------------------------------
----------------------------------------------------------------------------------------------------------------------------------------------------------------------------------------------------------
----------------------------------------------------------------------------------------------------------------------------------------------------------------------------------------------------------
----------------------------------------------------------------------------------------------------------------------------------------------------------------------------------------------------------
----------------------------------------------------------------------------------------------------------------------------------------------------------------------------------------------------------
----------------------------------------------------------------------------------------------------------------------------------------------------------------------------------------------------------
-----------------------------------------------------------------------------------------------------------------------------------------------------------------SSS----------------##--------------------
-----------------------------------------------------------------------------------------------------------------------------------------------------------------------------------###--------------------
----------------------------------------------------------------------------------------------------------------------------------------------------------------------------------####--------------------
--------------------1-----------------------------------------------------------------------------------1------------------------------------------------------------------------#####--------------------
------------------------------------------------------------------tt------------------!------------------------------------------tt---------------------------------------------######--------------------
------------------------------------------------------------------tt-------------------------------------------------------------tt--------------------------------------------#######--------------------
------------------------------------------------------------------tt------------------------------------------------tt-----------tt---------tt-----------------------------tt-########----------------F---
---M--------------------------------------------------------------tt------------------k------g----------------------tt-------g-g-tt---------tt------------------------gg---tt#########----------------#---
XXXXXXXXXXXXX--XXXXXXXXXXXXXXXXXXXXXXXXXXXXXXXXXXXXXXXXXXXXXXXXXXXXXXXXXXXXXXXXXXXXXXXXXXXXXXXXXXXXXXXXXXXXXXXXXXXXXXXXXXXXXXXXXXXXXXXXXXXXXXXXXXXXXXXXXXXXXXXXXXXXXXXXXXXXXXXXXXXXXXXXXXXXXXXXXXXXXXXXXXX
XXXXXXXXXXXXX--XXXXXXXXXXXXXXXXXXXXXXXXXXXXXXXXXXXXXXXXXXXXXXXXXXXXXXXXXXXXXXXXXXXXXXXXXXXXXXXXXXXXXXXXXXXXXXXXXXXXXXXXXXXXXXXXXXXXXXXXXXXXXXXXXXXXXXXXXXXXXXXXXXXXXXXXXXXXXXXXXXXXXXXXXXXXXXXXXXXXXXXXXXX
