----------------------------------------------------------------------------------------------------------------------------------------------------------------------------------------------------------------------
----------------------------------------------------------------------------------------------------------------------------------------------------------------------------------------------------------------------
----------------------------------------------------------------------------------------------------------------------------------------------------------------------------------------------------------------------
----------------------------------------------------------------------------------------------------------------------------------------------------------------------------------------------------------------------
----------------------------------------------------------------------------------------------------------------------------------------------------------------------------------------------------------------------
----------------------------------------------------------------------------------------------------------------------------------------------------------------------------------------------------------------------
-----------------------------------------------------------------------US--------------------------------------------------------------------------------------------------SSS----------------------------------------
----------------------------------------------------------------------------------------------------------------------------------------------------------------------------------------------------------------------
----------------------------------------------------------------------------------------------------------------------------------------------------------------------------------------------------------------------
---------------------------------------------------------------------SS-----------------------------------------------------------------------------------------------------------------------------------------------
---------------------------------------------------------------------------SSS-----------------------------SSS-----------TT------------------------------------------------SSS-----------SSS-----------SSS------------
----------------------------------------------------------------------------------------------------------------------K--TT-------------------------------------------------------------------------------------------
--------------------------------------------------------------TT----------------------------------TT---------------------TT---TT----------------------------------TT------------------TT---------------------------F--
---M----------------------------------------------------------TT----------------------------------TT---------------------TT---TT----------------------------------TT------------------TT---------------------------#--
XXXXXXXXXXXXXXXXXXXXXX--------------------------------------XXXXXXXXXXXX-X-XXXXXXX--------------XXXXXXXX-X-XXXXXXXXXXXXXXXXXXXXXXXXXXX--------------------------XXXXXXXX-X-XXXXXXXXXXXXXXXXXXXXXXXXX-X-XXXXXXXXXXXXXXX
XXXXXXXXXXXXXXXXXXXXXX--------------------------------------XXXXXXXXXXXX-X-XXXXXXX--------------XXXXXXXX-X-XXXXXXXXXXXXXXXXXXXXXXXXXXX--------------------------XXXXXXXX-X-XXXXXXXXXXXXXXXXXXXXXXXXX-X-XXXXXXXXXXXXXXX
