---------------------------------------------------------------------------------------------------------------------------------------------------------------------------------------------------------
---------------------------------------------------------------------------------------------------------------------------------------------------------------------------------------------------------
---------------------------------------------------------------------------------------------------------------------------------------------------------------------------------------------------------
----------------------------------------------------------------------------------------SSSS----------------SSSS-----------------------------------------------------------------------------------------
---------------------------------------------------------------------------------------------------------------------------------------------------------------------------------------------------------
---------------------------------------------------------------------------------------------------------------------------------------------------------------------------------------------------------
-------------SSS---------------------SSS-------##---------------------------------------------------##-----------------------------------------------------SSSS------------------------------------------
----------------------------------------------###---------------SSSS----SSSS-----------------------###-------------------------------------------------------------------K-------------------------------
--------------------------------------------k####-------------------------------------------------####---------------------------------------------------------------------------------------------------
--------------------------------------------#####----------------o-------------------------------#####-------------------------------SSS-----------------------------------------------------------------
-------------------------------------------######-----------------------------------------------######---------------------------------------------------------------------------------------------------
------------------------------------------#######----------------------------------------------#######---------------------------------------------------------------------------------------------------
-----------------------------------------########------------------------------------------tt-######---------------------------------------------------------------------------------------------------F-
-M---r-----------------------------kk---#########-------------------------gg--------g------tt#######---------------------------------------------------------------------------------------------------#-
XXXXXXXXXXX---------------------XXXXXXXXXXXXXXXXXXXXXXX-----------------XXXXXX------XXXXXXXXXXXXXXXXXXXXXX------------------XXXXXX------------------------------------------XXXXXXX-------------XXXXXXXXX
XXXXXXXXXXX---------------------XXXXXXXXXXXXXXXXXXXXXXX-----------------XXXXXX------XXXXXXXXXXXXXXXXXXXXXX------------------XXXXXX------------------------------------------XXXXXXX-------------XXXXXXXXX
