----------------------------------------------------------------------------------------------------------------------------------------------------------------------------------------
----------------------------------------------------------------------------------------------------------------------------------------------------------------------------------------
----------------------------------------------------------------------------------------------------------------------------------------------------------------------------------------
----------------------------------------------------------------------------------------------------------------------------------------------------------------------------------------
----------------------------------------------------------------------------------------------------------------------------------------------------------------------------------------
----------------------------------------------------------------------------------------------------------------------------------------------------------------------------------------
--------------2--------------------------------------------------------------------------------------------------###--------------------------------------------------------------------
-----------------------------------------------------------------------------------------------------------------###-----------------------------------------------y--------------------
--------------------------------------------------------------------------------------------------------------y--###-----------------------y---------------------#SS--o-----------------
--------------------------------------------------------------------------------------------------------------#--###-----------------------XSS-?Q---------------##----------------------
--------------2----------------------------------------------------------------------------------------------##--###----------------------XX-------------------###--SC------------------
-----------------------------------------------------------------------------------------------------------y###--###---------------------XXX------------------####----------------------
-----------------------------------------------------------------------------------------------------------####--###--------------------XXXX-------y---------#####---SSS------------F---
----M-------y--y------------------------------------------------------------------------y-y---------------#####--###-------------------XXXXX---SSSSS-----y--######------------------#---
XXXXXXXXXXXXXXXXXXXXXXXXXXXXXXXXXXXXXXXXXXXXXXXXXXXXXXXXXXXXXXXXXXXXXXXXXXXXXXXXXXXXXXXXXXXXXX--XXXXXXXXXXXXXXX--XXXXXXXXXXXXXXXXXXXXXXXXXXX-------XX-XXXXXXXXXXXX------XXXXXXXXXXXXXXXX
XXXXXXXXXXXXXXXXXXXXXXXXXXXXXXXXXXXXXXXXXXXXXXXXXXXXXXXXXXXXXXXXXXXXXXXXXXXXXXXXXXXXXXXXXXXXXX--XXXXXXXXXXXXXXX--XXXXXXXXXXXXXXXXXXXXXXXXXXX-------XX-XXXXXXXXXXXX------XXXXXXXXXXXXXXXX
