----------------------------------------------------------------------------------------------------------------------------------------------------------------------------------------------------
----------------------------------------------------------------------------------------------------------------------------------------------------------------------------------------------------
----------------------------------------------------------------------------------------------------------------------------------------------------------------------------------------------------
----------------------------------------------------------------------------------------------------------------------------------------------------------------------------------------------------
----------------------------------------------------------------------------------------------------------------------------------------------------------------------------------------------------
----------------------------------------------------------------------------------------------------------------------------------------------------------------------------------------------------
---------------------------------------1-------USS-------------------------------------------------------------------------------------------------------------1-------USS--------------------------
----------------------------------------------------------------------------------------------------------------------------------------------------------------------------------------------------
----------------------------------------------------------------------------------------------------------------------------------------------------------------------------------------------------
---------------------------------------ggg---------------------------------------------------------------------------------------------------------------------ggg----------------------------------
---------------------------------##########---#----------------------------------------------------------------------------------------------------------##########---#-----------------------------
--------------------------------##--------#---#---------------------------------------------------------------------------------------------------------##--------#---#-----------------------------
------------------------TT-----###--------#---##------------------------------------TT--------------TT------------------TT----------------------TT-----###--------#---##-------------------------F--
-M------------------k---TT----####--------#---##--gg------------------------------k-TT------------k-TT--------------k---TT------------------k---TT----####--------#---##--gg---------------------#--
XXXXXXXXXXXXXXXXXXXXXXXXXXXXXXXXXX--------X---XXXXXXXXXXXXXXXXXXXXXXXXXXXXXXXXXXXXXXXXXXXXXXXXXXXXXXXXXXXXXXXXXXXXXXXXXXXXXXXXXXXXXXXXXXXXXXXXXXXXXXXXXXXX--------X---XXXXXXXXXXXXXXXXXXXXXXXXXXXXXX
XXXXXXXXXXXXXXXXXXXXXXXXXXXXXXXXXX--------X---XXXXXXXXXXXXXXXXXXXXXXXXXXXXXXXXXXXXXXXXXXXXXXXXXXXXXXXXXXXXXXXXXXXXXXXXXXXXXXXXXXXXXXXXXXXXXXXXXXXXXXXXXXXX--------X---XXXXXXXXXXXXXXXXXXXXXXXXXXXXXX
