----------------------------------------------------------------------------------------------------------------------------------------------------------------------------------------------------
----------------------------------------------------------------------------------------------------------------------------------------------------------------------------------------------------
----------------------------------------------------------------------------------------------------------------------------------------------------------------------------------------------------
----------------------------------------------------------------------------------------------------------------------------------------------------------------------------------------------------
----------------------------------------------------------------------------------------------------------------------------------------------------------------------------------------------------
--------------------------------------------------------------------------------------------k-------------------------------------------------------------------------------------------------------
--------SSQSSS?SSS-------------------------------------------------------------------------##-------------------------------------------------------------------------------------------------------
------------------------------------------------------------------------------------------###-------------------------------------------------------------------------------------------------------
----------------------------------------------------------------------------------------k####-------------------------------------------------------------------------------------------------------
----------K-----------------------------------------------------------------------------#####-------------------------------------------------------------------------------------------------------
--------SSSSSSSSSSS--------------------------------------------------------------------######-------------------------------TT--------------TT------------------------------------------------------
--------------------------------------------------------------------------------------#######-------------------------------TT--------------TT------------------------------------------------------
-------------------------------------------------------------------------------------########-------------------------------TT--------------TT------------------TT-------------------------------F--
-M--------------K-------------------------------------------------------------------#########---------------------------k---TT----------k---TT--------------k---TT-------------------------------#--
XXXXXXXXXXXXXXXXXXXXXXXXXXXXXXXXXXXXXXXXXXXXXXXXXXXXXXXXXXXXXXXXXXXXXXXXXXXXXXXXXXXXXXXXXXXXXXXXXXXXXXXXXXXXXXXXXXXXXXXXXXXXXXXXXXXXXXXXXXXXXXXXXXXXXXXXXXXXXXXXXXXXXXXXXXXXXXXXXXXXXXXXXXXXXXXXXXXX
XXXXXXXXXXXXXXXXXXXXXXXXXXXXXXXXXXXXXXXXXXXXXXXXXXXXXXXXXXXXXXXXXXXXXXXXXXXXXXXXXXXXXXXXXXXXXXXXXXXXXXXXXXXXXXXXXXXXXXXXXXXXXXXXXXXXXXXXXXXXXXXXXXXXXXXXXXXXXXXXXXXXXXXXXXXXXXXXXXXXXXXXXXXXXXXXXXXX
