---------------------------------------------------------------------------------------------------------------------------------------------------------------------
---------------------------------------------------------------------------------------------------------------------------------------------------------------------
---------------------------------------------------------------------------------------------------------------------------------------------------------------------
---------------------------------------------------------------------------------------------------------------------------------------------------------------------
-----------------------------------------oo----------------------------------------------------------------------------------------------------------oo--------------
---------------------------------------------------------------------------------------------------------------------------------------------------------------------
-------------------------------------------%%%%---------------------------------------SS---------------------------------------------------------------%%%%----------
------------------------------------SSS-----||--------------------------------------------------------------------------------------------------SSS-----||-----------
--------------------------------------------||-------------------------------------------------------------------------------------------oo-------------||-----------
--------------------------------------------||----------------------------------------------------------------------------------------------------------||-----------
----------------%%%%------SS----------------||--------------%%%%--------------------------SS-----------------------------------------------%%%%---------||-----------
-----------------||-------------------------||---------------||---------------------------------------------------------------------SSS-----||----------||-----------
-----------------||-------------------------||---------------||-----------------------------------------------------------------------------||----------||---------F-
-M---------------||-------------------------||---------------||-----------------------------------------------------------------------------||----------||---------X-
XXXXXXXXXXX--%%%%||%%%%---------------------||-XXXXXXXX--%%%%||%%%%-----------------------------------------------%%%%%---------------------||----------||-XXXXXXXXXX
XXXXXXXXXXX---||-||-||----------------------||-XXXXXXXX---||-||-||-------------------------------------------------|||----------------------||----------||-XXXXXXXXXX
