--------------------------------------------------------------------------------------------------------------------------------------------------------------
--------------------------------------------------------------------------------------------------------------------------------------------------------------
--------------------------------------------------------------------------------------------------------------------------------------------------------------
S-----SS--------------------------------------------------------------------------SS--------------------------------------------------------------------------
S-------------------------------------------------------------------------------------------------------------------------------------------------------------
S-------------------------------------------------------------------------------------------------------------------------------------------------------------
S-------------------------------------------------------------------------------------------------------------------------------------------------------------
S-------------------------------------------------------------------------------------------------------------------------------------------------------------
S-------------------------------------------------------------------------------------------------------------------------------------------------------------
S-------------------------------------------------------------------------------------------------------------------------------------------------------------
S-------------------------------------------------------------------------------------------------------------------------------------------------------------
S-------------------------------------------------------------------------------------------------------------------------------------------------------------
S-------------------------------------------------------------------------------------------------------------------------------------------------------------
S--M--------------------------------------------------------------------------------------------------------------------------------------------------------F-
XXXXXXXXXXXX---XXXXXXXXXXXXXXXXXXXXXXXXXXXXXXXXXXXXXXXXXXXXXXXXXXXXX---XXXXXXXXXXXXXXXXXXXXX---XXXXXXXXXXXXXXXXXXXXXXXXXXXXXXXXXXXXXXXXXXXXXXXXXXXXXXXXXX--XXX
XXXXXXXXXXXX---XXXXXXXXXXXXXXXXXXXXXXXXXXXXXXXXXXXXXXXXXXXXXXXXXXXXX---XXXXXXXXXXXXXXXXXXXXX---XXXXXXXXXXXXXXXXXXXXXXXXXXXXXXXXXXXXXXXXXXXXXXXXXXXXXXXXXX--XXX
