------------------------------------------------------------------------------------------------------------------------------------------------------------------------------------------------------------------------------
------------------------------------------------------------------------------------------------------------------------------------------------------------------------------------------------------------------------------
------------------------------------------------------------------------------------------------------------------------------------------------------------------------------------------------------------------------------
------------------------------------------------------------------------------------------------------------------------------------------------------------------------------------------------------------------------------
------------------------------------------------------------------------------------------------------------------------------------------------------------------------------------------------------------------------------
------------------------------------------------------------------------------------------------------------------------------------------------------------y-----------------------------------------------------------------
------------------------------------------------------------------------------------------------------------------------------------------------------------##---------------Q-Q----------------------------------------------
------------------------------------------------------------oooo------------------------------------------------------------------------------------------y###----------------------------------------------------------------
----------------------------------------------------------------------------------------------------------------------------------------------------------####----------------------------------------------------------------
---------------------------------------------------------------------------------------------------------------------------------------------------------#####----------------------------------------------------------------
---------------------------------------------------------------------------------------------------------------------------------------------Q-Q--------######---C-----------Q-Q----------------------------------------------
-------------------------------------------------------------------------------------------------------------------------------------------------------#######----------------------------------------------------------------
------------------------------------------------------------------------------------------------------------------------------------------------------########--------------------------TT--------------------------------F---
-M--------y------------------------y-------------------------------------y--------y--------y---------------------------------------------------------#########------------y-------y-----TT-----------y-----------y--------#---
XXXXXXXXXXXXXXXXXXXXXXXXXXXXXXXXXXXXXXXXXXXXXXXXXXXXXXXXXXXXXXXXXXXXXXXXXXXXXXXXXXXXXXXXXXXXXXXXXXXXXXXXX--XXXXXXXXXXXXXXXXXXXXXXXXXXXXXXXXXXXXXXXXXXXXXXXXXXXXXXXXXXXXXXXXXXXXXXXXXXXXXXXXXXXXXXXXXXXXXXXXXXXXXXXXXXXXXXXXXXX
XXXXXXXXXXXXXXXXXXXXXXXXXXXXXXXXXXXXXXXXXXXXXXXXXXXXXXXXXXXXXXXXXXXXXXXXXXXXXXXXXXXXXXXXXXXXXXXXXXXXXXXXX--XXXXXXXXXXXXXXXXXXXXXXXXXXXXXXXXXXXXXXXXXXXXXXXXXXXXXXXXXXXXXXXXXXXXXXXXXXXXXXXXXXXXXXXXXXXXXXXXXXXXXXXXXXXXXXXXXXX
