-----------------------------------------------------------------------------------------------------------------------------------------------------------------------------------------------------
-----------------------------------------------------------------------------------------------------------------------------------------------------------------------------------------------------
-----------------------------------------------------------------------------------------------------------------------------------------------------------------------------------------------------
-----------------------------------------------------------------------------------------------------------------------------------------------------------------------------------------------------
-----------------------------------XX--------------------------XX------------------------------------------------------------------------------------------------------------------------------------
-----------------------------------XX--------------------------XX------------------------------------------------------------------------------------------------------------------------------------
-------------------------------C---XX----------------------C---XX------------------------------------------------------------------------------------------------------------------------------------
-----------------------------------XX--------------------------XX------------------------------------------------------------------------------------------------------------------------------------
-----------------------------------XX--------------------------XX--------------------------------------XX--------------------------------------------------------------------------------------------
-----------------------------------XX--------------------------XX--------------------------------------XX-------------------------------------------------------g------------------------------------
------------------------------SS---XX---------------------SS---XX---------------------------------SS---XX-------------------------------------------------------TT-----------------------------------
-----------------------------------XX--------------------------XX--------------------------------------XX-------------------------------------------------------TT-----------------------------------
-----------------------------------XX--------------------------XX--------------------------------------XX-------------------------------------------------------TT-------------------------------F---
--M------------------gg--------k---XX----------------------k---XX--------------------gg------------k---XX--------gg------------------gg------gg-----------------TT-------------------------------X---
XXXXXXXXXXXXXXXXXXXXXXXXXXXXXXXXXXXXXXXXXXXXXXXXXXXXXXXXXXXXXXXXXXXXXXXXXXXXXXXXXXXXXXXXXXXXXXXXXXXXXXXXXXXXXXXXXXXXXXXXXXXXXXXXXXXXXXXXXXXXXXXXXXXXXXXXXXXXXXXXXXX---XXXXXXXXXXXXXXXXXXXXXXXXXXXXXXX
XXXXXXXXXXXXXXXXXXXXXXXXXXXXXXXXXXXXXXXXXXXXXXXXXXXXXXXXXXXXXXXXXXXXXXXXXXXXXXXXXXXXXXXXXXXXXXXXXXXXXXXXXXXXXXXXXXXXXXXXXXXXXXXXXXXXXXXXXXXXXXXXXXXXXXXXXXXXXXXXXXX---XXXXXXXXXXXXXXXXXXXXXXXXXXXXXXX
