----------------------------------------------------------------------------------------------------------------------------------------------------------------------------------------------------------------------
----------------------------------------------------------------------------------------------------------------------------------------------------------------------------------------------------------------------
----------------------------------------------------------------------------------------------------------------------------------------------------------------------------------------------------------------------
----------------------------------------------------------------------------------------------------------------------------------------------------------------------------------------------------------------------
----------------------------------------------------------------------------------------------------------------------------------------------------------------------------------------------------------------------
----------------------------------------------------------------------------------------------------------------------------------------------------------------------------------------------------------------------
--------SSSSSSS--------------------------------------------------------------------SSS-------------------------------------SSS----------------------------------------------------------------------------------------
------------------------------------------------------------------TT--------------------------------------------------------------------------------------------------------------------------------------------------
------------------------------------------------------------------TT--------------------------------------------------------------------------------------------------------------------------------------------------
------------------------------------------------------------------TT--------------------------------------------------------------------------------------------------------------------------------------------------
-----------------------------------------------------------------SXXS--------------SSS-------------SSS---------------------SSS-------TT------------------------------------------------SSS----------------------------
-------------------------------------------------------------------------------------------------------------------------------------TT-------------------------------------------------------------------------------
------------------------------------------------------TT--------------TTTT----------------------------------------TT-----------------TT-------------------------------TT----------------------------------TT-------F--
---M--------------------------------------------------TT--------------TTTT----------------------------------------TT-----------------TT-------------------------------TT----------------------------------TT-------#--
XXXXXXXXXX------------------------------------------XXXXXXXXXXXXXXXXXXXXXXXXXXXX-X-XXXXXXXXXXXXX-X-XXXXXXX------XXXXXXXX-X-XXXXXXXXXXXXXXXXXXX----------------------XXXXXXXXXXXXXXXX-X-XXXXXXX----------XXXXXXXXXXXXXX
XXXXXXXXXX------------------------------------------XXXXXXXXXXXXXXXXXXXXXXXXXXXX-X-XXXXXXXXXXXXX-X-XXXXXXX------XXXXXXXX-X-XXXXXXXXXXXXXXXXXXX----------------------XXXXXXXXXXXXXXXX-X-XXXXXXX----------XXXXXXXXXXXXXX
