------------------------------------------------------------------------------------------------------------------------------------------------------------------------------------------------------
------------------------------------------------------------------------------------------------------------------------------------------------------------------------------------------------------
------------------------------------------------------------------------------------------------------------------------------------------------------------------------------------------------------
------------------------------------------------------------------------------------------------------------------------------------------------------------------------------------------------------
------------------------------------------------------------------------------------------------------------------------------------------------------------------------------------------------------
------------------------------------------------------------------------------------------------------------------------------------------------------------------------------------------------------
------------------------##----------------------------------------------------------------------------------##---------------------------SUS----------------------------------------------------------
------------------------##----------------------------------------------------------------------------------##----------------------------------------------------------------------------------------
------------------------##----------------------------------------------------------------------------------##----------------------------------------------------------------------------------------
-----------------K---#--##---------------------------------------------------------------------------K---#--##----------------------------------------------------------------------------------------
--------------------##--##------------------------------------------------------------------------------##--##--------------------------#####---------------------------------------------------------
-------------------###--##-----------------------------------------------------------------------------###--##--------------------------#-------------------------------------------------------------
------------------####--------------------------------------------------------------------------------####-----------------------------K#---------------------------------------------------------F---
-M---------------#####------------------------------ggg--k----ggg---------------ggg--k----ggg--------#####------------------------------#----------------------------------ggg--------------------#---
XXXXXXXXXXXXXXXXXXXXXXXXXXXXXXXXXXXXXXXXXXXXXXXXXXXXXXXXXXXXXXXXXXXXXXXXXXXXXXXXXXXXXXXXXXXXXXXXXXXXXXXXXXXXXXXXXXXXXXXXXXXXXXXXXXXXXXXXXXX----XXXXXXXXXXXXXXXXXXXXXXXXXXXXXXXXXXXXXXXXXXXXXXXXXXXXXXX
XXXXXXXXXXXXXXXXXXXXXXXXXXXXXXXXXXXXXXXXXXXXXXXXXXXXXXXXXXXXXXXXXXXXXXXXXXXXXXXXXXXXXXXXXXXXXXXXXXXXXXXXXXXXXXXXXXXXXXXXXXXXXXXXXXXXXXXXXXX----XXXXXXXXXXXXXXXXXXXXXXXXXXXXXXXXXXXXXXXXXXXXXXXXXXXXXXX
