-------------------------------------------------------------------------------------------------------------------------------------------------------------------------------------------
-------------------------------------------------------------------------------------------------------------------------------------------------------------------------------------------
-------------------------------------------------------------------------------------------------------------------------------------------------------------------------------------------
S-----------SSSS----SSSSSSSSSSSSSSSSSSSSSSSSSSSSSSSSSSSS----SSSS----------------SSSSSSSSSSSSSSSSSSSSSSSSSSSSSSSSSSSS------------SSSS--------SSSSS-----------SSSSSSSSSSSSSSSSSSSSSSSSSSSS---
S---------------------------SSSSSSSSSSSSSSSSSSSSSSSSSSSS------------------------SSSSSSSSSSSSSSSSSSSSSSSSSSSSSSSSSSSS----------------------------------------SSSSSSSSSSSSSSSSSSSS-----------
S---------------------------SSSSSSSSSSSSSSSSSSSSSSSCSSSS------------------------SSSSSSSSSSSSSSSSSSSSSSSSSSSSSSSCSSSS----------------------------------------SSSSSSSSSSSSSSSSSSSS-----------
S---------------------------SSSSSSSSSSSSSSSSSSSSSSSSSSSS------------------------SSSSSSSSSSSSSSSSSSSSSSSSSSSSSSSSSSSS----------------------------------------SSSSSSSSSSSSSSSSSSSS-----------
S-----------------------------------------------------------------------------------------------------------------------------------------------------------S-----------------------TT-----
S-----------------------------------------------------------------------------------------------------------------------------------------------------------S-----------------------TT-----
S--------------------------------------------------ggg---------------------------------------------------------ggg--------------------------------------------oooooooooooooo--------TT-----
S-----------------------------SSSSSS?-SSSSSSSSSSSSSSSSSS--QQ----------------------SSSSSS?-SSSSSSSSSSSSSSSSSSSSSSSSSS--QQ-------------------------------------USSSSSSSSSSSSSS----#---TT----F
S-----------------------------SSSSS---SSSSSSSSSSSSSSSSSS--------------------------SSSSS---SSSSSSSSSSSSSSSSSSSSSSSSSS-----------------------------------------------------------##---TT---SS
S-----------------------------SSSSS---SSSSSSSSSSSSSSSSSS--------------------------SSSSS---SSSSSSSSSSSSSSSSSSSSSSSSSS----------------------------------------------------------###---TT---SS
S-M--------------------------------oooSSSSSSSSSSSSSSSSSS-------------------------------oooSSSSSSSSSSSSSSSSSSSSSSSSSS----------------------------------------------------kk---####--kTT---SS
XXXXXXXXXXXXXXXXXXX--XX--X---XXXXXXXXXXXXXXXXXXXXXXXXXXXXXXXXXXXXXXXXXX--XX--X---XXXXXXXXXXXXXXXXXXXXXXXXXXXXXXXXXXXXXXXXXXXXXXXXXXXXXXXXXXXXXXXXXXXXXXXXXXXXXXXXXXXXXXXXXXXXXXXXXXXXXX--XX
XXXXXXXXXXXXXXXXXXX--XX--X---XXXXXXXXXXXXXXXXXXXXXXXXXXXXXXXXXXXXXXXXXX--XX--X---XXXXXXXXXXXXXXXXXXXXXXXXXXXXXXXXXXXXXXXXXXXXXXXXXXXXXXXXXXXXXXXXXXXXXXXXXXXXXXXXXXXXXXXXXXXXXXXXXXXXXX--XX
