----------------------------------------------------------------------------------------------------------------------------------------------------------------------------------------------------------
----------------------------------------------------------------------------------------------------------------------------------------------------------------------------------------------------------
----------------------------------------------------------------------------------------------------------------------------------------------------------------------------------------------------------
----------------------------------------------------------------------------------------------------------------------------------------------------------------------------------------------------------
----------------------------------------------------------------------------------------------------------------------------------------------------------------------------------------------------------
----------------------------------------------------------------------------------------------------------------------------------------------------------------------------------------------------------
----------------------------------------------------------------##----------------------------------------------------------------------------------------------------------------------------------------
---------------------------------------------------------------###----------------------------------------------------------------------------------------------------------------------------------------
--------------------------------------------------------------####----------------------------------------------------------------------------------------------------------------------------------------
-------------------------------------------------------------#####----------------------------------------------------------------------------------------------------------------------------------------
------------------------------------------------------------######----------------------------------------------------------------------------------------------------------------tt----SS!S--------------
-----------------------------------------------------------#######----------------------------------------------------------------------------------------------------------------tt----------------------
-------------------------------------------------------tt-########----------------------------------tt-------------------------tt------------------------------tt-----------------tt------------------F---
---M-----------------------------g-------g--------gg---tt#########-----------------------g----------tt-------g------------gg---tt-------------------------gg---tt-----------------tt---------g--------#---
XXXXXXXXXXXXXXXXXXXXXXXXXXXXXXXXXXXXXXXXXXXXXXXXXXXXXXXXXXXXXXXXXXXXXXXXXXXXXXXXXXXXXXXXXXXXXXXXXXXXXXXXXXXXXXXXXXXXXXXXXXXXXXXXXXXXXXXXXXXXXXXXXXXXXXXXXXXXXXXXXXXXXXXXXXXXXXXXXXXXXXXXXXXXXXXXXXXXXXXXXX
XXXXXXXXXXXXXXXXXXXXXXXXXXXXXXXXXXXXXXXXXXXXXXXXXXXXXXXXXXXXXXXXXXXXXXXXXXXXXXXXXXXXXXXXXXXXXXXXXXXXXXXXXXXXXXXXXXXXXXXXXXXXXXXXXXXXXXXXXXXXXXXXXXXXXXXXXXXXXXXXXXXXXXXXXXXXXXXXXXXXXXXXXXXXXXXXXXXXXXXXXX
