----------------------------------------------------------------------------------------------------------------------------------------------------------------------------------------------------------------------
----------------------------------------------------------------------------------------------------------------------------------------------------------------------------------------------------------------------
----------------------------------------------------------------------------------------------------------------------------------------------------------------------------------------------------------------------
----------------------------------------------------------------------------------------------------------------------------------------------------------------------------------------------------------------------
----------------------------------------------------------------------------------------------------------------------------------------------------------------------------------------------------------------------
--------------------------------------------------------------------------------------------------------------------------------------g-------------------------------------------------------------------------------
--------------------------SCS-----------------------------------SSSSSSS---------------------------------------------------------------SSSSS--------------------SSS----------------------------------------------------
-----------------------------------TT---------------------------------------------------------------------------------------------------------------------------------------------------------------------------------
-----------------------------------TT---------------------------------------------------------------------------------------------------------------------------------------------------------------------------------
-----------------------------------XX---------------------------------------------------------------------------------------------------------------------------------------------------------------------------------
----------------------TT---2---TT---------------SSSSSSS--------------------------------------------------------------------------------------SSS---------------SSS----------------------------------------------------
----------------------TT-------TT-------------------------------------------------------------------------------------------------------------------------------------------------------------------------------------
----------------------TT-------TT-----TT------------------------------------------------------TT------------------------------------------TT------TT----------------------------------------------TTTT-------------F--
---M------------------TT----k--TT-----TT------------------------------------------------------TT------------------------------------------TT------TT----------------------------------------------TTTT-------------#--
XXXXXXXXXX----------XXXXXXXXXXXXXXXXXXXXXXXXXX----------------------------------------------XXXXXXXXXX----------------------------------XXXXXXXXXXXXXXXXXXXX-X-XXXXXXX--------------------------XXXXXXXXXXXXXXXXXXXXXX
XXXXXXXXXX----------XXXXXXXXXXXXXXXXXXXXXXXXXX----------------------------------------------XXXXXXXXXX----------------------------------XXXXXXXXXXXXXXXXXXXX-X-XXXXXXX--------------------------XXXXXXXXXXXXXXXXXXXXXX
