------------------------------------------------------------------------------------------------------------------------------------------------------------------------------------------------------------------------------
------------------------------------------------------------------------------------------------------------------------------------------------------------------------------------------------------------------------------
------------------------------------------------------------------------------------------------------------------------------------------------------------------------------------------------------------------------------
------------------------------------------------------------------------------------------------------------------------------------------------------------------------------------------------------------------------------
------------------------------------------------------------------------------------------------------------------------------------------------------------------------------------------------------------------------------
----------------------------------------------------------------------------------------y-------------------------------------------------------------------------------------------------------------------------------------
-----------------1----------------------------------------------------------------------##----------------------------------------------------Q------------------------------QQQQ---------------------------------------------
--------------------------------------------------------------------------------------y###------------------------------------------------------------------------------------------------------------------------------------
--------------------------------------------------------------------------------------####------------------------------------------------------------------------------------------------------------------------------------
-------------------------------------------------------------------------------------#####-------------------------------------------------------------------------------------y----------------------------------------------
---------------QQQQ-----------------------------------------------------------------######---C------------------------------------------------?----------------------------QQ?SSQQQ-------------------------------------------
-----------------------------------------------------------------------------------#######------------------------------------------------TT----------------------------------------------------------------------------------
------------------------------------------------------------------------TT--------########------------------------------------------------TT------------------------------------------------------------------------------F---
-M----------------------------------------------------------------------TT-------#########------------------------------------y-----------TT-------------y------------------------------------y---------------------------#---
XXXXXXXXXXXXXXXXXXXXXXXXXXXXXXXXXXXXXXXXXXXXXXXXXXXXXXXXXXXXXXXXXXXXXXXXXXXXXXXXXXXXXXXXXXXXXXXXXXX----XXXXXXXXXXXXXXXXXXXXXXXXXXXXXXXXXXXXXXXXXXXXXXXXXXXXXXXXXXXXXXXXXXXXXXX--XXXXXXXXXXXXXXXXXXXXXXXXXXXXXX--XXXXXXXXXXXXXX
XXXXXXXXXXXXXXXXXXXXXXXXXXXXXXXXXXXXXXXXXXXXXXXXXXXXXXXXXXXXXXXXXXXXXXXXXXXXXXXXXXXXXXXXXXXXXXXXXXX----XXXXXXXXXXXXXXXXXXXXXXXXXXXXXXXXXXXXXXXXXXXXXXXXXXXXXXXXXXXXXXXXXXXXXXX--XXXXXXXXXXXXXXXXXXXXXXXXXXXXXX--XXXXXXXXXXXXXX
