----------------------------------------------------------------------------------------------------------------------------------------------------------------------------------------
----------------------------------------------------------------------------------------------------------------------------------------------------------------------------------------
----------------------------------------------------------------------------------------------------------------------------------------------------------------------------------------
----------------------------------------------------------------------------------------------------------------------------------------------------------------------------------------
----------------------------------------------------------------------------------------------------------------------------------------------------------------------------------------
----------------------------------------------------------------------------------------------------------------------------------------------------------------------------------------
----------------------2----------------------------------------------------------------------------------------------------------US-----------------------------------------------------
-----------------------------------------------------------------------y----------------------------------------------------------------------------------------------------------------
-----------------------------------------------y---------------------#SS--o-------------------------------------------------------------------------------------------------------------
-----------------------------------------------XSS-?Q---------------##------------------------------------------------------------------------------------------------------------------
----------------------2-----------------------XX-------------------###--SC------------------------------------------------------####--SSC-----------------------------------------------
---------------------------------------------XXX------------------####-----------------------------------------------------y-#####------------------------------------------------------
--------------------------------------------XXXX-------y---------#####---SSS--------------------------------------------y-######----------------------------------------------------F---
----M---------------y--y-------------------XXXXX---SSSSS-----y--######-------------------------------------------------#######----------------------y-y-----------------------------#---
XXXXXXXXXXXXXXXXXXXXXXXXXXXXXXXXXXXXXXXXXXXXXXXX-------XX-XXXXXXXXXXXX------XXXXXXXXXXXXXXXXXXXXXXXXXXXXXXXXXXXXX--XXXXXXXXX------XX--XXXXXXXXXXXXXXXXXXXX--XXXXXXXXXXXXXXXXXXXXXXXXXXXX
XXXXXXXXXXXXXXXXXXXXXXXXXXXXXXXXXXXXXXXXXXXXXXXX-------XX-XXXXXXXXXXXX------XXXXXXXXXXXXXXXXXXXXXXXXXXXXXXXXXXXXX--XXXXXXXXX------XX--XXXXXXXXXXXXXXXXXXXX--XXXXXXXXXXXXXXXXXXXXXXXXXXXX
