--------------------------------------------------------------------------------------------------------------------------------------------------------------------------------
--------------------------------------------------------------------------------------------------------------------------------------------------------------------------------
--------------------------------------------------------------------------------------------------------------------------------------------------------------------------------
--------------------------------------------------------------------------------------------------------------------------------------------------------------------------------
--------------------------------------------------------------------------------------------------------------------------------------------------------------------------------
------------------------------------------------------------------k-------------------------------------------------------------------------------------------------------------
------------------------------------------------------------------##------------------------------------SSSS--------------------SSSS--------------------------------------------
-----------------------------------------------------------------###------------------------------------------------------------------------------------------------------------
----------------------------------------------------------------####------------------------------------------------------------------------------------------------------------
---------------------------------------------------------------#####------------------------------------K-------------SS--------K-------------SS--------------------------------
--------------------------------------------------------------######-----------------------------------SSSSS-------------------SSSSS--------------------------------------------
-------------------------------------------------------------#######-------------------------K---B--------K---#----B--------------K---#----B------------------------------------
---------------------------------------------B-------------#########-----------------------------b------------#----b------------------#----b-------------------------B------F---
-M-------------------------------------------b------------##########-----------------------------B------------#----B------------------#----B-------------------------b------#---
XXXXXXXXXXXXXXXXXXXXXXXXXXXXXXXXXXXXXXXXXXXXXXXXXXXXXXXXX-XXXXXXXXXXXXXXXXXXXXXXXXXXXXXXXXXXXXXXXXXXXXXXXXXXXXXXXXXXXXXXXXXXXXXXXXXXXXXXXXXXXXXXXXXXXXXXXXXXXXXXXXXXXXXXXXXXXXXX
XXXXXXXXXXXXXXXXXXXXXXXXXXXXXXXXXXXXXXXXXXXXXXXXXXXXXXXXX-XXXXXXXXXXXXXXXXXXXXXXXXXXXXXXXXXXXXXXXXXXXXXXXXXXXXXXXXXXXXXXXXXXXXXXXXXXXXXXXXXXXXXXXXXXXXXXXXXXXXXXXXXXXXXXXXXXXXXX
