--------------------------------------------------------------------------------------------------------------------------------------------------------------
--------------------------------------------------------------------------------------------------------------------------------------------------------------
--------------------------------------------------------------------------------------------------------------------------------------------------------------
S-----SSSSSSSSSSSSSSSSSSSSSSSLSSSSSSSSSSSSSSSSSSSSSSSSSSSSSSSSSSSSSSSSSSSSSSSS----------------------------------------------------------------SS--------------
S-------------------------------------------------------------------------------------------------------------------------------------------------------------
S-------------------------------------------------------------------------------------------------------------------------------------------------------------
S-----------------------oooooo--------------------------------------------------------------------------------------SSS---------------------------------SSS---
S-----------------------------------------------------------------------------------------------------------------------------------------SS------------------
S-----------------------SSSSSS--------------------------------------------------------------------------------------------------------------------------------
S-----------------------SSSSSS-----------------------------------------------------------------------------------C---------------------------SSSSSSU----------
S-------------------------------------------------------------@QQQQ----------------------------------------#-#---------------------g##------------------------
S--------------------------------------------------------------------------------------------------------#-#-#-#---#---------------###------------------------
S----------------------------------------------------------------------------------------------------g-#-#-#-#-#---#-#-----------g####--SSS-------------------
S--M------------------------------------------------------------------------------------------------g#-#-#-#-#-#-E-#-#-----------#####---------r------------F-
XXXXXXXXXXXX---XXXXXXXXXXXXXXXXXXXXXXXXXXXXXXXXXXXXX---XXXXXXXXXXXXXXXXXXXXXXXXXXXXXXXXX---XXXXXXXXXXXXXXXXXXXXXXXXXXXXXXXXXXXXXXXXXXX-------XXXXXXXXXXXX--XXX
XXXXXXXXXXXX---XXXXXXXXXXXXXXXXXXXXXXXXXXXXXXXXXXXXX---XXXXXXXXXXXXXXXXXXXXXXXXXXXXXXXXX---XXXXXXXXXXXXXXXXXXXXXXXXXXXXXXXXXXXXXXXXXXX-------XXXXXXXXXXXX--XXX
