----------------------------------------------------------------------------------------------------------------------------------------------------------------------------------------------------------------------
----------------------------------------------------------------------------------------------------------------------------------------------------------------------------------------------------------------------
----------------------------------------------------------------------------------------------------------------------------------------------------------------------------------------------------------------------
----------------------------------------------------------------------------------------------------------------------------------------------------------------------------------------------------------------------
----------------------------------------------------------------------------------------------------------------------------------------------------------------------------------------------------------------------
----------------------------------------------------------------------------------------------------------------------------------------------------------------------------------------------------------------------
-----------------------------------US------------------------------------------------------------------------------------------------------SSS------------------------------------------------------------------------
--------------TT--------------------------------------------------------------------------------------------------------------------------------------------------------------TT--------------------------------------
--------------TT--------------------------------------------------------------------------------------------------------------------------------------------------------------TT--------------------------------------
--------------TT-----------------SS-------------------------------------------------------------------------------------------------------------------------------------------TT--------------------------------------
-------------SXXS----------------------SSS-------------------------------------------------------------------------SSS---------------------SSS-------------------------SSS----XX---------SSS--------------------------
----------------------------------------------------------------------------------------------------------------------------------------------------------------------------------------------------------------------
------------------TT--TT----------------------------------------------------------------------------------TT----------------------TT--------------------------TT------------------------------------------TT-------F--
---M--------------TT--TT----------------------------------------------------------------------------------TT----------------------TT--------------------------TT--------------k---------------------------TT-------#--
XXXXXXXXXXXXXXXXXXXXXXXXXXXXXXXXXXXX-X-XXXXXXX----------------------------------------------------------XXXXXXXX-X-XXXXXXX------XXXXXXXX-X-XXXXXXX----------XXXXXXXX-X-XXXXXXXXXXXXXXXXXXXXXXX----------XXXXXXXXXXXXXX
XXXXXXXXXXXXXXXXXXXXXXXXXXXXXXXXXXXX-X-XXXXXXX----------------------------------------------------------XXXXXXXX-X-XXXXXXX------XXXXXXXX-X-XXXXXXX----------XXXXXXXX-X-XXXXXXXXXXXXXXXXXXXXXXX----------XXXXXXXXXXXXXX
