----------------------------------------------------------------------------------------------------------------------------------------------------------------------------------------------------------------------
----------------------------------------------------------------------------------------------------------------------------------------------------------------------------------------------------------------------
----------------------------------------------------------------------------------------------------------------------------------------------------------------------------------------------------------------------
----------------------------------------------------------------------------------------------------------------------------------------------------------------------------------------------------------------------
----------------------------------------------------------------------------------------------------------------------------------------------------------------------------------------------------------------------
-----------------------------------------------------------------------------------k----------------------------------------------------------------------------------------------------------------------------------
------------------------------------------------------------------------------S---SSSSSSSSS-------------SSSSSSS-------------------------SSSSSSS-----------------------------------------------------------------------
--------------------------------------------------------------------------TT------------------------------------------------------------------------------------------------------------------------------------------
--------------------------------------------------------------------------TT------------------------------------------------------------------------------------------------------------------------------------------
----------------------------------------------g---------------------------TT------------------------------------------------------------------------------------------------------------------------------------------
----------------------------------------------SSSSS----------------------SXXS--------------------------------------SSS-------------------------------TT----------------SSS--------------------------------------------
----------------------------TT-----------------------------------------------------------------------------------------------------------------------TT---------------------------------------------------------------
--------------------------TTTT----------------------------------------TT------TT--------------------------TT----------------------------------TT-----TT---TT----------------------------------------------TT-------F--
---M----------------------TTTT----------------------------------------TT------TT--------------------------TT----------------------------------TT-----TT---TT----------------------------------------------TT-------#--
XXXXXXXXXX--------------XXXXXXXXXXXXXX------------------------------XXXXXXXXXXXXXXXXXX------------------XXXXXXXX-X-XXXXXXX------------------XXXXXXXXXXXXXXXXXXXXXXXX-X-XXXXXXX--------------------------XXXXXXXXXXXXXX
XXXXXXXXXX--------------XXXXXXXXXXXXXX------------------------------XXXXXXXXXXXXXXXXXX------------------XXXXXXXX-X-XXXXXXX------------------XXXXXXXXXXXXXXXXXXXXXXXX-X-XXXXXXX--------------------------XXXXXXXXXXXXXX
