--------------------------------------------------------------------------------------------------------------------------------------------------------------------------------
--------------------------------------------------------------------------------------------------------------------------------------------------------------------------------
--------------------------------------------------------------------------------------------------------------------------------------------------------------------------------
--------------------------------------------------------------------------------------------------------------------------------------------------------------------------------
--------------------------------------------------------------------------------------------------------------------------------------------------------------------------------
--------------------------------------------------------------------------------------------------------------------K-----------------------------------------------------------
----------------------------------------------------USS---------------------------------------------------------SSSSSS----1-----------------------------------------------------
--------------------------------------------------------------------------------------------------------------------------------------------------------------------------------
-------------------------------------------------------------------------------------------------------------------------------------------------B------------------------------
-----------------------------------------------------------------------------------------------------------------K-------------------------------b------------------------------
------------------------QQQQ-----------------------------------------------------------------------------------SSSSSSS-------------------------SS#CS----------------------------
-----------------------------K-B-----------------K---B-------------------------------K---B-------K---B--------------------TT----------------------------------------------------
------------B------------------b---------------------b--------------B--------------------b-----------b--------------------TT-----TT------B---------K-B-------B-------B------F---
-M----------b------------------b---------------------B--------------b--------------------B-----------B--------------------TT-----TT------b-----------b-------b-------b------#---
XXXXXXXXXXXXXXXXXXXXXXXXXXXXXXXXXXXXXXXXXXXXXXXXXXXXXXXXXXXXXXXXXXXXXXXXXXXXXXXXXXXXXXXXXXXXXXXXXXXXXXXXXXXXXXXXXXXXXXXXXXXXXXXXXXXXXXXXXXXXXXXXXXXXXXXXXXXXXXXXXXXXXXXXXXXXXXXX
XXXXXXXXXXXXXXXXXXXXXXXXXXXXXXXXXXXXXXXXXXXXXXXXXXXXXXXXXXXXXXXXXXXXXXXXXXXXXXXXXXXXXXXXXXXXXXXXXXXXXXXXXXXXXXXXXXXXXXXXXXXXXXXXXXXXXXXXXXXXXXXXXXXXXXXXXXXXXXXXXXXXXXXXXXXXXXXX
