--------------------------------------------------------------------------------------------------------------------------------------------------------------
--------------------------------------------------------------------------------------------------------------------------------------------------------------
--------------------------------------------------------------------------------------------------------------------------------------------------------------
S-----SS----------------------SSSSSSSSSSSSSSSSSSSSSSSSSSSSSSSSSSSSSSSSSSSSSSSSSSSSSSSSSSSSSSSSSSSSSSSS----------------------------------------SS--------------
S---------------------------------------------SS--SSSSSS--SSSS------SSSS--------------------------------------------------------------------------------------
S---------------------------------------------SS--SSSSSS--SSSS---g--SSSS--------------------------------------------------------------------------------------
S-------------------------------------------SS--------SS---S----SS--------------------------------------------------------------------------------------------
S-------------------------------------------SS--------SS---S----SS--------------------------------------------------------------------------------------------
S-------------------------------------------SS--------SS---S----SS--------------------------------------------------------------------------------------------
S-------------------------------------------SS----ooooSS---SoU--SC--g-g------------------C--------------------------------------------------------------------
S-------------------------------------------SSSS--SSSSSS---SSS--SS--SSSS-----------#-#------------------------------------------------@QQQQ-------------------
S---------------------------------------------SS---------------------------------#-#-#-#---#------------------------------------------------------------------
S---------------------------------------------SS-----------------------------g-#-#-#-#-#---#-#----------------------------------------------------------------
S--M------------------------------------------------k--g-g------------------g#-#-#-#-#-#-E-#-#--------------------------------------------------------------F-
XXXXXXXXXXXXXXXXXXXXXXXXXXXXXXXXXXXXXXXXXXXXXXXXXXXXXXXXXXXXXXXXXXXXXXXXXXXXXXXXXXXXXXXXXXXXXXXXXXXXXXXXXXXXXXXXXXXXXXXXXXXXXXXXXXXXXXXXXXXXXXXXXXXXXXXXX--XXX
XXXXXXXXXXXXXXXXXXXXXXXXXXXXXXXXXXXXXXXXXXXXXXXXXXXXXXXXXXXXXXXXXXXXXXXXXXXXXXXXXXXXXXXXXXXXXXXXXXXXXXXXXXXXXXXXXXXXXXXXXXXXXXXXXXXXXXXXXXXXXXXXXXXXXXXXX--XXX
