----------------------------------------------------------------------------------------------------------------------------------------------------------------------------------------
----------------------------------------------------------------------------------------------------------------------------------------------------------------------------------------
----------------------------------------------------------------------------------------------------------------------------------------------------------------------------------------
----------------------------------------------------------------------------------------------------------------------------------------------------------------------------------------
----------------------------------------------------------------------------------------------------------------------------------------------------------------------------------------
----------------------------------------------------------------------------------------------------------------------------------------------------------------------------------------
----------------------------------------------------------------------------------------------------------------------------------------------------------------------------------------
---------------------------------------------------------------------------------------------------------------------------------------y------------------------------------------------
---------------------------------------------------------------------------------------------------------------y---------------------#SS--o---------------------------------------------
---------------------------------------------------------------------------------------------------------------XSS-?Q---------------##--------------------------------------------------
--------------------------------------------------2--------------------------------------QQ-------------------XX-------------------###--SC----------------------------------------------
-------------------------------------------------------------------------------------------------------------XXX------------------####--------------------------------------------------
------------------------------------------------------------------------------------------------------------XXXX-------y---------#####---SSS----------------------------------------F---
----M-------------------------------------------y--y----------------y-y------------------------------------XXXXX---SSSSS-----y--######----------------------------------------------#---
XXXXXXXXXXXXXXXXXXXXXXXXXXXXXXXXXXXXXXXXXXXXXXXXXXXXXXXXXXXXXXXXXXXXXXXXXX--XXXXXXXXXXXXXXXXXXXXXXXXXXXXXXXXXXXX-------XX-XXXXXXXXXXXX------XXXXXXXXXXXXXXXXXXXXXXXXXXXXXXXXXXXXXXXXXXXX
XXXXXXXXXXXXXXXXXXXXXXXXXXXXXXXXXXXXXXXXXXXXXXXXXXXXXXXXXXXXXXXXXXXXXXXXXX--XXXXXXXXXXXXXXXXXXXXXXXXXXXXXXXXXXXX-------XX-XXXXXXXXXXXX------XXXXXXXXXXXXXXXXXXXXXXXXXXXXXXXXXXXXXXXXXXXX
