-----------------------------------------------------------------------------------------------------------------------------------------------------------------------------------------------------
-----------------------------------------------------------------------------------------------------------------------------------------------------------------------------------------------------
-----------------------------------------------------------------------------------------------------------------------------------------------------------------------------------------------------
-----------------------------------------------------------------------------------------------------------------------------------------------------------------------------------------------------
---------------------------------------------------------------XX------------------------------------------------------------------------------------------------------------------------------------
---------------------------------------------------------------XX------------------------------------------------------------------------------------------------------------------------------------
-----------------------------------------------------------C---XX----------------------------------------------------------------------------LSSS--------SSSSS--------QQQQQ--------------------------
---------------------------------------------------------------XX------------------------------------------------------------------------------------------------------------------------------------
-----------------------------------------------XX--------------XX------------------------------------------------------------------------g-----------------------------------------------------------
-----------------------------------------------XX--------------XX------------------------------------------------------------------------#------------------------------k----------------------------
------------------------------------------SS---XX---------SS---XX---------------------------------------------------------------SUS-----##---2-----#-----------TT-----?QQQQ--------------------------
-----------------------------------------------XX--------------XX----------------------------------------------------------------------###---------#-----------TT------------------------------------
-----------------------------------------------XX--------------XX---------------------------------------------------------------------####---------##----------TT--------------------------------F---
--M------gg----------gg----------gg--------k---XX----------k---XX------------------------------------gg----------------------gg------#####----kk---##---gg-----TT------------------------gg------X---
XXXXXXXXXXXXXXXXXXXXXXXXXXXXXXXXXXXXXXXXXXXXXXXXXXXXXXXXXXXXXXXXXXXXXXXXXXXXXXXXXXXXXXXXXXXXXXXXXXXXXXXXXXXXXXXXXXXXXXXXXXXXXXXXXXXXXXXXXXXXXXXXXXXXXXXXXXXXXXXXXXXXXXXXXXXXXXXXXXXXXXXXXXXXXXXXXXXXX
XXXXXXXXXXXXXXXXXXXXXXXXXXXXXXXXXXXXXXXXXXXXXXXXXXXXXXXXXXXXXXXXXXXXXXXXXXXXXXXXXXXXXXXXXXXXXXXXXXXXXXXXXXXXXXXXXXXXXXXXXXXXXXXXXXXXXXXXXXXXXXXXXXXXXXXXXXXXXXXXXXXXXXXXXXXXXXXXXXXXXXXXXXXXXXXXXXXXX
