-----------------------------------------------------------------------------------------------------------------------------------------------------
-----------------------------------------------------------------------------------------------------------------------------------------------------
-----------------------------------------------------------------------------------------------------------------------------------------------------
----------------------------o----------------------oo------------------------------------------------------------------------------------------------
--------------------------------------------?-----%%%%-------------------o---------------------------------------------------------------------------
-----------------------SSS-------------------------||-------------------%%%-------------------------oo-----------------------------------------------
---------------------------------------------------||--------------------|--o------o--o---SSS------%%%%----------------------------SSSS--------------
---------------------g----------o----ooo------r----||--SSS---o---o---o---|--SSSS--------------------||--o--------------------------------------------
-----------------%%%%%%-------------------%%%%%%---||-------%%%-%%%-%%%--|--------------------------||-%%%-------------------------------------------
------------------||||----SSS--------------||||----||--------|---|---|---|---------SSSS-------------||--|------------------------------SSSS----------
------------------||||----------------%%%%-||||ooo-||--------|---|---|---|------------------%%%-----||--|--------------------------------------------
-------------%%%%%||||-----------------||--||||--r-||--------|---|---|---|-------------------|------||-o|---------------o----------------------------
--------------|||-||||-----------------||%%%%%%%%%%||--------|---|---|---|-----%%%%----------|------||%%%%%----------------------------------------F-
-M------------|||-||||----oo---%%%%%%%-||-||||||||-||--------|---|-r-|---|------||-----------|------||-|||-----------------------------------------#-
XXXXXXXXXXX---|||-||||---%%%----|||||--||-||||||||-||-------%%%%%%%%%%%%%%%%----||-----------|------||-|||---------------------------------XXXXXXXXXX
XXXXXXXXXXX---|||-||||----|-----|||||--||-||||||||-||--------||||||||||||||-----||-----------|------||-|||---------------------------------XXXXXXXXXX
