-----------------------------------------------------------------------------------------------------------------------------------------------------------------------------------------------------
-----------------------------------------------------------------------------------------------------------------------------------------------------------------------------------------------------
-----------------------------------------------------------------------------------------------------------------------------------------------------------------------------------------------------
-----------------------------------------------------------------------------------------------------------------------------------------------------------------------------------------------------
-----------------------------------------------------------------------------------------------------------------------------------------------------------------------------------------------------
-----------------------------------------------------------------------------------------------------------------------------------------------------------------------------------------------------
------------------------------------------------------------------USSS------------------------USSS------------USSS--------QQQQQ----------------------------------------------SSSSS-------------------
-----------------------------------------------------------------------------------------------------------------------------------------------------------------------------------------------------
-----------------------------------------------------------------------------------------------------------------------------------------------------------------------------------------------------
----------------------------------------------------------------E------TT-------------------E------TT-----------------------k------------------------------------------------------------------------
---------------------------------------------------------------TT------TT------------------TT------TT--------S-----TT-----?QQQQ-------------------QQQ------------------------------Q-----------------
--------------------------------------------------------g------TT--tt--TT-----------g------TT--tt--TT--------------TT--------------------------------------------------------------------TT----------
--------------------------------------------------------TT-----TT--tt--TT-----------TT-----TT--tt--TT--------------TT--------------------------------------------------------------------TT------F---
--M-----------------------------------------------------TT--g--TT--tt--TT-----------TT--g--TT--tt--TT--------ggg---TT--------------------------------ggg-----------------gg-------K-K----TT------X---
XXXXXXXXXXXXXXXXXXXXXXXXXXXXXXXXXXXXXXXXXXXXXXXXXXXXXXXXXXXXXXXXXXXXXXXXXXXXXXXXXXXXXXXXXXXXXXXXXXXXXXXXXXXXXXXXXXXXXXXXXXXXXXXXXXXXXXXXXXXXXXXXXXXXXXXXX----XXXXXXXXXXXXXXXXXXXXXXXXXXXXXXXXXXXXXXXX
XXXXXXXXXXXXXXXXXXXXXXXXXXXXXXXXXXXXXXXXXXXXXXXXXXXXXXXXXXXXXXXXXXXXXXXXXXXXXXXXXXXXXXXXXXXXXXXXXXXXXXXXXXXXXXXXXXXXXXXXXXXXXXXXXXXXXXXXXXXXXXXXXXXXXXXXX----XXXXXXXXXXXXXXXXXXXXXXXXXXXXXXXXXXXXXXXX
