---------------------------------------------------------------------------------------------------------------------------------------------------------------------
---------------------------------------------------------------------------------------------------------------------------------------------------------------------
---------------------------------------------------------------------------------------------------------------------------------------------------------------------
-----------------------------------oo------------------------------oo------------------------------------------------------------------------------------------------
-----------------------------------------------------------------------------------------------------------------------------------------------------oo--------------
---------------------------------------------------------------------------------------------------------------------------------------------------------------------
----------------------------------SSSS----------------------------SSSS---------------------------------------------------------------------------------%%%%----------
------------------------------------------------------------------------------------------------------------------------------------------------SSS-----||-----------
--------------------------------------------------------------------------------------------------------------------------------------------------------||-----------
--------------------------------------------------------------------------------------------------------------------------------------------------------||-----------
----------------%%%%------------------%%%%%---------------------------%%%%%-----------------------------------------------------------SS----------------||-----------
-----------------||--------------------|||-----------------------------|||------------------------------------------------------------------------------||-----------
-----------------||--------------------|||-----------------------------|||------------------------------------------------------------------------------||---------F-
-M---------------||--------------------|||-----------------------------|||------------------------------------------------------------------------------||---------X-
XXXXXXXXXXX--%%%%||%%%%-------%%%%%----|||--------------------%%%%%----|||--------------------%%%%%---------------%%%%%---------------------------------||-XXXXXXXXXX
XXXXXXXXXXX---||-||-||---------|||-----|||---------------------|||-----|||---------------------|||-----------------|||----------------------------------||-XXXXXXXXXX
