-------------------------------------------------------------------------------------------------------------------------------------------------------------------------------------------
-------------------------------------------------------------------------------------------------------------------------------------------------------------------------------------------
-------------------------------------------------------------------------------------------------------------------------------------------------------------------------------------------
S-------SSSSS---------------SSSSSSSSSSSSSSSSSSSSSSSSSSSSSSSSSSSS----SSSSSSSSSSSSSSSSSSSSSSSSSSSSSSSSSSSSSSSSSSS-------------SSSS--------------------SSSSSSSSSSSS----SSSSSSSSSSSSS----------
S---------------------------SSSSSSSSSSSSSSSSSSSSSSSSSSSSSSSSSSSS----------------SSSSSSSSSSSSSSSSSSSSSSSSSSSS--------------------------------------------------------SSSSSSSSSSSS-----------
S---------------------------SSSSSSSSSSSSSSSSSSSSSSSSSSSSSSSCSSSS----------------SSSSSSSSSSSSSSSSSSSSSSSCSSSS--------------------------------------------------------SSSSSSSSSSSS-----------
S---------------------------SSSSSSSSSSSSSSSSSSSSSSSSSSSSSSSSSSSS----------------SSSSSSSSSSSSSSSSSSSSSSSSSSSS--------------------------------------------------------SSSSSSSSSSSS-----------
S-------------------------------------------------------------------------------------------------------------------------------------------------TT----------------S---------------TT-----
S-------------------------------------------------------------------------------------------------------------------------------------------------TT----------------S---------------TT-----
S----------------------------------------------------------ggg-----------------------------------------ggg----------------------------------------TT-------S----------oooooo--------TT-----
S-----------------------------SSSSSS?-SSSSSSSSSSSSSSSSSSSSSSSSSS--QQ--------------SSSSSS?-SSSSSSSSSSSSSSSSSS--QQ--------------------------------SCTTSU---------------USSSSSS----#---TT----F
S-----------------------------SSSSS---SSSSSSSSSSSSSSSSSSSSSSSSSS------------------SSSSS---SSSSSSSSSSSSSSSSSS--------------------------------TT----TT----TT---tt----------------##---TT---SS
S-----------------------------SSSSS---SSSSSSSSSSSSSSSSSSSSSSSSSS------------------SSSSS---SSSSSSSSSSSSSSSSSS--------------------------------TT----TT----TT---tt---------------###---TT---SS
S-M--------------------------------oooSSSSSSSSSSSSSSSSSSSSSSSSSS-----------------------oooSSSSSSSSSSSSSSSSSS--------------------------------TT---kTT---kTT--ktt---------kk---####--kTT---SS
XXXXXXXXXXXXXXXXXXX--XX--X---XXXXXXXXXXXXXXXXXXXXXXXXXXXXXXXXXXXXXXXXXX--XX--X---XXXXXXXXXXXXXXXXXXXXXXXXXXXXXXXXXXXXXXXXXXXXXXXXXXXXXXXXXXXXXXXXXXXXXXXXXXXXXXXXXXXXXXXXXXXXXXXXXXXXXX--XX
XXXXXXXXXXXXXXXXXXX--XX--X---XXXXXXXXXXXXXXXXXXXXXXXXXXXXXXXXXXXXXXXXXX--XX--X---XXXXXXXXXXXXXXXXXXXXXXXXXXXXXXXXXXXXXXXXXXXXXXXXXXXXXXXXXXXXXXXXXXXXXXXXXXXXXXXXXXXXXXXXXXXXXXXXXXXXXX--XX
