---------------------------------------------------------------------------------------------------------------------------------------------------------------------
---------------------------------------------------------------------------------------------------------------------------------------------------------------------
---------------------------------------------------------------------------------------------------------------------------------------------------------------------
-----------------------------------------------------------------------------------------------------------oo--------------------------------------------------------
-----------------------------------------------------------------------------------------------------------------------------------------------------oo--------------
---------------------------------------------------------------------------------------------------------------------------------------------------------------------
--------------------------------------------------------------SS------------------------------------------SSSS-----------------------------------------%%%%----------
-----SSS-------------------------------------------------------------------------------------------------------------------------SSS------------SSS-----||-----------
--------------------------------------------------------------------------------------------------------------------------------------------------------||-----------
--------------------------------------------------------------------------------------------------------------------------------------------------------||-----------
----------------%%%%------%%%%%---------------------------------------------------SS--------------------------%%%%%-------------------------------------||-----------
-----------------||--------|||-------------------------------------------SSS-----------------------------------|||--------------------------------------||-----------
-----------------||--------|||---------------------------------------------------------------------------------|||--------------------------------------||---------F-
-M---------------||--------|||---------------------------------------------------------------------------------|||--------------------------------------||---------X-
XXXXXXXXXXX--%%%%||%%%%----|||------------------------------------------------------------------------%%%%%----|||--------------------------------------||-XXXXXXXXXX
XXXXXXXXXXX---||-||-||-----|||-------------------------------------------------------------------------|||-----|||--------------------------------------||-XXXXXXXXXX
