---------------------------------------------------------------------------------------------------------------------------------------------------------------------
---------------------------------------------------------------------------------------------------------------------------------------------------------------------
---------------------------------------------------------------------------------------------------------------------------------------------------------------------
-----------------------------------------------------------------------------------------------oo--------------------------------------------------------------------
-----------------------------------------------------------------------------------------------------------------------------------------------------oo--------------
---------------------------------------------------------------------------------------------------------------------------------------------------------------------
----------------------------------------------------------------------------------------------SSSS------------------------SS---------------------------%%%%----------
------------------------------------------------------------------------------------------------------------------------------------------------SSS-----||-----------
--------------------------------------------------------------------------------------------------------------------------------------------------------||-----------
--------------------------------------------------------------------------------------------------------------------------------------------------------||-----------
----------------%%%%------------------------%%%%%%----SS----------SS------------------------------%%%%%-------------------------------------------------||-----------
-----------------||--------------------SSS---||||--------------------------------------------------|||--------------------------------------------------||-----------
-----------------||--------------------------||||--------------------------------------------------|||--------------------------------------------------||---------F-
-M---------------||--------------------------||||--------------------------------------------------|||--------------------------------------------------||---------X-
XXXXXXXXXXX--%%%%||%%%%----------------------||||-----------------------%%%%--------------%%%%%----|||------------%%%%%---------------------------------||-XXXXXXXXXX
XXXXXXXXXXX---||-||-||-----------------------||||------------------------||----------------|||-----|||-------------|||----------------------------------||-XXXXXXXXXX
