------------------------------------------------------------------------------------------------------------------------------------------------------
------------------------------------------------------------------------------------------------------------------------------------------------------
------------------------------------------------------------------------------------------------------------------------------------------------------
--------------------------------oo--------------------------------------------------------------------------------------------------------------------
---------------------------------------g-g------------------------------------------------------------------------------------------------------------
------------oo--------ooor---------%%%%%%%-------------oooo--------------------------R----------------------------------------------------------------
---------------------%%%%%----------|||||--------------%%%%--------------------------------g----oo----------------------------------------------------
----------------------|||-----------|||||----oo---SSSS--||-----------------------------%%%%%%---------------------------------------------------------
----------------------|||-----------|||||---------------||------------------------------||||----------------------------------------------------------
----------------------|||-----%%%%%-|||||---------------||------------------------------||||-----SSS--------------------------------------------------
-------------------%%%%%%%%----|||--|||||---------------||-------%%%--------------------||||----------------------------------------------------------
--------------------||||||-----|||--|||||-------------U-||--------|---------------------||||----------------------------------------------------------
--------------------||||||--o--|||--|||||---------------||--------|---------------------||||-------------------------------------------------------F--
--M----------%%%%---||||||-%%%-|||--|||||---------------||--------|---------------------||||-------------------------------------------------------#--
XXXXXXXXXXX---||----||||||--|--|||--|||||----%%%%-----%%%%%-%%%%%-|---------------------||||------------------------------------------------XXXXXXXXXX
XXXXXXXXXXX---||----||||||--|--|||--|||||-----||-------|||---|||--|---------------------||||------------------------------------------------XXXXXXXXXX
