----------------------------------------------------------------------------------------------------------------------------------------------------------------------------------------------------------
----------------------------------------------------------------------------------------------------------------------------------------------------------------------------------------------------------
----------------------------------------------------------------------------------------------------------------------------------------------------------------------------------------------------------
S---------------SSSS----------------------------------------SSSS----------------------------------------------------------------SSSS----------------o-----------------------------------------------------
S---------------------------------------------------------------------------------------------------------------------------------------------------------------------------------------------------------
S-----------------------------------------------------------------------o-----------------------------------oooo------------------------------SS----------------------------------------------------------
S-------SSS---------------SS-----SSS--------------------oo--------------------------------------------------SSSS-----------%%%%-------------------------------------------------------------------SS------
S-------------------------------------------------------------------SSSS----------------------------------------------------||----------------------------------------------------------------------------
S---------------------------------------------------------------------------------------------------------------------------||--------------------SSS-----------------------------------------------------
S---------------------------------------------------------------------------------------------------------------------------||----------------------------------------------------------------------------
S-------------------------------------------------o-------------------------------------------------------------------------||-----------%%%%-------------------------------------------------------------
S------------------------------------------------------------------------------------------------------y--------------------||------------||--------------------------------------------------------------
S---------------------------------------------------------------------------------------------------------------------------||------------||-----------------------------------------------------------F--
S--M------------------------------------------------------------------------------------------------------------------------||------------||-----------------------------------------------------------#--
XXXXXXXXXXX-----------------------------------------------------------------------------------------------------------------||-XXXXXXXX---||----XXXXXXXXXX----------------------------------XXXXXXXXXXXXXX
XXXXXXXXXXX-----------------------------------------------------------------------------------------------------------------||-XXXXXXXX---||----XXXXXXXXXX----------------------------------XXXXXXXXXXXXXX
