----------------------------------------------------------------------------------------------------------------------------------------------------------------------------------------------------------
----------------------------------------------------------------------------------------------------------------------------------------------------------------------------------------------------------
----------------------------------------------------------------------------------------------------------------------------------------------------------------------------------------------------------
----------------------------------------------------------------------------------------------------------------------------------------------------------------------------------------------------------
----------------------------------------------------------------------------------------------------------------------------------------------------------------------------------------------------------
------------------------------------------------------------------------------------------------------------------------------------------------------------------------------g---------------------------
----------------------------------------------------------------------------------------------------------------------------------------------------------------------------SSSSSSSS---SSS!---------------
----------------------------------------------------------------------------------------------------------------------------------------------------------------------------------------------------------
-------------------------------g--------------------------------------------------------------------------------------------------------------------------------------------------------------------------
--------------------1-----------------------------------------------------------------------------------------------1-------------------------------------------------------------------------------------
-----------------------------S@S------------------------------------------------------------------------------!-------------------tt------------------------------------------------------C---------------
----------------------------------------------------------------------------------------------------------------------------------tt----------tt----------------------------------------------------------
----------------------------------------------------------------------------------------------------------------------------------tt----------tt------------------------------------------------------F---
---M---------------------------------g---------------g-----------g---------------g----------------------------k-------------------tt----------tt-------------------------------------------g-g--------#---
XXXXXXXXXXXXXXXXX--XXXXXXXXXXXXXXXXXXXXXXXXXXXXXXXXXXXXXXXXXXXXXXXXXXXXXXXXXXXXXXXXXXXXXXXXXXXXXXXXXXXXXXXXXXXXXXXXXXXXXXXXXXXXXXXXXXXXXXXXXXXXXXXXXX--XXXXXXXXXXXXXXXXXXXXXXXXXXX---XXXXXXXXXXXXXXXXXXXXX
XXXXXXXXXXXXXXXXX--XXXXXXXXXXXXXXXXXXXXXXXXXXXXXXXXXXXXXXXXXXXXXXXXXXXXXXXXXXXXXXXXXXXXXXXXXXXXXXXXXXXXXXXXXXXXXXXXXXXXXXXXXXXXXXXXXXXXXXXXXXXXXXXXXX--XXXXXXXXXXXXXXXXXXXXXXXXXXX---XXXXXXXXXXXXXXXXXXXXX
