------------------------------------------------------------------------------------------------------------------------------------------------------------------------------------------------------------------------------
------------------------------------------------------------------------------------------------------------------------------------------------------------------------------------------------------------------------------
------------------------------------------------------------------------------------------------------------------------------------------------------------------------------------------------------------------------------
------------------------------------------------------------------------------------------------------------------------------------------------------------------------------------------------------------------------------
------------------------------------------------------------------------------------------------------------------------------------------------------------------------------------------------------------------------------
----------------------------------------------------------------------------------------------------------------------------------------------------------------------------------------------------y-------------------------
----------------------------------------------------------------------------------------------------------------------------------------------------------------------------------------------------##------------------------
----------------------------oooo------------------------------------------------------------------------------------------------------------------------------------------------------------------y###------------------------
--------------------------------------------------------------------------------------------------------------------------------------------------------------------------------------------------####------------------------
-------------------------------------------------------------------------------------------------------------------------------------------------------------------------------------------------#####------------------------
-------------------------------------------------------------------------TT--------------------------Q-Q----------------------------------------------------------------------------------------######---C--------------------
-------------------------------------------------------------------------TT--------------------------------------------------------------------------------------------------------------------#######------------------------
-------------------------------------------------------------------------TT-------------------------------------------------------------------------------------------------------------------########--------------------F---
-M-----------y----------------y---------------y----------------y-----y---TT---y--------------------------------------------------------------y-------------------------y--------------y------#########------------y-------#---
XXXXXXXXXXXXXXXXXXXXXXXXXXXXXXXXXXXXXXXXXXXXXXXXXXXXXXXXXXXXXXXXXXXXXXXXXXXXXXXXXXXXXXXXXXXXXXXXXXXXXXXXXXXXXXXXXXXXXXXXXXXXXXXXXXXXXXXXXXXXXXXXXXXXXXXXXXXXXXXXXXXXXXXXXXXXX--XXXXXXXXXXXXXXXXXXXXXXXXXXXXXXXXXXXXXXXXXXXXXXX
XXXXXXXXXXXXXXXXXXXXXXXXXXXXXXXXXXXXXXXXXXXXXXXXXXXXXXXXXXXXXXXXXXXXXXXXXXXXXXXXXXXXXXXXXXXXXXXXXXXXXXXXXXXXXXXXXXXXXXXXXXXXXXXXXXXXXXXXXXXXXXXXXXXXXXXXXXXXXXXXXXXXXXXXXXXXX--XXXXXXXXXXXXXXXXXXXXXXXXXXXXXXXXXXXXXXXXXXXXXXX
