------------------------------------------------------------------------------------------------------------------------------------------------------
------------------------------------------------------------------------------------------------------------------------------------------------------
------------------------------------------------------------------------------------------------------------------------------------------------------
--------------------------------oo--------------------------------------------------------------------------------------------------------------------
---------------------------------------g-g------------------------------------------------------------------------------------------------------------
----------------------ooor---------%%%%%%%-------------oooo-------------------------------------------------------------------------------------------
---------------------%%%%%----------|||||--------------%%%%-------------------------------------------------------------------------------------------
----------------------|||-----------|||||----oo---SSSS--||--------------------------------------------------------------------------------------------
----------------------|||-----------|||||---------------||--------------------------------------------------------------------------------------------
----------------------|||-----%%%%%-|||||---------------||----------------------------------oo------------------------------oo------------------------
-------------------%%%%%%%%----|||--|||||---------------||-------%%%----------------------------------------------------------------------------------
--------------------||||||-----|||--|||||-------------U-||--------|-----------------------------------------------------------------------------------
--------------------||||||--o--|||--|||||---------------||--------|--------------------------------------------------------------------------------F--
--M----------%%%%---||||||-%%%-|||--|||||---------------||--------|--------------------------------------------------------------------------------#--
XXXXXXXXXXX---||----||||||--|--|||--|||||----%%%%-----%%%%%-%%%%%-|-------------------------------------------------------------------------XXXXXXXXXX
XXXXXXXXXXX---||----||||||--|--|||--|||||-----||-------|||---|||--|-------------------------------------------------------------------------XXXXXXXXXX
