---------------------------------------------------------------------------------------------------------------------------------------------------------------------
---------------------------------------------------------------------------------------------------------------------------------------------------------------------
---------------------------------------------------------------------------------------------------------------------------------------------------------------------
---------------------------------------------------------------------------------------------------------------------------------------------------------------------
-----------------------------------------------------------------------------------------------------------------------------------------------------oo--------------
---------------------------------------------------------------------------------------------------------------------------------------------------------------------
------------------------------------------SS-----------------------------------------------------------------------------------------------------------%%%%-------SS-
-------------------------------------------------------------------------------------------------------------SSS--------------------------------SSS-----||-----------
---------------------------------------------------------oo---------------------------------------------------------------------------------------------||-----------
--------------------------------------------------------------------------------------------------------------------------------------------------------||-----------
----------------%%%%------------------SS-------------------%%%%-----------------------------------------------------------------------SS----------------||-----------
-----------------||---------------------------------SSS-----||------------------------------------------------------------------------------------------||-----------
-----------------||-----------------------------------------||------------------------------------------------------------------------------------------||---------F-
-M---------------||-----------------------------------------||------------------------------------------------------------------------------------------||---------X-
XXXXXXXXXXX--%%%%||%%%%-------------------------------------||------------------------------------------------------------%%%%%-------------------------||-XXXXXXXXXX
XXXXXXXXXXX---||-||-||--------------------------------------||-------------------------------------------------------------|||--------------------------||-XXXXXXXXXX
