------------------------------------------------------------------------------------------------------------------------------------------------------------------------------------------------------
------------------------------------------------------------------------------------------------------------------------------------------------------------------------------------------------------
------------------------------------------------------------------------------------------------------------------------------------------------------------------------------------------------------
------------------------------------------------------------------------------------------------------------------------------------------------------------------------------------------------------
------------------------------------------------------------------------------------------------------------------------------------------------------------------------------------------------------
------------------------------------------------------------------------------------------------------------------------------------------------------------------------------------------------------
----------------------------------------------------------------------------------------------------------------------------------------##------------------------------------------------------------
----------------------------------------------------------------------------------------------------------------------------------------##------------------------------------------------------------
-----------------------------------------------------------------------------------TT---------------------------------------------------##------------------------------------------------------------
-----------------------------------------------------------------------------------TT--------------------------------------------K---#--##------------------------------------------------------------
--------------------------------------------------------------------------#LSS-----##-----------------------------------------------##--##------------------------------------------------------------
--------------------------------------------------------------------------#--------------------------------------------------------###--##------K-----------------------------------------------------
--------------------------------------------------------------------------#-----------*---TT-----*--------------------------------####------------------------------------------------------------F---
-M--------k---ggg-------ggg--k----ggg-----------------------------------kk#-----------*---TT-----*-----K-----ggg-----ggg---------#####-----------------ggg------------k---ggg---------------------#---
XXXXXXXXXXXXXXXXXXXXXXXXXXXXXXXXXXXXXXXXXXXXXXXXXXXXXXXXXXXXXXXXXXXXXXXXXXXXXXX---XXXXXXXXXXXXXXXXXXXXXXXXXXXXXXXXXXXXXXXXXXXXXXXXXXXXXXXXXXXXXXXXXXXXXXXXXXXXXXXXXXXXXXXXXXXXXXXXXXXXXXXXXXXXXXXXXXXX
XXXXXXXXXXXXXXXXXXXXXXXXXXXXXXXXXXXXXXXXXXXXXXXXXXXXXXXXXXXXXXXXXXXXXXXXXXXXXXX---XXXXXXXXXXXXXXXXXXXXXXXXXXXXXXXXXXXXXXXXXXXXXXXXXXXXXXXXXXXXXXXXXXXXXXXXXXXXXXXXXXXXXXXXXXXXXXXXXXXXXXXXXXXXXXXXXXXX
