-----------------------------------------------------------------------------------------------------------------------------------------------------------------------------------------------------
-----------------------------------------------------------------------------------------------------------------------------------------------------------------------------------------------------
-----------------------------------------------------------------------------------------------------------------------------------------------------------------------------------------------------
-----------------------------------------------------------------------------------------------------------------------------------------------------------------------------------------------------
-----------------------------------------------------------------------------------------------------------------------------------------------------------------------------------------------------
-----------------------------------------------------------------------------------------------------------------------------------------------------------------------------------------------------
-----------------LSSS---------------------QQQQQ------------------------------------------------------------------------------------------------------------------------------------------------------
-----------------------------------------------------------------------------------------------------------------------------------------------------------------------------------------------------
-------------g-----------------------------------------------------------------------------------------------------------------------------XX--------------------------------------------------------
-------------#------------------------------k-----------g----------------------------------------------------------------------------------XX--------------------------------------------------------
----SUS-----##---2-----#-----------TT-----?QQQQ---------TT------------------------QQQ-------------------------------------------------SS---XX---------QQQ--------------------------------------------
-----------###---------#-----------TT-------------------TT---------------------------------------------------------------------------------XX--------------------------------------------------------
----------####---------##----------TT-------------------TT---------------------------------------------------------------------------------XX----------------------------------------------------F---
--M------#####----kk---##---gg-----TT-------------------TT---------------gg----------ggg-----------------------------------------------k---XX------------ggg-----------------gg------------------X---
XXXXXXXXXXXXXXXXXXXXXXXXXXXXXXXXXXXXXXXXXXXXXXXXXXXXXXXXXXX---XXXXXXXXXXXXXXXXXXXXXXXXXXX----XXXXXXXXXXXXXXXXXXXXXXXXXXXXXXXXXXXXXXXXXXXXXXXXXXXXXXXXXXXXXXXX----XXXXXXXXXXXXXXXXXXXXXXXXXXXXXXXXXXXX
XXXXXXXXXXXXXXXXXXXXXXXXXXXXXXXXXXXXXXXXXXXXXXXXXXXXXXXXXXX---XXXXXXXXXXXXXXXXXXXXXXXXXXX----XXXXXXXXXXXXXXXXXXXXXXXXXXXXXXXXXXXXXXXXXXXXXXXXXXXXXXXXXXXXXXXX----XXXXXXXXXXXXXXXXXXXXXXXXXXXXXXXXXXXX
