------------------------------------------------------------------------------------------------------------------------------------------------------------------------------------------------------------------------------
------------------------------------------------------------------------------------------------------------------------------------------------------------------------------------------------------------------------------
------------------------------------------------------------------------------------------------------------------------------------------------------------------------------------------------------------------------------
------------------------------------------------------------------------------------------------------------------------------------------------------------------------------------------------------------------------------
------------------------------------------------------------------------------------------------------------------------------------------------------------------------------------------------------------------------------
----------------------------------------------------------------------------------------------------------------------------------------------------y-------------------------------------------------------------------------
------------------------------------------------------Q-------------------------------------------------------------------------------Q-------------##------------------------------------------------------------------------
------------------oooo----------------------------------------------------------------------------------------------------------------------------y###------------------------------------------------------------------------
--------------------------------------------------------------------------------------------------------------------------------------------------####------------------------------------------------------------------------
-------oo----------------------------------------------------------------------------------------------------------------------------------------#####------------------------------------------------------------------------
------o--o--------------------------------------------?-------------------------------------------------------------------------------?---------######---C--------------------------------------------------------------------
----------------#---------------------------------TT------------------------------------------------------------------------------TT-----------#######------------------------------------------------------------------------
----------------#---------------TT----------------TT------------------------------------------------------------------------------TT----------########--------------------------------------------------------------------F---
-M--------------#---------------TT----------------TT--------------------------------------------------------------y---------------TT---------#########-------------------------------------------------y----------y-------#---
XXXXXXXXXXXXXXXXXXXXXXXXX--XXXXXXXXXXXXXX--XXXXXXXXXXXXXXXXXXXXXXXXXXX--XXXXXXXXX--XXXXXXXXXXXXXXXXXXXX----XXXXXXXXXXXXXXXXXXXXXXXXXXXXXXXXXXXXXXXXXXXXXXXXXXX--XXXXX--XXXXXXXXXXXXXXXXXXXXXXXXXXXXXXXXXXXXXXXXXXXXXXXXXXXXXXX
XXXXXXXXXXXXXXXXXXXXXXXXX--XXXXXXXXXXXXXX--XXXXXXXXXXXXXXXXXXXXXXXXXXX--XXXXXXXXX--XXXXXXXXXXXXXXXXXXXX----XXXXXXXXXXXXXXXXXXXXXXXXXXXXXXXXXXXXXXXXXXXXXXXXXXX--XXXXX--XXXXXXXXXXXXXXXXXXXXXXXXXXXXXXXXXXXXXXXXXXXXXXXXXXXXXXX
