------------------------------------------------------------------------------------------------------------------------------------------------------
------------------------------------------------------------------------------------------------------------------------------------------------------
------------------------------------------------------------------------------------------------------------------------------------------------------
--------------------------------oo--------------------------------------------------------------------------------------------------------------------
-------------------------------------g-g--------------------------------------------------------------------------------------------------------------
----------------------ooor---------%%%%%%%--------------------------------------------------oo--------------------------------------------------------
---------------------%%%%%----------|||||-------------------------------------------------------------------------------------------------------------
----------------------|||-----------|||||----oo-------------------------------------------------------------------------------------------------------
----------------------|||-----------|||||-------------------------------------------------------------------------------------------------------------
----------------------|||-----%%%%%-|||||---------------------------------------------------------------------------oo--oo----------------------------
-------------------%%%%%%%%----|||--|||||-------------------------------------------------------------------------------------------------------------
--------------------||||||-----|||--|||||-------------------------------------------------------------------------------------------------------------
--------------------||||||--o--|||--|||||----------------------------------------------------------------------------------------------------------F--
-M-----------%%%%---||||||-%%%-|||--|||||----------------------------------------------------------------------------------------------------------#--
XXXXXXXXXXX---||----||||||--|--|||--|||||---------------------------------------------------------------------------------------------------XXXXXXXXXX
XXXXXXXXXXX---||----||||||--|--|||--|||||---------------------------------------------------------------------------------------------------XXXXXXXXXX
