-------------------------------------------------------------------------------------------------------------------------------------------------------------------------------------------
-------------------------------------------------------------------------------------------------------------------------------------------------------------------------------------------
-------------------------------------------------------------------------------------------------------------------------------------------------------------------------------------------
S-------SSSSSSSS------------SSSSSSSSSSSSSSSSSSSSSSSSSSSSSSSSSSSSSSSSSSSSSSSSSSSSSSSSSSSS------------SSSS--------SSSSSSSSSSSSSSSS------------SSSSSSSS------------SSSSSSSSSSSSSSSSSSSSSSSS---
S-------------------------------SSSSSSSSSSSSSSSSSSSSSSSSSSSSSSSSSSSSSSSSSSSSSSSSSSSSSSSS----------------------------------------------------------------------------SSSSSSSSSSSS-----------
S-------------------------------SSSSSSSSSSSSSSSSSSSSSSSSSSSSSSSSSSSSSSSSSSSSSSSSSSSCSSSS----------------------------------------------------------------------------SSSSSSSSSSSS-----------
S-------------------------------SSSSSSSSSSSSSSSSSSSSSSSSSSSSSSSSSSSSSSSSSSSSSSSSSSSSSSSS--QQ--QQ--------------------------------------------------------------------SSSSSSSSSSSS-----------
S-------------------------------------------------------------------------------------------------------------------------------------------------------------------S---------------TT-----
S-------------------------------------------------------------------------------------------------------------------------------------------------------------------S---------------TT-----
S----------------------------------------------------------------------------------ggg--------------------------------------------------------------------------------oooooo--------TT-----
S---------------------------------SSSSSS?-SSSSSSSSSSSSSSSSSSSSSSSSSSSSSSSSSSSSSSSSSSSSSS--QQ--QQ--------------------------------------------------------------TT-----USSSSSS----#---TT----F
S---------------------------------SSSSS---SSSSSSSSSSSSSSSSSSSSSSSSSSSSSSSSSSSSSSSSSSSSSS------------------------------------------------------------------TT--TT---------------##---TT---SS
S---------------------------------SSSSS---SSSSSSSSSSSSSSSSSSSSSSSSSSSSSSSSSSSSSSSSSSSSSS-----------------------------------------------------------tt-----TT--TT--------------###---TT---SS
S-M------------------------------------oooSSSSSSSSSSSSSSSSSSSSSSSSSSSSSSSSSSSSSSSSSSSSSS-----------------------------------------------------------tt----kTT--TT--------kk---####--kTT---SS
XXXXXXXXXXXXXXXXXXXXXXX--XX--X---XXXXXXXXXXXXXXXXXXXXXXXXXXXXXXXXXXXXXXXXXXXXXXXXXXXXXXXXXXXXXXXXXX----------------------------------------------XXXXXXXXXXXXXXX--XXXXXXXXXXXXXXXXXXXXX--XX
XXXXXXXXXXXXXXXXXXXXXXX--XX--X---XXXXXXXXXXXXXXXXXXXXXXXXXXXXXXXXXXXXXXXXXXXXXXXXXXXXXXXXXXXXXXXXXX----------------------------------------------XXXXXXXXXXXXXXX--XXXXXXXXXXXXXXXXXXXXX--XX
