--------------------------------------------------------------------------------------------------------------------------------------------------------------------------------
--------------------------------------------------------------------------------------------------------------------------------------------------------------------------------
--------------------------------------------------------------------------------------------------------------------------------------------------------------------------------
------------------------------------------------U-------------------------------------------------------------------------------------------------------------------------------
--------------------------------------------------------------------------------------------------------------------------------------------------------------------------------
--------------------------------------------------------------------------------------------------------------------------------------------------------------------------------
------------------------------------------------------------------------------------------------SSSS----------------------------------------------------------------------------
--------------------------------------------------SS----------------------------------------------------------------------------------------------------------------------------
-----------------B--------------------------------------------------------------------------------------------------------------------------------------------------------------
-----------------b------------------------------------------------------------------------------K-------------SS----------------------------------------------------------------
---------------SS#CS---------------------------------------------------------------------------SSSSS--------------------------------QQQQ----------------------------------------
-----K---B----------------------------------------------------------------------------------------K---#----B-----------------------------K-B------------------------------------
---------b---------K-B-------TT------TT----------------------B-------TT--------------TT---------------#----b-------------------------------b---------------------TT---------F---
-M-------B-----------b-------TT------TT----------------------b-------TT--------------TT---------------#----B-------------------------------b---------------------TT---------#---
XXXXXXXXXXXXXXXXXXXXXXXXXXXXXXXXXXXXXXXXXXXXXXXXXXXXXXXXXXXXXXXXXX--XXXXXXXXXXXXXXXXXXXXXXXXXXXXXXXXXXXXXXXXXXXXXXXXXXXXXXXXXXXXXXXXXXXXXXXXXXXXXXXXXXXXXXXXXXXXXXXXXXXXXXXXXXXX
XXXXXXXXXXXXXXXXXXXXXXXXXXXXXXXXXXXXXXXXXXXXXXXXXXXXXXXXXXXXXXXXXX--XXXXXXXXXXXXXXXXXXXXXXXXXXXXXXXXXXXXXXXXXXXXXXXXXXXXXXXXXXXXXXXXXXXXXXXXXXXXXXXXXXXXXXXXXXXXXXXXXXXXXXXXXXXX
