------------------------------------------------------------------------------------------------------------------------------------------------------
------------------------------------------------------------------------------------------------------------------------------------------------------
------------------------------------------------------------------------------------------------------------------------------------------------------
------------------------------------------------------------------------------------------------------------------------------------------------------
------------------------------------------------------------------------------------------------------------------------------------------------------
--------R--oo---------------------------------------------oooooooooo----------------oo--------------------------------------------------------R-------
-----------------------------#-------oo-------------------%%%%%%%%%%-----------------------------------oo---------------------#-----------------------
-----------------------------#------------------------%-S--||||||||-----------------------------------------------------------#-----------------------
----------------------------##----------------------%------||||||||----------------------------------------------------------##-----------------------
----------------------------##--------SSSSS----------------||||||||-------SS----------------------------SS-------------------##-----------------------
-----------------------%---###---%-------------%%%---------||||||||---------------------------------------------------------###-----------------------
---------------------------###------------------|--------U-||||||||---------------------------------------------------------###-----------------------
------------%%%%%%%--------###------------------|----------||||||||------------------%%%%%%%%%%-----------------------------###--------------------F--
--M----------|||||---------###------------------|----------||||||||--------r----------||||||||------------------------------###-----%--------------#--
XXXXXX-------|||||-------XXXXXX-------------X---|--------%%%%%%%%%%%--%--XXXXXX-X-X---||||||||--XXXXXX-----XXX-X--X-XXXX--XXXXXXXXX---XXXXXXX---XXXXXX
XXXXXX-------|||||-------XXXXXX-------------X---|---------|||||||||------XXXXXX-X-X---||||||||--XXXXXX-----XXX-X--X-XXXX--XXXXXXXXX---XXXXXXX---XXXXXX
