-----------------------------------------------------------------------------------------------------------------------------------------------------
-----------------------------------------------------------------------------------------------------------------------------------------------------
-----------------------------------------------------------------------------------------------------------------------------------------------------
-----------------------------------------------------------------------------------------------------------------------------------------------------
-----------------------------------------------------------------------------------------------------------------------------------------------------
------------------------------------------------------------------------------------------SSSSSSSSSSSSSSSSSSSS---------------------------------------
----S--------------------------------------------------------------------------------------------------------------------------o---S-o-o----o--------
----------------------------------------------------------------------------------------g-----------------------------S--------SS--------------------
---------------SS----------------SS-------------------------------------------------%%%%%%----------------------------------%------------------------
-----S-------------------------------------------------------------------------------||||---------------------SSSS------------------SSSSSSSSSSS------
--------------------------r--------------r--r--r---r-----r--r--r--------------r------||||------------------------------------------------------------
--------%%%%%%%%---%%%%%%%%%%%%%%%-----%%%%%%%%%%%%%%%%%%%%%%%%%%%%%%%%%%%%%%%%%%%%%%||||------------------------------------------------------------
---------||||||-----|||||||||||||-------||||||||||||||||||||||||||||||||||||||||||||-||||----------------------------------------------------------F-
-M-------||||||-----|||||||||||||-------||||||||||||||||||||||||||||||||||||||||||||-||||---------------------oo-----------------------------------#-
XXX---X--||||||-----|||||||||||||-----%-||||||||||||||||||||||||||||||||||||||||||||-||||--------------------%%%--X-------%%%%%----------------XXXXXX
XXX---X--||||||-----|||||||||||||-------||||||||||||||||||||||||||||||||||||||||||||-||||---------------------|---X--------|||-----------------XXXXXX
