----------------------------------------------------------------------------------------------------------------------------------------------------------------------------------------------------
----------------------------------------------------------------------------------------------------------------------------------------------------------------------------------------------------
----------------------------------------------------------------------------------------------------------------------------------------------------------------------------------------------------
----------------------------------------------------------------------------------------------------------------------------------------------------------------------------------------------------
----------------------------------------------------------------------------------------------------------------------------------------------------------------------------------------------------
--------------------------------------------------------------------------------------------------k-----------------------------------------k-------------------------------------------------------
-----------S-----------------------------S----S--------S-----------------S-----------------------##---------------S-----------------S------##---S--S-----------------------------------S------------
------------------------------------------------------------------------------------------------###---------------------------------------###-------------------------------------------------------
-----------------------------------------------------------------------------------------------####--------------------------------------####-------------------------------------------------------
-------------------------------Q---------------------------------------------------------------####------------------?-------------------####-------------------------------------------------------
-----SS----SS----------#------------#----S----SSS-Q----S-----------------S---------------------####---------------S----------S-SS---S----####---S--SSS-----------------------------SS--S--T---S-----
------K----------------#-----T------#-----------K---------------------------------------------#####-----------------------------K-------#####--------K-----T------------T-----------K-----T-T-------
-----------------------#-----T------#---------------------------------------------------------#####-------T-----------------------------#####--------------T------------T-----------------T-T----F--
-M-g-------------gg----#-----T------#----g-------------------g----k---------------------------#####-------T------------------K----------#####---g----------T---g--------T-----------------T-T-K--#--
XXXXXXXXX-XXXXX-XXXXXX-X-X-XXXXXXX--X-XXXXXXXXXXXXXXXXXXXXX-XXXXXXXXXXX-XXXXX-XXXXXX-XXXXXXX-XXXXXXXXXXXXXXXX-XXXXXXXXXXXXXXXXXXXX-XXXXXXXXXXXXXXXXXXXXX-XXXXXXXX--XXXXXXXXXXX-XXXXXXXXXXXXXXXXXXXXX
XXXXXXXXX-XXXXX-XXXXXX-X-X-XXXXXXX--X-XXXXXXXXXXXXXXXXXXXXX-XXXXXXXXXXX-XXXXX-XXXXXX-XXXXXXX-XXXXXXXXXXXXXXXX-XXXXXXXXXXXXXXXXXXXX-XXXXXXXXXXXXXXXXXXXXX-XXXXXXXX--XXXXXXXXXXX-XXXXXXXXXXXXXXXXXXXXX
