----------------------------------------------------------------------------------------------------------------------------------------------------------------------------------------------------------
----------------------------------------------------------------------------------------------------------------------------------------------------------------------------------------------------------
----------------------------------------------------------------------------------------------------------------------------------------------------------------------------------------------------------
----------------------------------------------------------------------------------------------------------------------------------------------------------------------------------------------------------
----------------------------------------------------------------------------------------------------------------------------------------------------------------------------------------------------------
----------------------------------------------------------------------------------------------------------------------------------------------------------------------------------------------------------
-----------------------------@-------------S---------@-----S-------------------------------------S-------------S----------------------------------S-----------------S--------S-----------------S----------
----------------------------------------------------------------------------------------------------------------------------------------------------------------------------------------------------------
----------------------------------------------------------------------------------------------------------------------------------------------------------------------------------------------------------
----------------------------------------------------------------------------------------------------------------------------------------------------------------------------------------------------------
---------t-----#--t--------#-!-----------------------!---S----!-------t----t-----!-S!---------S-----!--------------#-S----------#-#-S--#------------S------!-------------------------S----#---------------
---------t-----#--t--------#---t---------t----------------------------t----t---------------------------------------#------------#-#----#--------------------------------------------------#---------------
---------t-----#--t--------#---t---------t-------t--------------------t----t-------------------------------t-t-----#------t-t---#-#----#--t-----------------------------------------------#-----------F---
---M-----t-----#--t----g---#---t-gg----#-t-------t-g------------------t----t-g-#-----------#----------g----t-t-----#------t-t#--#-#----#--t-----------g----------g---g-#----------g-------#-----------#---
XXXXXXXXXXXXXXXXXXXXXXXXXXXXXXXXXXXXXXXXXXXXXXXXXXXXXXXXXXXXXXXXXXXXXXXXXXXXXXXXXXXXXXXXXXXXXXXXXXXXXXXXX-XXXXXXXXXXXXXXXXXXXXXXXXXXXX-XXXXXXXXXXXXXXXXXXXXXXXXXXXXXXXXXXXXXXXXXXXXXXXXXX-XXXXXXXXXXXXXXXX
XXXXXXXXXXXXXXXXXXXXXXXXXXXXXXXXXXXXXXXXXXXXXXXXXXXXXXXXXXXXXXXXXXXXXXXXXXXXXXXXXXXXXXXXXXXXXXXXXXXXXXXXX-XXXXXXXXXXXXXXXXXXXXXXXXXXXX-XXXXXXXXXXXXXXXXXXXXXXXXXXXXXXXXXXXXXXXXXXXXXXXXXX-XXXXXXXXXXXXXXXX
