------------------------------------------------------------------------------------------------------------------------------------------------------
------------------------------------------------------------------------------------------------------------------------------------------------------
------------------------------------------------------------------------------------------------------------------------------------------------------
------------------------------------------------------------------------------------------------------------------------------------------------------
------------------------------------------------------------------------------------------------------------------------------------------------------
-------------------------R------------------------------------oooo-------------------------------ooooooooo--------------------------------------------
------oo-----------oo-----------------------------------------%%%%------------------------g------%%%%%%%%%------------------#----o--------------------
------------------------------------------------------------S--||-----------------------%%%%---S--|||||||-------------------#-------------------------
---------------------------------------------------------------||------------------------||-------|||||||------------------##--%----------------------
-------SSSS---------SS-----------------------------------------||------------------------||-------|||||||------------SS----##-------------------------
----------------%-%-------------------%%%----------------------||-----%------------------||-------|||||||-----------------###-----%-------------------
---------------------------------------|---------------------U-||------------------------||-----U-|||||||-----------------###-------------------------
---------------------------------------|-----------------------||------------------------||-------|||||||-----------------###----------------------F--
--M------------------------------------|-----------------------||------------------------||-------|||||||-------------r---###----------------------#--
XXXX--------XXX-------------XXXXX-X--%-|---XXX-XXX-XXXXXX----%%%%%-XX---X-XXXXX-XX-XX----||--X--%%%%%%%%%%---XXXXX--XXXX-XXXXX--------X-X---XX-XX-XXXX
XXXX--------XXX-------------XXXXX-X----|---XXX-XXX-XXXXXX-----|||--XX---X-XXXXX-XX-XX----||--X---||||||||----XXXXX--XXXX-XXXXX--------X-X---XX-XX-XXXX
