------------------------------------------------------------------------------------------------------------------------------------------------------
------------------------------------------------------------------------------------------------------------------------------------------------------
------------------------------------------------------------------------------------------------------------------------------------------------------
------------------------------------------------------------------------------------------------------------------------------------------------------
------------------------------------------------------------------------------------------------------------------------------------------------------
--------------------------------------------------oooooo-----ooo------------------------%------------------------------------%%%-------------%%%------
---------#---------------####---------------------%%%%%%-----%%%----o---------------------------------------------------------|---------------|-------
---------#---------------####--%-------------------||||-------|--------------%------------------------------------------------|---------------|-------
--------##--------------#####----------------------||||-------|------------------------------------------------%--------------|-----%---------|-------
--------##--------------#####----------------------||||-------|------------------------%------------------------------------%-|-------------%-|-------
-------###-------%-----######----------------------||||-------|---%--%---------------%-----------%----------------------------|-----------%---|-------
-------###-------------######--------------------U-||||-----U-|---------------------------------------------------------------|---------------|-------
-------###-------------######----------------------||||-------|---------------------------------------------------------------|---------------|----F--
-M-----###-------------######----------------------||||-------|------------%---%------%---------------------------------%--%--|------------%--|----#--
XXXX-XXXXXX-X-XX---X-XXXXXXXXX------X-X--XX-XX-X-%%%%%%%-XX-%%%%-------XX--------XXX---------X--%-----XXXX--X-----X-X---------|--XX-----------|---XXXX
XXXX-XXXXXX-X-XX---X-XXXXXXXXX------X-X--XX-XX-X--|||||--XX--||--------XX--------XXX---------X--------XXXX--X-----X-X---------|--XX-----------|---XXXX
