-----------------------------------------------------------------------------------------------------------------------------------------------------------------------------------------------------
-----------------------------------------------------------------------------------------------------------------------------------------------------------------------------------------------------
-----------------------------------------------------------------------------------------------------------------------------------------------------------------------------------------------------
-----------------------------------------------------------------------------------------------------------------------------------------------------------------------------------------------------
-----------X-----------------------------------------------------------------------X---------------------X----------------------------------------X----------------------------------------X---------
-----------X-----------------------------------------------------------------------X---------------------X----------------------------------------X----------------------------------------X---------
-----------X-S------------QQ-----S------------QQ----S---S----S---------------------X-S-------------------X--------------------------------------S-X-S------------S----------------USS------X---------
-----------X-----------------------------------------------------------------------X---------------------X----------------------------------------X----------------------------------------X---------
-----------X-----------------------------------------------------------------------X---------------------X----------------------------------------X------------------------------------g---X---------
-----------X-------------------------------------------------------------------E---X---------------------X----------------------------------------X------------------------------------#---X---------
-----------X--------------?Q------------------?Q----------S-------------C---T-TT---X---------------------X----T-----------C-----------------------X---------------------------S-------##---X---------
---------#-X--------------------------------#-------------------------------T-TT---X-----------g---------X----T-----T--------#--------------T-----X---------g----------------------t--##---X---------
---------#-X-----------------------K--------#-------------------------------T-TT---X-----------TT--------X----T-----T--------#--------------T-----X---------TT---------------------t--##---X-----F---
--M------#-X------g--g-g--------------------#--------------------------gg---T-TT---X-----------TT-k------X----T---g-T----gg--#-----------g--T-----X---------TT------g-----------g--t--##---X-----X---
XXXX-XXX-XXXXXXXXXXXXXXXXXXXXXXXXXXXXXXXXXX-XXXXXXXX-XXXXXXXXXXXXXX--XXXXXXXXXXXXXXXX-XX-XXX-XXXXXXXXXXXXXXXXXXXXXXXXXXXXXXX-XXXXXXXXXXXXXXXXXXX-XXXXXXXX-XXXXXXXXXXXXXXXXXX-XXXXXXXXXXXXXXXXXXXXXXXX
XXXX-XXX-XXXXXXXXXXXXXXXXXXXXXXXXXXXXXXXXXX-XXXXXXXX-XXXXXXXXXXXXXX--XXXXXXXXXXXXXXXX-XX-XXX-XXXXXXXXXXXXXXXXXXXXXXXXXXXXXXX-XXXXXXXXXXXXXXXXXXX-XXXXXXXX-XXXXXXXXXXXXXXXXXX-XXXXXXXXXXXXXXXXXXXXXXXX
