------------------------------------------------------------------------------------------------------------------------------------------------------------------------------------------------------------------------------
------------------------------------------------------------------------------------------------------------------------------------------------------------------------------------------------------------------------------
------------------------------------------------------------------------------------------------------------------------------------------------------------------------------------------------------------------------------
------------------------------------------------------------------------------------------------------------------------------------------------------------------------------------------------------------------------------
------------------------------------------------------------------------------------------------------------------------------------------------------------------------------------------------------------------------------
------------------------------------------------------------------------------------------------------------------------------------------------------------------------------------------------------------------------------
-------------------------------------------------------------------Q------------------------------------------Q----------------------------------------Q-----------------Q-------------------------------Q--------------------
--------------------o----------------------------o-------------------------------------------------------------------------------o-----------------------------------------------o-----o-------------------------o------------
------------------------------------------------------------------------------------------------------------------------------------------------------------------------------------------------------------------------------
------------------------------------------------------------------------------------------------------------------------------------------------------------------------------------------------------------------------------
-----------------------------------------Q------------------Q------?---------------------C-------------------Q?------o---------------------------------Q---------------T-Q-------------------------------Q--T-----------------
------------------------T--T------------------T------------------------------------------------------------------------------------------------------------T------#----T---------------------------#--------T-----------------
------------------------T--T------------------T------------------------------------------------------------------------------------------------------------T-T----#----T---------------------------#--------T-------------F---
-M-y--------------y-----T--T----y-------------T------------------------------------------------------------------------------------------------------------T-T----#----T------y--------------------#--------T-------------#---
XXXXXXXXX-XXXXXXXXXXXXXXXXXXXXXXXXXXXXX-XXXXXXXXXXXXXXXXX-XXXXXXXXXXXXXXXXXXX-X-XXXXXXXXXXXXXXXXXX-XXXXXXXXXXXXXXXX-XXXXXXXXXXXXXXX--XXXXXXX-X-XXXXXXXXXXXXXXXXXXXXXX-XXXXX-XXXXXXXXXXXXXXXXXXXXX-XX-XXXXXXXXXXXXXXXXXXXXXXXXX
XXXXXXXXX-XXXXXXXXXXXXXXXXXXXXXXXXXXXXX-XXXXXXXXXXXXXXXXX-XXXXXXXXXXXXXXXXXXX-X-XXXXXXXXXXXXXXXXXX-XXXXXXXXXXXXXXXX-XXXXXXXXXXXXXXX--XXXXXXX-X-XXXXXXXXXXXXXXXXXXXXXX-XXXXX-XXXXXXXXXXXXXXXXXXXXX-XX-XXXXXXXXXXXXXXXXXXXXXXXXX
