---------------------------------------------------------------------------------------------------------------------------------------------------------------------
---------------------------------------------------------------------------------------------------------------------------------------------------------------------
---------------------------------------------------------------------------------------------------------------------------------------------------------------------
---------------------------------------------------------------------------------------------------------------------------------------------------------------------
------o------------------------o---------------------------------------------------------------o-----------------------------o-----------------------o---------o-----
---------------------------------------------------------------------------------------------------------------------------------------------------------------------
-------%%%%%%%------------------%-------------------------S----------SSS-----%%%%%--------------%---------------------S---o---%-------------------SS--%---------%----
----S---|-|-|-----------------------------------------------------SS-----S----|||-----------------------------------------S------------------------------------------
--------|-|-|-----------------------------------------------o-----------------|||------------------------------------------------------------------------------------
--------|-|-|-----------------------------------------------------------------|||-------------------------------------------------------------oo---------------------
--------|-|-|------------------------------------------S-%--S--------------SS-|||%%%%%%--%%%-%-----------------------------------------------------------------------
--------|-|-|-----------------------------------------------------------------|||-||-|----|--------------------------------------------------------------------------
--------|-|-|-----------------------------------------------------------------|||-||-|----|------------------------------------------------------------------------F-
-M------|-|-|-----------------------------------------------------------------|||-||-|----|------------------------------------------------------------------------X-
XXX-----|-|-|-XXXXXXXXXXXXXXXX---XXXXXXXXXXXXXXXXXXXX----------%%%%----------%%%%%||-|%%%%|-%----XXXXXXXXXXXXXXXXXXXX----%-----XXXXX-%%%%%%%%%%%%%%----XXXXXX----XXXX
XXX-----|-|-|-XXXXXXXXXXXXXXXX---XXXXXXXXXXXXXXXXXXXX-----------||------------|||-||-|-||-|------XXXXXXXXXXXXXXXXXXXX----------XXXXX--||-||||||-||-----XXXXXX----XXXX
