-------------------------------------------------------------------------------------------------------------------------------------------------------------------------------------------
-------------------------------------------------------------------------------------------------------------------------------------------------------------------------------------------
-------------------------------------------------------------------------------------------------------------------------------------------------------------------------------------------
S---SSSSSSS-SSSSSSSSSSSSSSSSSSSSSSSSSSSSSSSSSSSS--SSSSSSSSSSSSSSSSSSSSSSSSSSSSSSSSSSSSSSSS-SSSSSSSSSSSSSSSSSSSSSSS------SSSSSS-SSS-SSSSSSS---SSSSSSSSSSSSSSSSSSSSSSSSSSSSSSSSSSSSSSSSSS-SSS
S------------------------------------------------------------------------------------------------------------------------------------------------------------------------------------------
S------------------------------------------------------------------------------------------------------------------------------------------------------------------------------------------
S---------------------------------------------------Q----------------------------------------------------------------CSS---------------------------------QQ-----Q--------------------------
S------------------------------------------------------------------------------------------------------------------------------------------------------------------------------------------
S--------------------------------------------------------------------------------------------------------------------2---------------------------------------------------------------------
S---------------------------S---------------------------------------------------------------------------------------2-2--------------------------------------------------------------------
S--------QQ-----------------------------------QQ----Q----------T-----------T-------------S-----------------------------2---QQQ---S-------Q---------------QQ-----Q--------T------------S---F
S------------#---------T---------------#----------------T------T-----------T-----------------------T-------------#--------------------TT-----------------------------#---T--T--T---T-----SS
S------------#---------T-------t------##----------------T------T-----------T-----------------------T-------------#--------------------TT--------------------t-------##---T--T--T---T-----SS
S-M----------#--------kT-----k-t-k---###----------------T------T-----------T----------k------------T-------------#--------------------TT-------------k-k----t-------##---T--T--T---T-----SS
XXXXXXXXXXX--X-X-XXXXXXXXXXXXXXXXXXXXXXX-XX-XXXX---XXXXXXXXXXXXX-X-XXX--XX-X--X-X---XXXXXX--X-X--XXXXXXXXXXXXX-X-X--XXXXXXXXXX--XX--XXXXXX----XXX-X-XXXXXXXXXXXXXXXXXX-XXX-XXXXXX-XXXXX--XX
XXXXXXXXXXX--X-X-XXXXXXXXXXXXXXXXXXXXXXX-XX-XXXX---XXXXXXXXXXXXX-X-XXX--XX-X--X-X---XXXXXX--X-X--XXXXXXXXXXXXX-X-X--XXXXXXXXXX--XX--XXXXXX----XXX-X-XXXXXXXXXXXXXXXXXX-XXX-XXXXXX-XXXXX--XX
