-----------------------------------------------------------------------------------------------------------------------------------------------------------------------------------------------------
-----------------------------------------------------------------------------------------------------------------------------------------------------------------------------------------------------
-----------------------------------------------------------------------------------------------------------------------------------------------------------------------------------------------------
-----------------------------------------------------------------------------------------------------------------------------------------------------------------------------------------------------
-------------------------------------------------------------------------------X--------------------------------------X------------------------------------------------------------------------------
-------------------------------------------------------------------------------X--------------------------------------X------------------------------------------------------------------------------
--------------------------------------------------SS--------------S------------X---S-------------------------------S--X--S--S-SS------------------C-------------------------------------S-?----S-----
-------------------------------------------------------------------------------X--------------------------------------X------------------------------------------------------------------------------
-------------------------------------------------------------------------------X--------------------------------g-----X------------------------------------------------------------------------------
------------------E------------------------------------------------------------X-------------E------------------#-----X---------------T------------------------------T-------------------------------
--------T--------TT-------#---------------------------------T----------T-------X------------TT----T------------##-----X-------------S-T------Q---SS----T-------------T-Q-----------------------------
--------T----T---TT----T--#--------------#------------------T----------T-------X------------TT----T------------##-----X---------------T----------------T----g-----T--T------g---g--------------------
------#-T----T---TT----T--##--------K----#----#-------------T----------T-------X------------TT----T------------##-----X---------------T----------------T----TT----T--T------TT--TT---------------F---
--M--##-T----T---TT----T--##--g----------#---##---------k---T--------g-T--g-g--X------------TT----T----------g-##-----X----------g----T----g--g---k-g--T----TT----T--T--g---TT--TT-------K-------X---
XXXXXXXXXXXXXXXXXXXXXXXXXXXXXXXX-XXXXXXX-XXXXXXXXXXXX-XXXXXXXXXXXXXXXXXXXXXXXXXXXXXXXXXXXXXXXXXX-XXXXXXXXX-XXXXXXXXXXXXXX-XXXXXXXXXXXXXXXXXXXXXXXXXXXXXXXXXXXXXXXXXXXXXXXXXXXXXXXXXXX-XXXXXXX-XXXXXXX
XXXXXXXXXXXXXXXXXXXXXXXXXXXXXXXX-XXXXXXX-XXXXXXXXXXXX-XXXXXXXXXXXXXXXXXXXXXXXXXXXXXXXXXXXXXXXXXX-XXXXXXXXX-XXXXXXXXXXXXXX-XXXXXXXXXXXXXXXXXXXXXXXXXXXXXXXXXXXXXXXXXXXXXXXXXXXXXXXXXXX-XXXXXXX-XXXXXXX
