------------------------------------------------------------------------------------------------------------------------------------------------------
------------------------------------------------------------------------------------------------------------------------------------------------------
------------------------------------------------------------------------------------------------------------------------------------------------------
-------------------------------------o--oooo----------------------------------------------------------------------------------------------------------
-------------------g-g--------------------------------------------------------------------------------------------------------------------------------
-----------------%%%%%%%%%%%%%---------------%-R---------------------------R--------oo----------------------------------oooor---------------oo--------
------------------|||||-|-|-|------------------------------------------------------------------------------------------%%%%%%-------------------------
------------------|||||-|-|-|-------------------------------------------------------------------------------------------||||--------------------------
------------------|||||-|-|-|-------------------------------------------------------------------------------------------||||--------------------------
----------------%-|||||-|-|-|------%%%%%%%%%%-------------------S----S------------------------------S----S--------------||||--------------------------
---------%--------|||||-|-|-|-------||-|||||-----------------------------------------SS-----------%----%-------------%%%%%%%%%%%-------------SS-------
------------------|||||-|-|-|-------||-|||||--------------------------------------------------------------------------|||||||-|-----------------------
------------------|||||-|-|-|-------||-|||||--------------------------------------------------------------------------|||||||-|--------------------F--
-M-------------%--|||||-|-|-|-----%-||-|||||----------------------%----%----------------------------------------------|||||||-|--------------------#--
XXX---XX-----X----|||||-|-|-|--XX---||-|||||------%----X-X---XX----------X---%--X--------XXX-X-X------%----XXXX-X--X--|||||||-|-----X-XXX--------XXXXX
XXX---XX-----X----|||||-|-|-|--XX---||-|||||-----------X-X---XX----------X------X--------XXX-X-X-----------XXXX-X--X--|||||||-|-----X-XXX--------XXXXX
