---------------------------------------------------------------------------------------------------------------------------------------------------------------------
---------------------------------------------------------------------------------------------------------------------------------------------------------------------
---------------------------------------------------------------------------------------------------------------------------------------------------------------------
---------------------------------------------------------------------------------------------------------------------------------------------------------------------
-------o---------------------o--------------------------------------o------------o---------------------o-----------------------------------o------------o------------
---------------------------------------------------------------------------------------------------------------------------------------------------------------------
--------%---------------------%%%----------------------------S-------%------------%-----------o--S------%%%%%%%------------------S----------%-----S---S--%-----------
-------------------------------|--------------------------S--------------------------------S--S-----SS---|||-|--------------------------------------S----------------
-------------------------------|-------------------------------------------------------------------------|||-|-------------------------------------------------------
-------------------------------|-------------------------------------------------------------------------|||-|-------------------------------------------------------
---------------------------%---|----------------------------------S-------------------------------%------|||-|-------------------------%%%---------------------------
-------------------------------|-------------------------------S-----------------------------------------|||-|---------------------S----|----------------------------
-------------------------------|-------------------------------------------------------------------------|||-|--------------------------|--------------------------F-
-M-----------------------------|-------------------------------------------------------------------------|||-|--------------------------|--------------------------X-
XXXXX----XXXXXXXXXXXXXXXXX-----|-XXXXXXXXXXXXXXXXXXXXXXX--------------XXXXXXXXXX---XXXXXXX---%-----------|||-|-XXXXXXXXXXXXXXXXX------%-|----XXXX---------XXXXXXXXXXX
XXXXX----XXXXXXXXXXXXXXXXX-----|-XXXXXXXXXXXXXXXXXXXXXXX--------------XXXXXXXXXX---XXXXXXX---------------|||-|-XXXXXXXXXXXXXXXXX--------|----XXXX---------XXXXXXXXXXX
