----------------------------------------------------------------------------------------------------------------------------------------------------------------------------------------------------
----------------------------------------------------------------------------------------------------------------------------------------------------------------------------------------------------
----------------------------------------------------------------------------------------------------------------------------------------------------------------------------------------------------
----------------------------------------------------------------------------------------------------------------------------------------------------------------------------------------------------
----------------------------------------------------------------------------------------------------------------------------------------------------------------------------------------------------
----------------------------------------k-----------------------------------------------------------------------------------------------------------------------------------------------------------
--------------------------------S------##-------------------------------------------S-------------------------S------------------S------------------------------------------------------------------
--------------------------------------###-----------------------------------------------------------------------------------------------------------------------------------------------------------
-------------------------------------####-----------------------------------------------------------------------------------------------------------------------------------------------------------
-------------------------------------####---------------Q-------------------------------------------------------------------------------------------------------------------------------------------
-------T------------------T-----S----####----T-------------T-----------S------------S-----T-T-----------------S----SS------------S--------S-------------T----------------SCS--------S----------S----
-------T------------------T---------#####----T-------------T------------------------------T-T-----------------------K-------------------------T---------T------------------K------------------------
-------T------------------T---------#####----T-------------T------------------------------T-T--------------------------------------T---T------T---------T----------------------------------T-----F--
-M-----T----------g-----k-T--k------#####--g-T-k-k---------T------g-g---------------------T-T--------------------g-----g-g-gg------T---T------T--------gT-------------k--K--------g-K--k---T-----#--
XXXXXXXXX-XXXXXX-XXXXX-XXXXXXXXXXXXXXXXXXXXXXXXXXXX---XXXXXXXXX-XXXXXXXXXXXXXXXXXX-XXXXX-XXXXXXXX-XXXXX-XXXXXXXXXXXXXXXXXXXXXXX-XXXXXXXXXXXXXXXXXXXXX-XXXXXXXXXXXXXX-XXXXXXXX-XXXXXXXXXXXXXXXXXXXXXX
XXXXXXXXX-XXXXXX-XXXXX-XXXXXXXXXXXXXXXXXXXXXXXXXXXX---XXXXXXXXX-XXXXXXXXXXXXXXXXXX-XXXXX-XXXXXXXX-XXXXX-XXXXXXXXXXXXXXXXXXXXXXX-XXXXXXXXXXXXXXXXXXXXX-XXXXXXXXXXXXXX-XXXXXXXX-XXXXXXXXXXXXXXXXXXXXXX
