----------------------------------------------------------------------------------------------------------------------------------------------------------------------------------------------------------
----------------------------------------------------------------------------------------------------------------------------------------------------------------------------------------------------------
----------------------------------------------------------------------------------------------------------------------------------------------------------------------------------------------------------
----------------------------------------------------------------------------------------------------------------------------------------------------------------------------------------------------------
----------------------------------------------------------------------------------------------------------------------------------------------------------------------------------------------------------
--------------------------------------------------------------------------------------------------------------------------------------g-------------------------------------------------------------------
-------------------------SS--------------------------------------S--------------------S-------SS----S-----------------------S--------SSS---------S-@-----------------------------S-SS-----SSS-------------
----------------------------------------------------------------------------------------------------------------------------------------------------------------------------------------------------------
----------------------------------------------------------------------------------------------------------------------------------------------------------------------------------------------------------
----------------------------------------------------------------------------------------------------------------------------------------------------------------------------------------------------------
--------------------S--S---------t---------t-t---------S----------------#---!---------------------t----------------S-------------------------------!------S---------#--#-------------------------#--------
---------------------------------t---------t-t------------t---------t---#-------------------------t-----------------------------------------------------------------#--#-------------------------#--------
---------------------------------t---------t-t---t---t----t---------t---#-------------------------t---------------------------t-------------t-----------------------#--#-t-----------------------#----F---
---M-------------g---------------t---------t-t---t---t----t--#------t---#--------------g----------t--------g-----g------------t----------gg-t---g-------------g-----#--#-t-------------g-----g---#----#---
XXXXXXXXXXXXX-XXXXXXXXXXXX--XXXXXXXXXXXXXXXXXXXXXXXXXXXXXXXXXXXXXXXXXX-XXXXXXXXXXXXXXXXXXXXXXXXXXXXXXXXXX-XXX-XXXXXXXXXXXXXXXXXX-XXXXXXXXXXXXXXXXXXXXXX-XXXXXXXXXXXXXXXXXXXXXXXXXXXXXXXXXXXXXXXXXXXXXXXXXX
XXXXXXXXXXXXX-XXXXXXXXXXXX--XXXXXXXXXXXXXXXXXXXXXXXXXXXXXXXXXXXXXXXXXX-XXXXXXXXXXXXXXXXXXXXXXXXXXXXXXXXXX-XXX-XXXXXXXXXXXXXXXXXX-XXXXXXXXXXXXXXXXXXXXXX-XXXXXXXXXXXXXXXXXXXXXXXXXXXXXXXXXXXXXXXXXXXXXXXXXX
