----------------------------------------------------------------------------------------------------------------------------------------------------------------------------------------------------------
----------------------------------------------------------------------------------------------------------------------------------------------------------------------------------------------------------
----------------------------------------------------------------------------------------------------------------------------------------------------------------------------------------------------------
----------------------------------------------------------------------------------------------------------------------------------------------------------------------------------------------------------
----------------------------------------------------------------------------------------------------------------------------------------------------------------------------------------------------------
----------------------------------------------------------------------------------------------------------------------------------------------------------------------------------------------------------
------S---S---------------SS---S--S--S---------S--------------------------S-----------@---------------------------S--SSS--SS---------S----------------------SSS----------------S-----------S------------S-
----------------------------------------------------------------------------------------------------------------------------------------------------------------------------------------------------------
----------------------------------------------------------------------------------------------------------------------------------------------------------------------------------------------------------
---------------------------------------------------------------------------------------------------------------------------------------------1------------------------------------------------------------
----------------#-------S-----------------#-------#-----------------#-S--------S------!---------#--S-S-----------------------------t---#-------------------------S---t--!-#------------#------------------
----------------#-------------------------#-------#-----------------#---------------------------#----------------------------------t---#-----------------------------t----#------------#--------t---------
----------------#-------------------------#-------#---t-------------#---------------------------#----------------------------------t---#-----------------------------t----#------------#--------t-----F---
---M-------g-g--#-g-----------------------#-------#---t----------#--#---g---------#------#------#---------gg-------g----g----------t---#--------#-------#------------t--k-#-#----------#-----g--t---#-#---
XXXXXXXXXXXXXXX-XXXXXXXXXXXXXXXXXXXXXXXXXXXX-XXXXXXXXXXXXXXXXXXXXXXXXXXXXXXXXXXXXXXXXXXXXXXXXXXXXXXXXXXX-XXXXXXXXXXXXXXXXXXXXX-XXXXXXXXXXXXXXXXXXXXXXXXXXXXXXXXXXXXXXXXXXXXXXXXXXXXXXXXXXXXXXXXXXXXXXXXXXX
XXXXXXXXXXXXXXX-XXXXXXXXXXXXXXXXXXXXXXXXXXXX-XXXXXXXXXXXXXXXXXXXXXXXXXXXXXXXXXXXXXXXXXXXXXXXXXXXXXXXXXXX-XXXXXXXXXXXXXXXXXXXXX-XXXXXXXXXXXXXXXXXXXXXXXXXXXXXXXXXXXXXXXXXXXXXXXXXXXXXXXXXXXXXXXXXXXXXXXXXXX
