----------------------------------------------------------------------------------------------------------------------------------------------------------------------------------------------------
----------------------------------------------------------------------------------------------------------------------------------------------------------------------------------------------------
----------------------------------------------------------------------------------------------------------------------------------------------------------------------------------------------------
----------------------------------------------------------------------------------------------------------------------------------------------------------------------------------------------------
----------------------------------------------------------------------------------------------------------------------------------------------------------------------------------------------------
-----------------------------------------------------------------------------------------------------------------------------------------------------------------------k----------------------------
---S-------S----------S---------S----US------------------------S-------------------------------------------------------S-------------SC-------------------------------##-----S-------S---------S----
---------------------------------------------------------------------------------------------------------------------------------------------------------------------###----------------------------
--------------------------------------------------------------------------------------------------------------------------------------------------------------------####----------------------------
-----------------------------------------?-------------------------------------------------------------------------------------------SS-----------------------------####---------?------------------
---S---S-S-S--------Q-S---------S---#----------------T-----S---S---SS-------------T-----Q---------S--S-------T---------S--#-------S------SS-------------------------####-----S-----Q-S---------S----
------------------------------------#----------------T------------------------T---T--------------------------T------------#---T-----------K------------------------#####----------------------------
------------------------------------##---------------T------------------------T---T--------------------------T------------#---T------------------------------------#####-------------------------F--
-M-g---K-K-g------g---g------k------##-g----------k--T-----K---g--K------g----T---T-------k----------K-------T---------g--#---T---K------------------------------g-#####--------------------g----#--
XXXXXXXXXXXXXXXXXXXXXXXXX-XXXXXXXXX-XXXXXXXX-X-XXXXXXXXXXXXXXXXXXXXXXXXXXXXX-XXXXXXXX-XXXXXX-XXXXXXXXXXXXXX-XXXXXXXXXXXXX-X-XXXXXXXX---XXXXXXXXXXXXXXXXXXXXX--XXXXXXXXXXX--XXXXXXXXXXXXXXXXXXXXXXXXX
XXXXXXXXXXXXXXXXXXXXXXXXX-XXXXXXXXX-XXXXXXXX-X-XXXXXXXXXXXXXXXXXXXXXXXXXXXXX-XXXXXXXX-XXXXXX-XXXXXXXXXXXXXX-XXXXXXXXXXXXX-X-XXXXXXXX---XXXXXXXXXXXXXXXXXXXXX--XXXXXXXXXXX--XXXXXXXXXXXXXXXXXXXXXXXXX
