------------------------------------------------------------------------------------------------------------------------------------------------------
------------------------------------------------------------------------------------------------------------------------------------------------------
------------------------------------------------------------------------------------------------------------------------------------------------------
------------------------------------------------------------------------------------------------------------------------------------------------------
--------------------------------------------------------g---g-g---------------------------------------------------------------------------------------
----------------------ooo------------------------R----%%%%%%%%%%%-----R-------------------------------------------------------------------------------
----------g-----------%%%------------------------------|||-|||||--------------------------------------------------------------------------------------
--------%%%%-----------|-------------------------------|||-|||||---------------------------------------------------------%----------------------------
---------||------------|-------------------------------|||-|||||-------------------------------%-----------------------------%------------------------
---------||------------|-----------------------------%-|||-|||||-------------------------------------------------------------------S------------------
-----%---||------------|---------------%-----------%---|||-|||||---------------------%-------------------------------------%--------------------------
---------||----------U-|-------------------------------|||-|||||--------------------------------------------------------------------------------------
---------||------------|-------------------------------|||-|||||-----------------------------------------------------------------------------------F--
-M-------||------------|----------------------------%--|||-|||||---------------%%%--o----%---------------------------------------------------------#--
XXX-%----||--X---X---%%%%--X-%%%--XX-----XXX-X-%-------|||-|||||--%-%-----XXX---|---%-------XX---XXXX--XX-%--X-XXXX-X-%--------XX--------X-XX--X-XXXXX
XXX------||--X---X----||---X--|---XX-----XXX-X---------|||-|||||----------XXX---|-----------XX---XXXX--XX----X-XXXX-X----------XX--------X-XX--X-XXXXX
