-------------------------------------------------------------------------------------------------------------------------------------------------------------------------------------------------------------------------------------------------------------------------------------------------------------------------------------------------------------------------------------
-------------------------------------------------------------------------------------------------------------------------------------------------------------------------------------------------------------------------------------------------------------------------------------------------------------------------------------------------------------------------------------
-------------------------------------------------------------------------------------------------------------------------------------------------------------------------------------------------------------------------------------------------------------------------------------------------------------------------------------------------------------------------------------
-------------------------------------------------------------------------------------------------------------------------------------------------------------------------------------------------------------------------------------------------------------------------------------------------------------------------------------------------------------------------------------
-------------------------------------------------------------------------------------------------------------------------------------------------------------------------------------------------------------------------------------------------------------------------------------------------------------------------------------------------------------------------------------
---------------------------------------------------------------------------------------------------------------------o---------------------------------------------------------------------------------------------------------------------------------------------------------------------------------------------------------------------------------------------------------------
-------------------------------------------------------------------------------------------------------------------------------------------------------------------------------------------------------------------------------------------------------------------------------------------------------------------------------------------------------------------------------------
-------------------------------------------------------------------------------------------------------------------------------------------------------------------------------------------------------------------------------------------------------------------------------------------------------------------------------------------------------------------------------------
-------------------------------------------------------------------------------------------------------------------------------------------------------------------------------------------------------------------------------------------------------------------------------------------------------------------------------------------------------------------------------------
--------S----1----------------------------------------------S---------------------------------------------------------------------------------------o---------------------------------------------------SS-----------------o----------------S---------------------S---------------------S-----------o-----------------SS-------------------------------------------------------------
----------#---------------------------------T------------------------------------------------------------T--------#--------------------------------------------------------------------------------------------------------------------------------------T---#---------------#------------#-----------------------------------------------------------------------#------------T-----
----------#---------------------------------T-----------------------T------------------------------------T--------#------T-------------------------------------T----------T-------T----------------------------------T-----------------------------------T---#---------------#------------#-T---------------------------------------------------------------------#------------T-----
------#---#---------------------------------T-----------------------T-----#-----------#------------------T--------#------T-------T-----------t-----------------T----T-----T-------T----------------------------------T-------------------------#-T-------T---#---------------#------------#-T-----------------#---------------------------------------------------#------------T-F---
-M----#---#---k---------g--g---k------g--k--T--k--kk-k--------gggg--T-----#---------kk#-gg--------g------T------g-#--gg--T--g----T----k-k-k--t----g------------T----T--g--T-------T-----k--g------g----------k-------T-g-----g----g------------#-T--k----T---#-k----g--------#------------#-T---------------g-#----g-----------k-------------g----k--------k---kk-#----g-k-g---T-#---
XXXXXXXXXXXXXXXXX-XXXXXXXXXXXXXXXXXXXXXXXXXXXXXXXXXXXXXXXXXXXXXXXXXXXXXXXXXXXXXXXXXXXXXXXXX-XX-XXXXXXXX-XXXXX--XXXXXXXXXXX-XXX-XXXXXXXXXXXXXXXXXXXXXXXXX-XXXXXXXXXXXXXXXXXXXX-XXXXXXXXXXXXXXXXXXXXXXXXXXXXXXXXXXXXX-XXXXXXXXXXX--XXXXXXXX--XXXXXXXXXXX-XXX-XXXXXXXXXXXXX-XXXXXXX-XXXXXXXXXX-XXXXXXXXXXXXX--XXXX-XXXXXXXXX-X--XXXXXXXXXX-XXXXXXXXXXXXXXXXXXXXXXXXXXXXXXXXXXXXXXXXXXXXX
XXXXXXXXXXXXXXXXX-XXXXXXXXXXXXXXXXXXXXXXXXXXXXXXXXXXXXXXXXXXXXXXXXXXXXXXXXXXXXXXXXXXXXXXXXX-XX-XXXXXXXX-XXXXX--XXXXXXXXXXX-XXX-XXXXXXXXXXXXXXXXXXXXXXXXX-XXXXXXXXXXXXXXXXXXXX-XXXXXXXXXXXXXXXXXXXXXXXXXXXXXXXXXXXXX-XXXXXXXXXXX--XXXXXXXX--XXXXXXXXXXX-XXX-XXXXXXXXXXXXX-XXXXXXX-XXXXXXXXXX-XXXXXXXXXXXXX--XXXX-XXXXXXXXX-X--XXXXXXXXXX-XXXXXXXXXXXXXXXXXXXXXXXXXXXXXXXXXXXXXXXXXXXXX
