------------------------------------------------------------------------------------------------------------------------------------------------------
------------------------------------------------------------------------------------------------------------------------------------------------------
------------------------------------------------------------------------------------------------------------------------------------------------------
---------------------------------------------------------------------o----------------------------------------------------ooo-------------------------
----------------------------------------------------------------------------g-------------------------g----g-----------------------g----g-------------
-----------------R-----------------------------------------------------%%%%%%---------------------%%%%%%%%%%------------------%%%%%%%%%%%-------------
--------------------------------------------------------#---------------||||---oo------------------||||||||--------------------|||||||||--------------
---------%----------------------------------------------#---------------||||-----------------------||||||||--%-----------------|||||||||--------------
-------------------------------------------------------##---------------||||--------%--------------||||||||--------------------|||||||||--------------
-------------------------------------------------------##----------%%%%-||||----SS---------------%-||||||||-------------%%%%%%-|||||||||--------SS----
-----%--------------%---%--------%----------%%%-------###--%--------||--||||--%--------------------||||||||-----------%--||||--|||||||||--------------
---------------------------------------------|--------###-----------||--||||-----------------------||||||||--------------||||--|||||||||--------------
---------------------------------------------|--------###-----------||--||||-----------------------||||||||--------------||||--|||||||||-----------F--
--M----------------------%-%-----------------|--%-----###---------%-||--||||------------------%%%--||||||||------------%-||||--|||||||||---------r-#--
XXXX---X------X-------X------XXX----XX-XX-X--|----XX-XXXXX---X------||--||||-----------X--XX---|---||||||||----XXX--%----||||--|||||||||----X--XXXXXXX
XXXX---X------X-------X------XXX----XX-XX-X--|----XX-XXXXX---X------||--||||-----------X--XX---|---||||||||----XXX-------||||--|||||||||----X--XXXXXXX
