--------------------------------------------------------------------------------------------------------------------------------------------------------------------------------
--------------------------------------------------------------------------------------------------------------------------------------------------------------------------------
--------------------------------------------------------------------------------------------------------------------------------------------------------------------------------
--------------------------------------------------------------------------------------------------------------------------------------------------------------------------------
--------------------------------------------------------------------------------------------------------------------------------------------------------------------------------
----------------------------------k--------------------------k------------------------------------------------------------------------------------------------------------------
---------S------------------------##-------------------------##----------------USS---------------S---------------S-----------------------------S----S-S-------------------------
---------------------------------###------------------------###-----------------------------------------------------------------------------------------------------------------
--------------------------------####-----#-----------------####-----------------------------------------------------------------------------------------------------------------
-------------------------------#####----##----------------#####-----------------------------------------------------------------------------------------------------------------
-----Q---S--------------------######---###---------------######----------------------------------S-Q-------Q-----S-----------------------------S----S-S-------------Q-----Q-----
--------------------B--------#######--####--#-----T-----#######-----B-----------B--------------------#-------------#---T--------------------T-------------------T-------------T-
--------------------b--------#######--####--#-----T-----#######-----b-------T---b-------B------------#---------B---#---T---------------B----T-------------------T-----------F-T-
-M------------------b--------#######--####--#-----T-----#######-----b-------T---B-------b------------#---------b---#---T---------------b----T-----------k-------T-----------#-T-
XXXXXXXXXXXXXXX-XXXXXXXXXXXXXXXXXXXXXXXXXXXXXXXXXXXXXXXXXXXXXXXXXXXXXXXXXXXXXXXXXXXXXXXXXXXXXXXXXXXXXXXXXXXXXXXXXXXXXXXXXXXXXXXXXXXXXXXXXXXXXXXXXX-XXXXXXXXXX-XXXXXXXXXXXXXXXXXX
XXXXXXXXXXXXXXX-XXXXXXXXXXXXXXXXXXXXXXXXXXXXXXXXXXXXXXXXXXXXXXXXXXXXXXXXXXXXXXXXXXXXXXXXXXXXXXXXXXXXXXXXXXXXXXXXXXXXXXXXXXXXXXXXXXXXXXXXXXXXXXXXXX-XXXXXXXXXX-XXXXXXXXXXXXXXXXXX
