--------------------------------------------------------------------------------------------------------------------------------------------------------------
--------------------------------------------------------------------------------------------------------------------------------------------------------------
--------------------------------------------------------------------------------------------------------------------------------------------------------------
S----SSSSSSSSSSSSSSSSLSSSSSSSSSSSSSSSSSSSSSSSSSSSSSSSSSSSSSSSSSSSSSSSSSSSSSSSSSSSSSSLSSSSSSSSSSSSSSSSSS--SSLSSSSSSSSSSSSSSSSSSSSLSSSSSSSLSSSSSSSSS------------
S----------------SS----SS---SSSS------------------------------------------------SS--------------------------------S-SS-------S---------------SS---------------
S----------------SS----SS---SSSS------------------------------------------------SS-----g--------------------------S-SS-------S---------------SS---------------
S-------------------oo--------SS---------------------------------------------------oo-SS------------------oo-----S----------S--oo------oo---------------------
S-----------------------------SS------------------------------------------------------SS-------------------------S----------S---------------------------------
S-------------------SS--------SS---------------------------------------------------SS-SS------------------SS-----S----------S--SS------SS---------------------
S----------------oU-SS-g----ooSS------------------------------------------------oU-SS-SC------------------SS-----S--oU------S--SS------SS----oU---------------
S-------#-----T--SS----SS---SSSS------------------------------------------------SS----SS-#-@Q-T-------#----------SS-SS------SS----#----------SS--#------------
S-------#-----T----------------------------------#-------------------#-#-----------------#----T-------#-----------S-----S----S----#--------------#------------
S-------#-----T-------------------#--------------#---------T---------#-#-----------------#----T--#-T--#-----------S-----S----S----#-g------------#------------
S--M----#---g-T----------------g--#--g-----g---g-#---------T--g------#-#-g--g------------#----T--#-T--#--------g--------S---------#-#-----g------#----------F-
XXXXXXXXXXXXXXXXXXXXXXXXX-XXXXXXXXXXXXXXXXXXXXXXXXXX-XXXXXXXXXXXXXXXXXXXXXXXXXXXXXXXXXXXXXXXXXXXXXXXXXX-XXXXXXXXXXXXXXX-X-XXXXXXXXXXXXXXXXXXXXXXXX-XX-XXXXXXXX
XXXXXXXXXXXXXXXXXXXXXXXXX-XXXXXXXXXXXXXXXXXXXXXXXXXX-XXXXXXXXXXXXXXXXXXXXXXXXXXXXXXXXXXXXXXXXXXXXXXXXXX-XXXXXXXXXXXXXXX-X-XXXXXXXXXXXXXXXXXXXXXXXX-XX-XXXXXXXX
