------------------------------------------------------------------------------------------------------------------------------------------------------
------------------------------------------------------------------------------------------------------------------------------------------------------
------------------------------------------------------------------------------------------------------------------------------------------------------
------------------------------------------------------------------------------------------------------------------------------------------------------
-------------------------------------------------------------------------------------------------------------------------------g----------------------
---------oo------------------------------------------------------------------------------------------------------------------%%%%%--------------------
---------------------######---------------------------------------------------------------------------------------------------|||---------------------
---------------------######--------------------------------------------%-----------------------------%-------------%----------|||---------------------
--------------------#######---------------------------------------------------S-----S-----------------------------------------|||---------------------
--------------------#######---S---------------------------S-----------------------------------------------------------------%-|||--------S------------
-------------------########----------%%%--------------%--------------%-----------------------------------------%--------------|||--%------------------
-------------------########-----------|---------------------------------------------------------------------------------------|||---------------------
----------%%%------########-----------|---------------------------------------------------------------------------------------|||------------------F--
-M---------|-------########---------o-|--------------------------%-------------r-----r---------------------------%-----%%%%%--|||---------------%--#--
XXX--XXX---|----X-XXXXXXXXXXX----X--%-|----%-XXX-X----------%%%------------X-XXXXX-XXXX-XXXX--XXXXX----XXXXX--%------X--|||---|||-----X----XX-X---XXXX
XXX--XXX---|----X-XXXXXXXXXXX----X----|------XXX-X-----------|-------------X-XXXXX-XXXX-XXXX--XXXXX----XXXXX---------X--|||---|||-----X----XX-X---XXXX
