--------------------------------------------------------------------------------------------------------------------------------------------------------------------------------
--------------------------------------------------------------------------------------------------------------------------------------------------------------------------------
--------------------------------------------------------------------------------------------------------------------------------------------------------------------------------
--------------------------------------------------------------------------------------------------------------------------------------------------------------------------------
--------------------------------------------------------------------------------------------------------------------------------------------------------------------------------
--------------------------------------------------------------------------------------------------------------------------------------------------------------------------------
----------------------------------------------------S-----------------------------S-----------------------------------------USS-------------------------S-----------------S-----
--------------------------------------------------------------------------------------------------------------------------------------------------------------------------------
---------------------------#-----------------------------------------------------------#------------#---------------------------------B-----------------------------------------
--------------------------##----------------------------------------------------------##-----------##---------------------------------b-----------------------------------------
-------------------------###------------------------S--------------Q--------------S--###----------###--------------------------------S#CS---------------S-----------------S-----
----#------------#------####----------T--K---------------B-T-----K------------------####---------####--------------K---------B-------------------#----#-------T------K----------
----#----------T-#------####-------B--T----B-----------B-b-T----------------T-------####---------####----B--T------------T---b----------K------T-#----#-------T-------------F---
-M--#----------T-#------####-------b--T----b-----------b-B-T----------------T-------####---------####----b--T------------T---B-----------------T-#----#-------T-------------#---
XXXXXXXXXXXXXXXXXXXXXXXXXXXXXXXXXXXXXXXXXXXXXXXXXXXXXXXXXXXXXXXXXXXXXXXXXXXXXXXXXXXXXXXXXXXXXXXXXXXXXXXXXXXXXXXXXXXXXXXXXXXXXXXXX-XXXXXXXXXXXXXXXXXXXXXXXXXXXXXXXXXXXXXXXXXXXXXX
XXXXXXXXXXXXXXXXXXXXXXXXXXXXXXXXXXXXXXXXXXXXXXXXXXXXXXXXXXXXXXXXXXXXXXXXXXXXXXXXXXXXXXXXXXXXXXXXXXXXXXXXXXXXXXXXXXXXXXXXXXXXXXXXX-XXXXXXXXXXXXXXXXXXXXXXXXXXXXXXXXXXXXXXXXXXXXXX
