--------------------------------------------------------------------------------------------------------------------------------------------------------------------------------
--------------------------------------------------------------------------------------------------------------------------------------------------------------------------------
--------------------------------------------------------------------------------------------------------------------------------------------------------------------------------
--------------------------------------------------------------------------------------------------------------------------------------------------------------------------------
--------------------------------------------------------------------------------------------------------------------------------------------------------------------------------
--------------------------------------------------------------------------------------K-----------------------------------------------------------------------------------------
---------------S--------------------S-USS--------------S-------S-S------S------------SSS----S-------S-----------------------------S--------------------------S------------S-----
--------------------------------------------------------------------------------------------------------------------------------------------------------------------------------
------------------------------------------------------------------------------------------------------------------------B-----------------B---------------------B---------------
------------------------------------------------------------------------------------------------------------------------b-----------------b---------------------b---------------
------------QQ-S----------Q---------S------------------S-------S-S------S--Q---------SSS----S-------S-----------Q------S#CS-----Q-S------S#CS----------------S-S#CS-------S-----
---------T--------#--------------------B--------T-------------------------------------------------------B---#-----T-#-------#--------------------T--------B---------------------
---------T--------#-T------------------b---T----T---------T---------------------------------------------b---#-----T-#-----K-#---------------K----T--------b-------K---------F---
-M-------T--------#-T------------------B---T----T---------T---------------------------------------------b---#-----T-#-------#--------------------T--------b-----------------#---
XXXXXXXXXXXXXXXXXXXXXXXXXXXXXXXXXXXXXXXXXXXXXXXXXXXXXXXXXXXXXXXXXXXXXXXXXXXXXXXXXXXXXXXXXXXXXXXXXXXXXXXXXXXXXXXXXXXXXXXXXXXXXXXXXXXXXXXXXXXXXXXXXXXXXXXXXXXXXXXXXXXXXXXXXXXXXXXX
XXXXXXXXXXXXXXXXXXXXXXXXXXXXXXXXXXXXXXXXXXXXXXXXXXXXXXXXXXXXXXXXXXXXXXXXXXXXXXXXXXXXXXXXXXXXXXXXXXXXXXXXXXXXXXXXXXXXXXXXXXXXXXXXXXXXXXXXXXXXXXXXXXXXXXXXXXXXXXXXXXXXXXXXXXXXXXXX
