----------------------------------------------------------------------------------------------------------------------------------------------------------------------------------------------------
----------------------------------------------------------------------------------------------------------------------------------------------------------------------------------------------------
----------------------------------------------------------------------------------------------------------------------------------------------------------------------------------------------------
----------------------------------------------------------------------------------------------------------------------------------------------------------------------------------------------------
----------------------------------------------------------------------------------------------------------------------------------------------------------------------------------------------------
---------------------------------------------------------------------------------------------------------------------------------------------------------k------------------------------------------
---------------------------S---S--S---S------SC-----------------------S-------SC--------------S-S-------------------------S------------------------S----##-------USSSSSSSSSSSSSS--------------------
-------------------------------------------------------------------------------------------------------------------------------------------------------###------------------------------------------
------------------------------------------------------------------------------------------------------------------------------------------------------####------------------------------------------
---------------------------------------------SS-------------------------------SS----------------------------------------------------------------------####------------------------------------------
---------------------------S---S--S---S---------------------S---------S---S----------S--S-----S-S-S----SS---T-S----TT-----S---S---SCS-SS--SS-------S--####---Q--#------------------T-----S----------
-------------------------------------------------------------------------------------------T------------K-T-T------TT---------------K--K---K---------#####------#------------------T-------T--------
----------------------------------------------------------------T--------------------------T--------------T-T------TT--------------------------------#####------##-----------------T-------T-----F--
-M-g-----------------------g--------------------k---g---g-------T---------K-------------K--T------K-------T-T-K----TT---------K---K------------------#####------##--------------g--T-------T-----#--
XXXXXXXXXXXXXXXXXXXXX-XXXXXXX-XXXXXXXXXXXXX----XXXXXXXXXXXXXXXXXXX-XXXXXXXXXX---XXXXXXXXXXXXXXXXXXXXXXXXXXXXXXXXXXXXXXXXXXXXXXXXXXXXXXXXXXXXX-X-XXXXXXXXXXX-XXX-XXXXXXXXXXXXXXXXXXXXXXXXXXXXX-XXXXXX
XXXXXXXXXXXXXXXXXXXXX-XXXXXXX-XXXXXXXXXXXXX----XXXXXXXXXXXXXXXXXXX-XXXXXXXXXX---XXXXXXXXXXXXXXXXXXXXXXXXXXXXXXXXXXXXXXXXXXXXXXXXXXXXXXXXXXXXX-X-XXXXXXXXXXX-XXX-XXXXXXXXXXXXXXXXXXXXXXXXXXXXX-XXXXXX
