------------------------------------------------------------------------------------------------------------------------------------------------------------------------------------------------------
------------------------------------------------------------------------------------------------------------------------------------------------------------------------------------------------------
------------------------------------------------------------------------------------------------------------------------------------------------------------------------------------------------------
------------------------------------------------------------------------------------------------------------------------------------------------------------------------------------------------------
------------------------------------------------------------------------------------------------------------------------------------------------------------------------------------------------------
------------------------------------------------------------------------------------------------------------------------------------------------------------------------------------------------------
----------------------------------------------------------#------------#--------------------------------------------------------------------------------#---------------------------------------------
----------------------------------------------------------#------------#--------------------------------------------------------------------------------#---------------------------------------------
----------------------------------------------------------#------------#---------------------------------------------------------------T----------------#---------------------------------------------
----------------------------------------------------------#------------#---------------------------------------------------------------T----------------#---------------------------K-----------------
----------------------------------------------------------#------------#---------------------------------------------------------------#----------------#---------------------------------------------
----------------------------------------------------------#------------#----------------K---------------------------------------------------------------#-----------------------------#---------------
---------------------------------------------------------------------------------------------*-----------------------*--------------------*------------------------------------------##-----------F---
-M--------------gg--g-----------g-------ggg--------k-----------g--k-----------k----k---------*-K-k--------------g----*---------gg----g----*-----------------g---------g-gg-k-k----g-###------gg---#---
XXXXXXXXXXXXXXXXXXXXXX-XXXXX-XXXXXXXXXXXXXXXXXXXXXXXXXXXXXXXXXXXXXXXXXXXXXXXXXXXXXXXXXXXXXXXXXXXXXXXXXX-XX-XXXXXXXXXXXXXXXXXXXXXXXXXXXXXXXXXXXXXXXXXXXXXXXXXXXXXXXXXXXXXXXXXXXX-XXXXXXXXXXXXXXXXXXXXXX
XXXXXXXXXXXXXXXXXXXXXX-XXXXX-XXXXXXXXXXXXXXXXXXXXXXXXXXXXXXXXXXXXXXXXXXXXXXXXXXXXXXXXXXXXXXXXXXXXXXXXXX-XX-XXXXXXXXXXXXXXXXXXXXXXXXXXXXXXXXXXXXXXXXXXXXXXXXXXXXXXXXXXXXXXXXXXXX-XXXXXXXXXXXXXXXXXXXXXX
