----------------------------------------------------------------------------------------------------------------------------------------------------------------------------------------------------------
----------------------------------------------------------------------------------------------------------------------------------------------------------------------------------------------------------
----------------------------------------------------------------------------------------------------------------------------------------------------------------------------------------------------------
-------------------------SSSSSS-------SS------------------------------------------------------------------------------SSSSSS-------SS-----------SSSSSSSSSSSSSSS-------------------------------------------
-----------------------------------------------------------------------------------------------------------------------S----------------------------------------------------------------------------------
------------------------------------------------R------------------------------------------------------------o---------S----------------------------------------------------------------------------------
------------------S----S-----------------------------------------------------------S-----------Q--------S----------US----------------------------------------------S------S-----------------SS------------
----------------------------T-----------------------------------------------------------------------------------------------------------------------------------------------------------------------------
----------------------------T------------------------------------------------------------------------------------------------------------------------U----------------------------------------------------
----------S-----------------T------------oo--------------------#-----------------#------------------------S------------o---------------------S-------S------------------S------------o---------S----------
--------------------------SCT-#--------#-----------------------#---#-------------#-------T-----?------------------S----S------------#---------------SS--------S-------------------------------------#-----
----------------------------T-#--------#-------------#----K----#---#-------------#---y---T-----------T---------------------##-------#----------------------S----------#-------------------B---------#-----
-------#--------------------T-#--------#-------------#---------#---#---T---------#---#---T-----------T----------#----------##-------#----------------------S-----T----#-------------------b-T-------#---F-
-M-----#--r---------K-y----kT-#--------#-------g-----#g--------#--r#---T---------#k--#---T-----------T----------#-K--------##-K-----#---------y----------k-S-----T---g#------g------------b-Tg---g--#---X-
XXX-%--XXXXX-XX-XX-XX-X-XXXXXXX-XXXX-XXX--XXXXXX-XXXXXXXXXX-XXXXXXXXX-XXXX-XXXXXXXX--XXXXXXXXXXXXXXXXXXXXXXX--XXX-XXXXXX--XXXXXXXXXXX--XX-XX--XXX--XXXXX-X-X-XX-XXXXXXX-XXXXXXXX-XX-X-XXXXXXXXXXXXXXXXXXXX
XXX----XXXXX-XX-XX-XX-X-XXXXXXX-XXXX-XXX--XXXXXX-XXXXXXXXXX-XXXXXXXXX-XXXX-XXXXXXXX--XXXXXXXXXXXXXXXXXXXXXXX--XXX-XXXXXX--XXXXXXXXXXX--XX-XX--XXX--XXXXX-X-X-XX-XXXXXXX-XXXXXXXX-XX-X-XXXXXXXXXXXXXXXXXXXX
