----------------------------------------------------------------------------------------------------------------------------------------------------------------------------------------------------------
----------------------------------------------------------------------------------------------------------------------------------------------------------------------------------------------------------
----------------------------------------------------------------------------------------------------------------------------------------------------------------------------------------------------------
-------SSSSLSS----------------SSSSSS--------------SSSSSSS--------------------------------------------------SSSS---------------------------SS-------SS-----------------------------------------------------
----------------------------------------------------------------------------------------------------------------------------------------------------------------------------------------------------------
----------------------------------------------------------------------------------------------------------------------------------------------------------------------------------------------------------
--------oooo------SS----S-----------------------------Q-------S----S-------------------------------------S----------S-----------S------------------------S---------------------S--------------------------
------------------------------------------------------------------------------o-------------------------------------------------------------------------------------------o-------------------------------
--------SSSS-------------------------------------------------------------y--------------------------------------------------------------------------------------------------------------------------------
--------SSSS----S--------------------------------------------------------#------o--------------------S--------------------------------------------------------------o-S-#---------------------------------
--------------------------SC-------Q----%-%-----------Q-Q-----S----------#-------------Q------T----------S-------Q-------------------------Q-----S--Q-------------------#--------S---S----T---------T-----
-------------##----------K----------------------T------------------------#-----#--T-----------T---------------#------------T------------------------------------#-------#-----------------T---------T-----
-------------##---------------------------------T------------------------#--#--#--T-------S---T---------------#--------B---T--------------------------------T---#-------#-----------------T---t-----T-F---
--M----------##kr----------g---------------%----T------------g-----------#--#--#--T-----------T---------------#--------b---T----------g------o--------------T---#g------#---------y-------T---t-----T-#---
XXXXXXXXXXXXXXXXXX--XXXXXXXXXXXXXXXX-XX--%---X-XXXX-XXXXX-XXXXXXXXXXXXXXXXXXXXXXXXX-XXXXX--XXXXXXXXXXXXXXXXXXXX-XXXXXXXXXXXXXX-XXXXX-XXX-XXX-%-XXXXXX--XX-XXXXXXXXXX-XXXXXXXX-XXXXXX-XXXXXXXXXXXXXXXXXXXXX
XXXXXXXXXXXXXXXXXX--XXXXXXXXXXXXXXXX-XX------X-XXXX-XXXXX-XXXXXXXXXXXXXXXXXXXXXXXXX-XXXXX--XXXXXXXXXXXXXXXXXXXX-XXXXXXXXXXXXXX-XXXXX-XXX-XXX---XXXXXX--XX-XXXXXXXXXX-XXXXXXXX-XXXXXX-XXXXXXXXXXXXXXXXXXXXX
