----------------------------------------------------------------------------------------------------------------------------------------------------------------------------------------------------
----------------------------------------------------------------------------------------------------------------------------------------------------------------------------------------------------
----------------------------------------------------------------------------------------------------------------------------------------------------------------------------------------------------
----------------------------------------------------------------------------------------------------------------------------------------------------------------------------------------------------
----------------------------------------------------------------------------------------------------------------------------------------------------------------------------------------------------
----------------------------------------------------------------------------------------------------------------------------------------------------------------------------------------------------
----------S--------S------------------------S----------SC------------------------------------------------S-S-S------------SSC------------------S-----S----------------------S--S--------------------
----------------------------------------------------------------------------------------------------------------------------------------------------------------------------------------------------
----------------------------------------------------------------------------------------------------------------------------------------------------------------------------------------------------
-------------------------------------------------------SS-----------------------------------------------------------------SSS-----------------------------------------------------------------------
--------Q-S---T----S--S---------------------S-------------T---------------S-----SS----------S------------S-S-S---------------------#---SS------S-----S----S--------------S--S--S-------------S------
--------------T----------T-------T-T----------------------T----------------------K------------------TTTT-------T-------------------#----K----------T------------------------------------------------
--------------T----------T-------T-T-T--------------------T-------------------T---------------------TTTT-------T-------------------#---------------T---------------------------------T-----------F--
-M--------g---T----g-----T----g--T-T-T--------------------T--g------g-----K-k-T----------g----g-----TTTT-g-----T---------------k---#---------------T---------------------K-----------T----g--K---#--
XXXXXX-XXXXXXXXXX-XXXXXXXXXX-XXXXXXXXXXXXXXXXX-XXXXX-X---XXXXXXXX-XXXXX-XXXXXXXXXXXXXXXXXXXXXXXXXXXXXXXXXXXXXXXXXXXX-XXXX----XXXXX-X-XXXXXXXX-XXX-XXXXX-XXXXXXXXXXXXXX-XXXXXXXXXXX-XXXXXXXXXXXX-XXXX
XXXXXX-XXXXXXXXXX-XXXXXXXXXX-XXXXXXXXXXXXXXXXX-XXXXX-X---XXXXXXXX-XXXXX-XXXXXXXXXXXXXXXXXXXXXXXXXXXXXXXXXXXXXXXXXXXX-XXXX----XXXXX-X-XXXXXXXX-XXX-XXXXX-XXXXXXXXXXXXXX-XXXXXXXXXXX-XXXXXXXXXXXX-XXXX
