-----------------------------------------------------------------------------------------------------------------------------------------------------
-----------------------------------------------------------------------------------------------------------------------------------------------------
-----------------------------------------------------------------------------------------------------------------------------------------------------
-----------------------------------------------------------------------------------------------------------------------------------------------------
-----------------------------------------------------------------------------------------------------------------------------------------------------
-----------%------%-------------------------------------------------------------------------------------------------------------------o--------------
-----------------------------------------------------S-------------------------------------------------------------------------------%%%----o--------
--------o------o------o---o---o-o-------------------------o-----------------------o--------------------ooo-----R-------------------S--|--o-----------
-------%%%----%%%----%%%-%%%-%%%%%-%-------------SS------%%%-----------------SS-------------------------------------------------SS----|-%%%----------
--------|------|------|---|---|-|---------------------S---|---------------------------------------------------------------------------|--|--SS-------
--------|------|------|---|---|-|-------------------------|---------------------------------------------%%%%------------r-r-----------|--|-----------
--------|------|------|---|---|-|-------%%%%%%%%%%--------|---%%%%%%%%%%%%%%%%---------------------------||------%%%%%%%%%%%%%%%%-----|-o|-----------
--------|------|------|---|---|-|--------||||||||---------|----||||||||||||||----------------------------||-------||||||||||||||------|%%%%%-------F-
-M------|------|------|---|---|-|--------||||||||---------|----||||||||||||||----%%%%%%%%%%%%%%%%%%%%%%%-||-------||||||||||||||------|-|||--------#-
XXX----%%%%%%%%%%%%%%%%%%%%%%%%%%%%%%%%%-||||||||------X-%%%%%-||||||||||||||-----|||||||||||||||||||||--||-------||||||||||||||------|-|||---XXXXXXX
XXX-----||||-||||||-|||||||||||||||||-|--||||||||------X--|||--||||||||||||||-----|||||||||||||||||||||--||-------||||||||||||||------|-|||---XXXXXXX
