-------------------------------------------------------------------------------------------------------------------------------------------------------------------------------------------------------------------------------------------------------------------------------------------------------------------------------------------------------------------------------------
-------------------------------------------------------------------------------------------------------------------------------------------------------------------------------------------------------------------------------------------------------------------------------------------------------------------------------------------------------------------------------------
-------------------------------------------------------------------------------------------------------------------------------------------------------------------------------------------------------------------------------------------------------------------------------------------------------------------------------------------------------------------------------------
-------------------------------------------------------------------------------------------------------------------------------------------------------------------------------------------------------------------------------------------------------------------------------------------------------------------------------------------------------------------------------------
-------------------------------------------------------------------------------------------------------------------------------------------------------------------------------------------------------------------------------------------------------------------------------------------------------------------------------------------------------------------------------------
---------------------------------------------------------------------------------------------------------------------------------------------------------------------------------------------------------------------o-----------------------------------------o---------------------------------------------------------------------------------------------------------------------
-------------------------------------------------------------------------------------------------------------------------------------------------------------------------------------------------------------------------------------------------------------------------------------------------------------------------------------------------------------------------------------
-------------------------------------------------------------------------------------------------------------------------------------------------------------------------------------------------------------------------------------------------------------------------------------------------------------------------------------------------------------------------------------
-------------------------------------------------------------------------------------------------------------------------------------------------------------------------------------------------------------------------------------------------------------------------------------------------------------------------------------------------------------------------------------
---------------------------------------------------------------------------o-------S--------------------------------------------------o---------------------------------------------------------------------o---1--------------------------------o-----------o-----S----S-------S-----------o------------------------------------------S---------------------------------------------
------------#--T-----------T------------------------------------T---------------------T---------T---------T-------------------------------------------------------T--T--T----TT--T-------------------------------------------------------------------------------------------------------------#-T-----------------T--------#--------------T-----------------------------------------
------------#--T---------T-T------------------------------------T---------------------T---------T---------T-T-------T---------------------------------------------T--T--T----TT--T----------------------------------------------------T---------------------------------------------T----T-----#-T-------T---------T--------#--------K-----T------------------------------T----------
---T--------#--T---------T-T-----------------K------------------T--#---------T--------T---------T---------T-T-------T---------------------------#------#----------T--T--T----TT--T--------------#-------------------------------#-----T-------------------------------------------T-T----T-----#-T-------T---------T--------#--------------T-------------#----t-----------T-#----F---
-M-T------k-#--T----k----T-T---k-k--k----------------g---g---g--T--#---------T--------T---------T-----g-g-T-T-----g-T---gg---g--------------ggg-#----k-#----ggg-g-T--T--T----TT--T--k--g--k-----#----------------k---gg--------k#-----T---------------g----g---gg-----------k-----T-T----T-----#-T-------T---------T---g----#----g---------T-------------#----t---g-------T-#----#---
XXXXXX-XXXXXXXXXXX-XXXXXXXXXXXXXXXXXXXXXXXXX-X-XXXXXXXXXXXXXXXXXX-XXXXXXXXXXXXXXXXXXXXXXXXXXXXXXXXXXXXXXXXXXXXXXXXXXXX-XXXXXXXXXXXX-XXXXXX-XXXXXX-XXXXXXXXXXXXXXXXXX-X-XXXXXXXXXXXXXXXXXXXXXX-XXXXXXX-XXXXXXXXXXXXXXXXXXX-XXXXXXXXXXXXXXXXXXXXX----XXXXX-XXXXXXXXXXXXXXXXXXXXXXXXXXXXXXXXXX---XXXX-XXXX-XXX-XXXX-XXXXXXXXXXXXXXXXXXXX-XXXXXXXXX-XXXXXXXXXX--XXXXXXXXXXXXXXXXX-X-XXXXX
XXXXXX-XXXXXXXXXXX-XXXXXXXXXXXXXXXXXXXXXXXXX-X-XXXXXXXXXXXXXXXXXX-XXXXXXXXXXXXXXXXXXXXXXXXXXXXXXXXXXXXXXXXXXXXXXXXXXXX-XXXXXXXXXXXX-XXXXXX-XXXXXX-XXXXXXXXXXXXXXXXXX-X-XXXXXXXXXXXXXXXXXXXXXX-XXXXXXX-XXXXXXXXXXXXXXXXXXX-XXXXXXXXXXXXXXXXXXXXX----XXXXX-XXXXXXXXXXXXXXXXXXXXXXXXXXXXXXXXXX---XXXX-XXXX-XXX-XXXX-XXXXXXXXXXXXXXXXXXXX-XXXXXXXXX-XXXXXXXXXX--XXXXXXXXXXXXXXXXX-X-XXXXX
