--------------------------------------------------------------------------------------------------------------------------------------------------------------
--------------------------------------------------------------------------------------------------------------------------------------------------------------
--------------------------------------------------------------------------------------------------------------------------------------------------------------
S----SSSSSSSSSSSSSSSSSSSSSSSSSSSSSSSSSSSSSSSSSSSSSSSSSSSSSSSSSSSSSSSSSSSSSSSLSSSSSSSSSSSSSSSSSSSSSSSSSLSSSSSSSSSSS--SSSSSSSSSSSSSSSSSSSSSSSSSSSSSSSSSS--------
S----------------------------------------SS----------------------SS----------------------SS-----------------SSS-----------------------SS----------------------
S------g---------------------------------SS----------------------SS----------------------SS-----------------SSS-----------------------SS----------------------
S-----SS-------------------------------------------------------------------oo------------------------oo------SS----------------------------------------S------
S-----SS-----------------------------------------------------------------------------------------------------SS-----------------------------------------------
S-----SS-------------------------------------------------------------------SS------------------S-U---SS------SS-----------------------------------------------
S-----SC------------------------C--------g----------C------------oU--------SS------------oU----SoS---SS-----oSS-----------------------oU----------------------
S-----SS---------------------T----T------SS----------------------SS------------------#---SS----SSS----------SSS--#---------------#----SS----##-------#--------
S---------#------------------T----T--------------------------T-----------------------#-#-------------------------#--------T------#----------##-T-----#--------
S---------#-#-#--#-----------T----T-----------T----------#-g-T---------T---------g---#-#-------------------------#--------T------#--g-------##-T-----#-S------
S--M------#-#-#--#------g-g--T--E-T-----------T-----E----#-#-T---------T---------#---#-#----------------------g--#-----g--T---g--#--#-------##-T-----#------F-
XXXXXXXXXXXXXXXXXXXXXXXXXXXXXXXXXXXXXXXXXXX--XXXXXXXXXXXXXXXXXXXXXXX--XXXXXXXXXXXXX-XXXXXXXXXXXXXXXXXXXX---XXXXXXX-XX-XXXXXXXXXXXXXXXXXXXXXXXXXXXXXXXX----XXXX
XXXXXXXXXXXXXXXXXXXXXXXXXXXXXXXXXXXXXXXXXXX--XXXXXXXXXXXXXXXXXXXXXXX--XXXXXXXXXXXXX-XXXXXXXXXXXXXXXXXXXX---XXXXXXX-XX-XXXXXXXXXXXXXXXXXXXXXXXXXXXXXXXX----XXXX
