------------------------------------------------------------------------------------------------------------------------------------------------------------------------------------------------------------------------------
------------------------------------------------------------------------------------------------------------------------------------------------------------------------------------------------------------------------------
------------------------------------------------------------------------------------------------------------------------------------------------------------------------------------------------------------------------------
------------------------------------------------------------------------------------------------------------------------------------------------------------------------------------------------------------------------------
------------------------------------------------------------------------------------------------------------------------------------------------------------------------------------------------------------------------------
------------------------------------------------------------------------------------------------------------------------------------------------------------------------------------------------------------------------------
---------------------------------------------------------------------------------------------------------Q------------------------Q-------------------------------------------------------------------------------------------
-----o------o-----------------------------------------------------------------------------------o----------------------------------------------oo--o----------------o-----------o----o----o-----------------------------------
------------------------------------------------------------------------------------------------------------------------------------------------------------------------------------------------------------------------------
------------------------------------------------------------------------------------------------------------------------------------------------------------------------------------------------------------------------------
---------------Q---T-------------Q--------------T--------------------------------------------------------Q------------------------Q-------------------Q--o----------------------------------------T------------------Q------T-
-------------------T----------------------------T-----------------------------#---T----------------------------------------------------------T------------------------------------#---------------T-------------------------T-
-------------------T----------------------------T----------------------------##---T----------------------------------T-----------------------T------------------------------------#---------------T-----------------------F-T-
-M-----------------T-------------------y--------T---------------------------###---T-y---------y--------------------y-T------------------y----T------------------y-----------------#-------------y-T------y----------------#-T-
XXXXXXXXXXXXXXXXXXXXXX-XXXXXXXXXXXXXXXXXXXXXX-XXXXX-XXXXXXXXX-XXXXXXX-XXXXXXXXXXXXXXXXXXX-XXXXXXXXXXXXXXXXXXXXXXXXXXXXXXXXXXXXXXXXXXXXXXXXXXXXXXXXXXXXXXXXXXXXXXXXXXXXXXXXXXXX-XXXX-XXXXXXXXXX-XXXXXXXXXXXXXXXXXXXX-XXXXXXXXXX
XXXXXXXXXXXXXXXXXXXXXX-XXXXXXXXXXXXXXXXXXXXXX-XXXXX-XXXXXXXXX-XXXXXXX-XXXXXXXXXXXXXXXXXXX-XXXXXXXXXXXXXXXXXXXXXXXXXXXXXXXXXXXXXXXXXXXXXXXXXXXXXXXXXXXXXXXXXXXXXXXXXXXXXXXXXXXX-XXXX-XXXXXXXXXX-XXXXXXXXXXXXXXXXXXXX-XXXXXXXXXX
