--------------------------------------------------------------------------------------------------------------------------------------------------------------
--------------------------------------------------------------------------------------------------------------------------------------------------------------
--------------------------------------------------------------------------------------------------------------------------------------------------------------
S----SSSSSSSSSSSSSSSSSSSSSSSSSSSSSSSSSSSSSSSSLSSSSSSSSLSSSSSSSSSSSSSSSSSSSSSSSSSSSSSSSSSSSSSSSSSSSSSSSSSSSSSSSSSSSSSLSSSSSSSSSSSSSSSSSSSSSSLSSSSSSSSSSSSSS----
S-------------------------------------------------SS----------SSSSSS--------------S---------SSSS---------------------------------------------SS---------------
S-------------------------------------------------SS----------SSSSSS--------------S---------SSSS---------------------------------------------SS---------------
S-------------------------------------------oo-------oo--------------------------S-----------S---------------------oo-------------------oooo------------------
S--------------------------------------------------------------------------------S-----------S----------------------------------------------------------------
S-------------------------------------------SS-------SS--------------------------S-----------S---------------------SS---------S-U-------SSSS------------------
S-------------------------------------------SS----oU-SS-------g-g-g--------------S----------oSoU-------------------SS---------SoS-------SSSS-oU---------------
S-----------------g#------#-----------------------SS----------SSSSSS-------------SS---------SSSS------------------------------SSS------------SS---#--T---#----
S----------#------##------#-----------#-------------------------------------------S----T-------------------------#--------#-T---------------------#--T-#-#----
S-----#----#-----###------#--g#-----#-#---------------------#---------------------S----T-------------------------#--------#-T---------------------#--T-#-#----
S--M--#----#-g---###------#-g##-----#-#-----------------g---#------------------------g-T------------g-g--------g-#-----g--#-T-----g---------------#--T-#-#--F-
XXXXXXXXXXXXXXXXXXXXXXXXXXXXXXXXX-XXXXXX--XXXXXXXXXXXXXXXXXXXXXXXXXX-XXXXXXXXXXXXXXXXXXXXXXXXXXXXXXXXXXXXXXXXXXXXXXXXXXXXXXXXXXXXXXXX-XXXXXXXXXXXXXXXXXXXX-XXX
XXXXXXXXXXXXXXXXXXXXXXXXXXXXXXXXX-XXXXXX--XXXXXXXXXXXXXXXXXXXXXXXXXX-XXXXXXXXXXXXXXXXXXXXXXXXXXXXXXXXXXXXXXXXXXXXXXXXXXXXXXXXXXXXXXXX-XXXXXXXXXXXXXXXXXXXX-XXX
