-------------------------------------------------------------------------------------------------------------------------------------------------------------------------------------------
-------------------------------------------------------------------------------------------------------------------------------------------------------------------------------------------
-------------------------------------------------------------------------------------------------------------------------------------------------------------------------------------------
S---SSSSSSSSSSSSSSSSSSSSS---------SSSSSSSSSSSSSSSSSSSS---SSSSSSSSSSSSSSSSSSSSSSSSSSSSSSSSSSSSSSSSSSSSSSSSSSSSSSSSSSSSSSSSSSSSSSSSSS---------SS-SSSSSSSSSSSSSSSSSSS--------SSSSSSSSSSSSSSSSS
S------------------------------------------------------------------------------------------------------------------------------------------------------------------------------------------
S------------------------------------------------------------------------------------------------------------------------------------------------------------------------------------------
S-----------------------------------Q-------------------------------------------------------------------------------------------------------S----------------------------------------Q-----
S------------------------------------------------------------------------------------------------------------------------------------------------------------------------------------------
S--------------------------SS-S-S----------------------S------------------------------------------------------------------------------S---S------------------------SS-S--------------------
S------------------------------------------------------------------------------------------------------------------------------------------------------------------------------------------
S--------------------T--Q-----------Q----------------S--------------------------T-----------------------------------T-------T-----Q---------SS------------T------Q-------------------Q----F
S-----------------T--T---------------------T-------------------TT-----#---------T---------------------------T-------T-------T------------------------#----T---------------------T--------SS
S------t----------T--T------------------t--T-------------------TT-----#---------T---------------------------T-------T-------T-----------------------##----T---------------------T--------SS
S-M----t----------T--T----------------k-t--T----kk-------------TT-----#---------T-----k-------------k-------T-------T-------T-----------------------##----T--------------------kT--------SS
XXXXXXXXXXXX-XX-XXXX-X-XX----------XXXXXXXXXXX-XXXXXXX----XX-XXXXX--X-X--X-X-X-XX-X-XXXXXXXX-X-XXX-XXX--X-XXXXX-XX--X---X-XXX-X-XXX---------XX--XXXXXX-X-XX--X-XXX---------XX-XXXXXXXXXX-XX
XXXXXXXXXXXX-XX-XXXX-X-XX----------XXXXXXXXXXX-XXXXXXX----XX-XXXXX--X-X--X-X-X-XX-X-XXXXXXXX-X-XXX-XXX--X-XXXXX-XX--X---X-XXX-X-XXX---------XX--XXXXXX-X-XX--X-XXX---------XX-XXXXXXXXXX-XX
