----------------------------------------------------------------------------------------------------------------------------------------------------------------------------------------
----------------------------------------------------------------------------------------------------------------------------------------------------------------------------------------
----------------------------------------------------------------------------------------------------------------------------------------------------------------------------------------
----------------------------------------------------------------------------------------------------------------------------------------------------------------------------------------
----------------------------------------------------------------------------------------------------------------------------------------------------------------------------------------
----------------------------------------------------------------------------------------------------------------------------------------------------------------------------------------
---------------------------------#---------------------#--------------------------------------------------------------------------------------------------------------------------------
---------------------------------#---------------------#--------------------------------------------------------------------------------------------------------------------------------
---------------------------------#---------------------#-------------------------------------------y------------------------------------------------------------------------------------
----------------o----------------#---------------------#-------------------------------------------XS-------o---------------------------------------------------------------------------
---------------------------------#--------------SC-----#-----------o------------Q---Q-----o-------XX-----o--------------------------------------------------------------#---------------
---------T-----------------------#----#-T--------------#-----------------------------------------XXX------------------------------------------------------------------y##---T---------T-
---------T-----------------------#---##-T--------------#----------------------------------------XXXX------------------------------------------------------------------###---T-------F-T-
----M----T------------------y----#------T--------------#-------------------------------y-------XXXXX------------------------y-------------------------------------y--####---T-------#-T-
XX-XXXX-XXX-X-XXXXXXXX-X-XXXXXXX-XX-XXXXXXXXXXX-XXXXXX-XXXXXX--X-XXXX-XXXXXXXXXXXX-XXXXXXXXXXXXXXXXX--XXXXXXXXXX-XXXX-XXXX-XXXXXXXXXXX-XXXX-XXXXXXXXXXXXX---X-XXXXXXXXXXX-XXXXXXXXXXXXXX
XX-XXXX-XXX-X-XXXXXXXX-X-XXXXXXX-XX-XXXXXXXXXXX-XXXXXX-XXXXXX--X-XXXX-XXXXXXXXXXXX-XXXXXXXXXXXXXXXXX--XXXXXXXXXX-XXXX-XXXX-XXXXXXXXXXX-XXXX-XXXXXXXXXXXXX---X-XXXXXXXXXXX-XXXXXXXXXXXXXX
