-----------------------------------------------------------------------------------------------------------------------------------------------------
-----------------------------------------------------------------------------------------------------------------------------------------------------
-----------------------------------------------------------------------------------------------------------------------------------------------------
-----------------------------------------------------------------------------------------------------------------------------------------------------
-----------------------------------------------------------------------------------------------------------------------------------------------------
-----------------------------------------------------------------------------------------------------------SSSS--------------------------------------
-------SSS--------S-o-------SSS----------------------------------------------------S--SS----SSS---------------------------------------------SS-------
----SS----------S-------------------o---------------ooo---------SS-R--o----ooo---S-----------------------g-------------------------------------------
-------------------------------------------------------------------------------------------------%-----%%%%----------------------------SS------------
----------S--------SSS---------S----------------------------------------------------S---S---------------||-----SSS----------------------------S------
-----------------------------------------------------%%%%-------------------%%%%--------------%%%-------||------------------r---r--------------------
------------------------------------------------------||---------------------||----------------|-----%%%||----------------%%%%%%%%%%%%%%-------------
------------------------------------------------------||---------------------||----------------|%%%---|-||-----------------||||||||||||------------F-
-M---------------------------------%%%%%%%%%%%%%%%%%%-||-------------%%%%%%%-||----------------|-|----|-||-----oo----------||||||||||||------------#-
XXX--------X------------------------||||||||||||||||--||--------------|||||--||----------XX----|-|----|-||----%%%-XXXXX--%-||||||||||||--------XXXXXX
XXX--------X------------------------||||||||||||||||--||--------------|||||--||----------XX----|-|----|-||-----|--XXXXX----||||||||||||--------XXXXXX
