---------------------------------------------------------------------------------------------------------------------------------------------------------------------
---------------------------------------------------------------------------------------------------------------------------------------------------------------------
---------------------------------------------------------------------------------------------------------------------------------------------------------------------
---------------------------------------------------------------------------------------------------------------------------------------------------------------------
-----o---------------------o------------------o---------------------------------------------------o-------------------------o-------------------------oo-------------
---------------------------------------------------------------------------------------------------------------------------------------------------------------------
------%--------SSS----------%%%%%%%------------%%%%%%%%%%%%%%%%-----------------------oo--------S--%%%%%---------S-----------%%%%%%%%%------------SSS---%------------
-----------------------------|||||--------------||-|||-|-|-|-|------------------------SS-S-S--------|-|-----------------------|||||-|-----S-S---S--------------------
-----------------------------|||||--------------||-|||-|-|-|-|----------------S---------------------|-|-------------o-S-S-----|||||-|--------------------------------
-----------------------------|||||--------------||-|||-|-|-|-|--------------------------------------|-|-----------------------|||||-|--------------------------------
------------------%----%%%---|||||--------------||-|||-|-|-|-|-------------------%%%%---------------|-|-----------%-S---------|||||-|---------S----------------------
---------------------S--|----|||||--------------||-|||-|-|-|-|--------------------||----------------|-|-----------------------|||||-|--------------------------------
------------------------|----|||||--------------||-|||-|-|-|-|--------------------||----------------|-|-----------------------|||||-|------------------------------F-
-M----------------------|----|||||--------------||-|||-|-|-|-|--------------------||----------------|-|-----------------------|||||-|------------------------------X-
XXX----XXXXXXX----------|----|||||-XXXXXXXXX----||-|||-|-|-|-|-XXXXXXXXXXX------%-||-%--------------|-|-XXXXXXXX--------------|||||-|-XX-----------------XXXXXXXXXXXX
XXX----XXXXXXX----------|----|||||-XXXXXXXXX----||-|||-|-|-|-|-XXXXXXXXXXX--------||----------------|-|-XXXXXXXX--------------|||||-|-XX-----------------XXXXXXXXXXXX
