---------------------------------------------------------------------------------------------------------------------------------------------------------------------
---------------------------------------------------------------------------------------------------------------------------------------------------------------------
---------------------------------------------------------------------------------------------------------------------------------------------------------------------
---------------------------------------------------------------------------------------------------------------------------------------------------------------------
--------o--------------------o----------------------o-----------o---------o-------------o------------------------o---o-----o-----o-----------------------------------
---------------------------------------------------------------------------------------------------------------------------------------------------------------------
---------%--------------------%%%%%%--------------S--%%%%%-------%---------%%%%%---------%%%----S------------So---%---%-----%-----%%%%%%%%%%%%-----------------------
-------------------------------||-|-------------------|-|----S--------------|-|-----------|----------SSSS--------------------------||-||||-||------------------------
-------------------------o-----||-|-------------------|-|-------------------|-|-----------|--------o-------------------------------||-||||-||------------------------
-------------------------------||-|-------------------|-|-------------------|-|-----------|----------------------------------------||-||||-||------------------------
-------------------------S-----||-|-------------S-----|-|-------------------|-|-----------|---%----S-----------S-------------------||-||||-||------------------------
------S------------------------||-|-------------------|-|-------------------|-|-----------|----------------S-----------------------||-||||-||------------------------
-------------------------------||-|-------------------|-|-------------------|-|-----------|----------------------------------------||-||||-||----------------------F-
-M-----------------------------||-|-------------------|-|-------------------|-|-----------|----------------------------------------||-||||-||----------------------X-
XXXX------XXXXXXXXXXXXXX-------||-|-XXXXXXXXXXX-------|-|-XX------XXXXXX----|-|-XXXXXXX---|-X----------------------X---XX----XX----||-||||-||-XXXXXXXXXXXXXXXXXXXXXXX
XXXX------XXXXXXXXXXXXXX-------||-|-XXXXXXXXXXX-------|-|-XX------XXXXXX----|-|-XXXXXXX---|-X----------------------X---XX----XX----||-||||-||-XXXXXXXXXXXXXXXXXXXXXXX
