----------------------------------------------------------------------------------------------------------------------------------------------------------------------------------------
----------------------------------------------------------------------------------------------------------------------------------------------------------------------------------------
----------------------------------------------------------------------------------------------------------------------------------------------------------------------------------------
----------------------------------------------------------------------------------------------------------------------------------------------------------------------------------------
----------------------------------------------------------------------------------------------------------------------------------------------------------------------------------------
----------------------------------------------------------------------------------------------------------------------------------------------------------------------------------------
---------------------------------------------------------------------------------#----#------------------------##-----------------------------------------------------------------------
---------------------------------------------------------------------------------#----#------------------------##-----------------------------------------------------------------------
--------------------------------------------------y--------y---------------------#----#------------------------##-----------------------------------------------------------------------
--------------------------------------------------XS-------XS--------------------#----#-----------------?Q-----##-oo-------------------------------------o------------------------------
------o------------------------------------------XX-------XX----------------SC---#----#------------------------##--------o---------Q-------Q----Q---------------------------SC----------
--------------------------------T---------------XXX------XXX---------------------#----#--T---T-----------------##-------------------------------------#---------------------------------
--------------------------------T--------------XXXX-----XXXX---------------------#----#--T---T-------------y---##------------------------------------##-----------------------------F---
----M--------------y--------y---T-------------XXXXX----XXXXX---------------------#----#--T---T----------SSSS---##--------------------------------------------y----y-----------------#---
XX-XXXXXX--XXX-X-XXXXX-XXXXXXXXXXXX-XX-XXXXXXXXXXXX--XXXXXXX--XXXXXXXXXX-XX-XXXX-XXXX-XXXXX-XXXXXX-XXXX----XXX-XXXXXX-XXXXXXXXX-XXXXX-XXXXXXXXXXXXX-XXXXXXXXXXX-XXXXXXX-XXX-XXX--XXXXXXX
XX-XXXXXX--XXX-X-XXXXX-XXXXXXXXXXXX-XX-XXXXXXXXXXXX--XXXXXXX--XXXXXXXXXX-XX-XXXX-XXXX-XXXXX-XXXXXX-XXXX----XXX-XXXXXX-XXXXXXXXX-XXXXX-XXXXXXXXXXXXX-XXXXXXXXXXX-XXXXXXX-XXX-XXX--XXXXXXX
