------------------------------------------------------------------------------------------------------------------------------------------------------
------------------------------------------------------------------------------------------------------------------------------------------------------
------------------------------------------------------------------------------------------------------------------------------------------------------
------------------------------------------------------------------------------------------------------------------------------------------------------
------------------------------------------------------------------------------------------------------------------------------------g-------g-g-------
--------------------------------------------------ooo-----------------------------------------------------------------------------%%%%%%%%%%%%%-------
------------------#----------------oo-------------%%%--------oo--------------------------------------------------oo----------------|||||||||||--------
------------------#---------------------------SSS--|-----------------%-------------------------------------------------------------|||||||||||--------
-----------------##-------------%------------------|---------------%---------------------------------------------------------------|||||||||||--------
-----------------##-----------------SS-------------|----------SS--------------------------------------------------SS-------------%-|||||||||||--------
----------------###---------------%----------------|---------------------------------------------------%-------------%-%---%-------|||||||||||--------
----------------###------------------------------U-|-------------------------------------------------------------------------------|||||||||||--------
----------------###--------------------------------|-------------------------------------------------------------------------------|||||||||||-----F--
--M-------------###----------%---------------------|--%----%----------------------%----------------------------%----------------%--|||||||||||-----#--
XXXXXXX-X--XXXXXXXXXXXXXXXX------------X-X-------%%%%---X--------X------XXXX---XX---%---X-XXXXX---XX--%---X-XX-----------X---XX----|||||||||||---XXXXX
XXXXXXX-X--XXXXXXXXXXXXXXXX------------X-X--------||----X--------X------XXXX---XX-------X-XXXXX---XX------X-XX-----------X---XX----|||||||||||---XXXXX
