-----------------------------------------------------------------------------------------------------------------------------------------------------------------------------------------------------
-----------------------------------------------------------------------------------------------------------------------------------------------------------------------------------------------------
-----------------------------------------------------------------------------------------------------------------------------------------------------------------------------------------------------
-----------------------------------------------------------------------------------------------------------------------------------------------------------------------------------------------------
---------------------------------------------------------------------------------------------------------------------------------------------------------------------------------------X-------------
---------------------------------------------------------------------------------------------------------------------------------------------------------------------------------------X-------------
-------S----------S-?----------------SS------------------------S-------------S----------------------USS------------------------S-QQ---------------------------------S-----S--QQ----S---X-QQ----------
---------------------------------------------------------------------------------------------------------------------------------------------------------------------------------------X-------------
---------------------------------------------------------------------------------------------------------------------------------------------------------------------------------------X-------------
----------------------------------------T------------E----------------------------------------------------------------------------------------------------------T----------------------X-------------
----Q-----------C-----S-----------------T-----------TT-----------#---------------------------T-----------------------------------?Q-----------------------------T------------?Q--------X-?Q----------
---------------------------g------#-----T-------#---TT-----------#---------------------------T-------t--------------------------------------------------------T-T--------------------T-X-------------
---------------------------TT-----#-----T-------#---TT-----------##--------------------------T-------t--------------------------------------------------------T-T--------------------T-X---------F---
--M--g---------gg--K-------TT-----#-----T-------#---TT-----------##------k---------------g---T-------t--gg------------k---g--g------gg------------------------T-T-g----g-------------T-X---------X---
XXXXXXXXX-XXXXXXXXXXXXXXXXXXXXXXX-XXXXXXXXXXXXX-XXXXXXXXXXX-XXX-XXXX-XXXXXXXX-XXXXXXX-XXXXXXXXXXX-XXXXXXXXXXXXXXXXXXXXXXXXXXXXXXXXXXXXXXXX-X--X-X-XXXX-X---XXXXXXXXXXXXXXX-XXXXXXXXXXXXXXXXX-XXXXXXXX
XXXXXXXXX-XXXXXXXXXXXXXXXXXXXXXXX-XXXXXXXXXXXXX-XXXXXXXXXXX-XXX-XXXX-XXXXXXXX-XXXXXXX-XXXXXXXXXXX-XXXXXXXXXXXXXXXXXXXXXXXXXXXXXXXXXXXXXXXX-X--X-X-XXXX-X---XXXXXXXXXXXXXXX-XXXXXXXXXXXXXXXXX-XXXXXXXX
