-----------------------------------------------------------------------------------------------------------------------------------------------------------------------------------------------------
-----------------------------------------------------------------------------------------------------------------------------------------------------------------------------------------------------
-----------------------------------------------------------------------------------------------------------------------------------------------------------------------------------------------------
-----------------------------------------------------------------------------------------------------------------------------------------------------------------------------------------------------
-----------------------------------------------------------------------------------------------------------------------------------------------------------------------------------------------------
-----------------------------------------------------------------------------------------------------------------------------------------------------------------------------------------------------
--------------------------------?----S-----------------------S---------------------------------S-?-----------------S-S--S--S-S---S----QQ-QQ----------------S---------QQ-S----------------------S-----
-----------------------------------------------------------------------------------------------------------------------------------------------------------------------------------------------------
------------------------------------------------------g----------------------------------------------------------------------------------------------------------------------------------------------
-------T----------------------------------------------#---------------------------------T------------------------------------------------------------------------------------------------------------
-------T--------T------#--S---Q--------T-----S-------##-------------------------Q-------T-----------------T---------------------------?Q-?Q-----S--------------S-----?Q--------T------S--------------
-------T--------T------#---------------T------------###---------------------------------T-----------------T----------------------------------------------------------------T---T---#-----------------
-------T--------T------##--------------T------------###---------------------------------T-K---------------T----------------------------------------------------------------T---T---#-------------F---
--M----T--------T------##------K-------T------------###--------------g----g------g-k----T----k--K------gg-T----------------------------------------------------------------T-g-T---#----g--------X---
XXXXX-XXXXXXX-XXXXXXXXXXXXXXXXXXXXXXXXXXXXXXXXXXXXX-XXXXXXXXXXXXX-XXXXXXXXXXXX-XXXXXX-XXXXXXXXXXXXXXXXXXXXXXXXXXXXX-XXXX-XXXXXXXXXXXXXXXXXXXX-XXXXXXXX-XXXXXXXXXXXX-XXXX-XXXXXXXXX-XXXXXXXXXXXX-XXXXX
XXXXX-XXXXXXX-XXXXXXXXXXXXXXXXXXXXXXXXXXXXXXXXXXXXX-XXXXXXXXXXXXX-XXXXXXXXXXXX-XXXXXX-XXXXXXXXXXXXXXXXXXXXXXXXXXXXX-XXXX-XXXXXXXXXXXXXXXXXXXX-XXXXXXXX-XXXXXXXXXXXX-XXXX-XXXXXXXXX-XXXXXXXXXXXX-XXXXX
