------------------------------------------------------------------------------------------------------------------------------------------------------
------------------------------------------------------------------------------------------------------------------------------------------------------
------------------------------------------------------------------------------------------------------------------------------------------------------
------------------------------------------------------------------------------------------------------------------------------------------------------
-------------------------------------------------------------------------------------------------------------------------------------g------g---------
--------------------------------------------------------------oo----------------------------------------oo-------------------%%%%%%%%%%%%%%%%---------
-----------#---------------------------------------------------------------##-------------------------------------------------||||||||||||||----------
-----------#-----------------------------------------------%---------------##-------------------------------------------------||||||||||||||----------
----------##--------------------------------------------------------------###-------------------------------------------------||||||||||||||----------
----SS----##--------------------------------------------------------------###-----------------------------------------------%-||||||||||||||----------
---------###--------%--------------%%%---------%---------%---------------####-------------------------------------------------||||||||||||||----%-----
---------###------------------------|------------------------------------####-------------------------------------------------||||||||||||||----------
---------###------------------------|--------------------------%%%%------####----------------------------%%%%%%%%-------------||||||||||||||-------F--
--M--r---###------------------------|---------------------------||-------####--%---------------%%%--------||||||-----------%--||||||||||||||-------#--
XXXXXXXXXXXXXXXXX-----X-%-X-XXX-XX--|--XXXXX-X----XXXX-X--------||--XXXXXXXXXX---XXX--%%%-%%%---|---X-X---||||||---X---X------||||||||||||||------XXXX
XXXXXXXXXXXXXXXXX-----X---X-XXX-XX--|--XXXXX-X----XXXX-X--------||--XXXXXXXXXX---XXX---|---|----|---X-X---||||||---X---X------||||||||||||||------XXXX
