------------------------------------------------------------------------------------------------------------------------------------------------------
------------------------------------------------------------------------------------------------------------------------------------------------------
------------------------------------------------------------------------------------------------------------------------------------------------------
------------------------------------------------------oooo--------------------------------------------------------------------------------------------
-------------------------------------------------------------g----g-----------------------------------------------------------------------------------
-----------------------------------------------------------%%%%%%%%-----------------------------------------------------------------------------------
-----------------------####---------------------oo----------||||||------------------------------------------------------------------------------------
-----------------------####---------------------------------||||||------------------------------------------------%------------------------%----------
----------------------#####---------------------------------||||||--------------------------------------------------%--------------------------%------
----------------------#####-------------------------%%%%%%%-||||||------------------------------------------------------------------------------------
--------%%%%%--------######-----------------------%--|||||--||||||----------%-----%---%--------%-----------%-%-------------%----%---%-----------------
---------|-|---------######--------------------------|||||--||||||------------------------------------------------------------------------------------
---------|-|---------######--------------------------|||||--||||||---------------------------------------------------------------------------------F--
--M------|-|-%%%%----######---------%--------------%-|||||--||||||----------------------------o---------------------------o----------%-------------#--
XXXX-XX--|-|--||--XXXXXXXXXXXX-X-X------XX--%%%------|||||--||||||---%-X--X---X-X---%---XXXX--%---X-X-XXXX------%------X--%---%----%---XXX-------XXXXX
XXXX-XX--|-|--||--XXXXXXXXXXXX-X-X------XX---|-------|||||--||||||-----X--X---X-X-------XXXX------X-X-XXXX-------------X---------------XXX-------XXXXX
