------------------------------------------------------------------------------------------------------------------------------------------------------------------------------------------------------------------------------
------------------------------------------------------------------------------------------------------------------------------------------------------------------------------------------------------------------------------
------------------------------------------------------------------------------------------------------------------------------------------------------------------------------------------------------------------------------
------------------------------------------------------------------------------------------------------------------------------------------------------------------------------------------------------------------------------
------------------------------------------------------------------------------------------------------------------------------------------------------------------------------------------------------------------------------
----------------------------------------------------------------------------------------------------------------------------------------------------------------------------------------------y-------------------------------
----------Q----Q--------------Q------Q-------------------------Q-----------Q------------------------------------------------------------------------------------------------------------------##-----------------------Q------
------o--------------------------------------------------o---------------o--------o-----------------------------------o------o--o---o-----o----------o-----------------------o--------------y###------------------------------
--------------------------------------------------------------------------------------------------------------------------------------------------------------------------------------------####------------------------------
-------------------------------------------------------------------------------------------------------------------------------------------------------------------------------------------#####------------------------------
----------?----?-----Q--------?----Q-Q-------------------------QQ----------Q------------------Q--------------Q-----------------------------------------------------Q-----------Q----------######-----------------------Q------
-----------------#------------------------------------------------------------#----------------------------#--------------------------------------------------------------------------#--#######-#----------------------------
-----------------#------T-----------------------------------------------------#----------------------------#--------------------------------------------------------------------------#--#######-#-------T----------------F---
-M---------------#------T------------------------------------y--------y-------#-y--------------------------#--------------------------------------------------y--y--------------------#--#######-#-------T----------------#---
XXXXXXXXXXXXXXXXXXXXXXXXXXXXXXXXXXXXXXXXXXX-XXXXXXXXXXXXXXXXXXXXXXXXXXXXXXXXXXXXXXXXXXX-XXXX-XXXXXXX-XXXX-XXXXXX-XXX-XXXXXXXXXXXXXXXXXXXXXXXXXXXXXXXXXXXXXXXXXXXXXXXXXXX-XXXXXXXXXXXXXX-XXXXXXXXXXXXXXXXXXXX-XXXXXXXXXXXXXXXXX
XXXXXXXXXXXXXXXXXXXXXXXXXXXXXXXXXXXXXXXXXXX-XXXXXXXXXXXXXXXXXXXXXXXXXXXXXXXXXXXXXXXXXXX-XXXX-XXXXXXX-XXXX-XXXXXX-XXX-XXXXXXXXXXXXXXXXXXXXXXXXXXXXXXXXXXXXXXXXXXXXXXXXXXX-XXXXXXXXXXXXXX-XXXXXXXXXXXXXXXXXXXX-XXXXXXXXXXXXXXXXX
