--------------------------------------------------------------------------------------------------------------------------------------------------------------------------------
--------------------------------------------------------------------------------------------------------------------------------------------------------------------------------
--------------------------------------------------------------------------------------------------------------------------------------------------------------------------------
--------------------------------------------------------------------------------------------------------------------------------------------------------------------------------
--------------------------------------------------------------------------------------------------------------------------------------------------------------------------------
--------------k-----------------------------------------------------------------------------------------------------------------------------------------------------------------
-------S------##------USS------USS--------------------------------------S---------------S-------------------S----------USS------------------------S------------------USS--------
-------------###----------------------------------------------------------------------------------------------------------------------------------------------------------------
------------####---------------------------------------------------#----------------------------#------------------------------------#---------#--------------------------------
-----------#####--------------------------------------------------##---------------------------##-----------------------------------##--------##--------------------------------
-------S--######-------------------------------------------------###----S---------------S-----###-----------S----------------------###-------###--S-----------------------------
---------#######-------B--------B------T------B-------T---TT----####-------#-----------------####------B------------#---B---------####------####--------T-------------B---------
---------#######----B--b--------b------T------b-------T---TT----####-------#----T------------####---T--b-T------TT--#---b---------####------####------T-T-----B--T----b---B-F---
-M-------#######----b--B--------B------T------B-------T---TT----####-------#----T------------####---T--B-T------TT--#---B---------####------####------T-T-----b--T----B---b-#---
XXXXXXXXXXXXXXXXXXXXXXXXXXXXXXXXXXXXXXXXXX-XXXXXXXXX-XXXXXXXXXXXXXXXXXXXXXXXXXXXXXXXXXXXXXXXXXXXXXXXXXXXXXXXXXXXXXXXXXXXXXXXXXXXXXXXXXXXXXXXXXXXXXXXXXXXXXX-XXXXXXXXXXXXXXXXXXXX
XXXXXXXXXXXXXXXXXXXXXXXXXXXXXXXXXXXXXXXXXX-XXXXXXXXX-XXXXXXXXXXXXXXXXXXXXXXXXXXXXXXXXXXXXXXXXXXXXXXXXXXXXXXXXXXXXXXXXXXXXXXXXXXXXXXXXXXXXXXXXXXXXXXXXXXXXXX-XXXXXXXXXXXXXXXXXXXX
