----------------------------------------------------------------------------------------------------------------------------------------------------------------------------------------------------
----------------------------------------------------------------------------------------------------------------------------------------------------------------------------------------------------
----------------------------------------------------------------------------------------------------------------------------------------------------------------------------------------------------
----------------------------------------------------------------------------------------------------------------------------------------------------------------------------------------------------
----------------------------------------------------------------------------------------------------------------------------------------------------------------------------------------------------
----------------------------------------------------------------------------------------------------------------------------------------------------------------------------------------------------
-----S---USSSSSS-----------S---USSSSSS---------------------------------------S----------------S-------------------------------------------S-S-----S------S-----------------S------------------------
----------------------------------------------------------------------------------------------------------------------------------------------------------------------------------------------------
----------------------------------------------------------------------------------------------------------------------------------------------------------------------------------------------------
-------------------------?-------------------------------------------------------------------------------------------Q--------------?---------------------------------------------------------------
-----S--#------------------S--#--------------------#-------------------S-----S----------------S----------------SS-------T-----------------S-S-----S------S-------T---S-----S------------S-----------
--------#---------------------#--------------------#-------------------------------T------------------------------------T---------------T------------------------T-------------T--------------------
--------##--------------------##-------------------#-------------------------------T------------------------------------T---------------T------------T-----------T-------------T-----------------F--
-M------##------g-------------##------g--k---------#-------------------K-g-----g--gT------g-----------------------------T------g-------gT------------T-k---------T-------g----gT-----g--K-----g--#--
XXXXXXX-XXXXXXXXXXXXXXXXXXXXX-XXXXXXXXXXXXX-XXXXXX-X--X-XX-XXXXXXXXXXXXXXXXXXXXXXXXXXXXXXXXXXXXXXXXXXXXXX-XXXXXXXXXXXXXXXXXXXXXXXXXXXXXXXXXXXXXXXXXXXXXXXXXXX-XXXXXXXXXXXXXXXXXXXX-XXXXXXXXXXXXXXXXX
XXXXXXX-XXXXXXXXXXXXXXXXXXXXX-XXXXXXXXXXXXX-XXXXXX-X--X-XX-XXXXXXXXXXXXXXXXXXXXXXXXXXXXXXXXXXXXXXXXXXXXXX-XXXXXXXXXXXXXXXXXXXXXXXXXXXXXXXXXXXXXXXXXXXXXXXXXXX-XXXXXXXXXXXXXXXXXXXX-XXXXXXXXXXXXXXXXX
