----------------------------------------------------------------------------------------------------------------------------------------------------------------------------------------------------------
----------------------------------------------------------------------------------------------------------------------------------------------------------------------------------------------------------
----------------------------------------------------------------------------------------------------------------------------------------------------------------------------------------------------------
------------------------------o--------------------------SSSSSSSS-----------SSSS----------SS--------------SSSS---------SS-----------SSSSSSSSS---------------------------------------------------------SSSS
----------------------------------------------------------------------------------------------------------------------------------------------------------------------------------------------------------
------------------------K---------------------------------------------------------------------------------------------------------------------------------------------------------------------------------
----S--------S----------S-----S----------------------o--------Q------------------------LS---------------S-----------------------------------------------S-------------------------------------------------
--------------o--T-----------------------------------S-----------------------------------------------------------------------------------------------------------o----------------------------------------
-----------------T----------------------------------------------------------------------------S---------------------------S-------------------------------------------------------------------------------
-----------------X-------o-----------g--------------------------------------------------------------------------------------------------------------S----------------------o---#-------------------S------
------------------------S--------S---#------------T-------#---Q-#-----Q------------T---2----------------S----#--Q-------#-------S------Q-SU------------S------------------Q----#----!--------------------F
---------------------------------K---#----T-------T----#--#-----#--#-----------##--T-------##------T---------#----------#-------------------##--#------------------------------#------------------------SS
-----------------------------------t-#----T-----T-T----#--#-----#--#-----------##--T-------##------T---------#----------#-------------------##--#------------------------------#----------T-------------SS
-M-----g-g---g---------------g-----t-#----Ty----T-T----#--#-----#--#--------g--##--T-------##----y-T-------g-#-----g----#------------k------##--#---------------------------g--#---g------T-------------SS
XXXX-XXXXXXXXXXXXXX-X--XXXXXXX-X-XXXXX-X-XXXXXXXXXX-%--XXXXXXXXXX--XXXXXXXXXXXXXXX-XXXXXXXXXXXXXXX-XXXXXXXXXXX-XXXXXXXXXX---X-X-XXXXXXXXXXXXXXXXXXXXXXXXXXX--XXXXX-XXXXXXXXXXXXXXX-XXXXXXXXXXXXX-XXXXXX-XX
XXXX-XXXXXXXXXXXXXX-X--XXXXXXX-X-XXXXX-X-XXXXXXXXXX----XXXXXXXXXX--XXXXXXXXXXXXXXX-XXXXXXXXXXXXXXX-XXXXXXXXXXX-XXXXXXXXXX---X-X-XXXXXXXXXXXXXXXXXXXXXXXXXXX--XXXXX-XXXXXXXXXXXXXXX-XXXXXXXXXXXXX-XXXXXX-XX
