------------------------------------------------------------------------------------------------------------------------------------------------------------------------------------------------------
------------------------------------------------------------------------------------------------------------------------------------------------------------------------------------------------------
------------------------------------------------------------------------------------------------------------------------------------------------------------------------------------------------------
------------------------------------------------------------------------------------------------------------------------------------------------------------------------------------------------------
------------------------------------------------------------------------------------------------------------------------------------------------------------------------------------------------------
------------------------------------------------------------------------------------------------------------------------------------------------------------------------------------------------------
--------------------------------------------------------------------------#---------------------------------------------------------------------------------------------------------------------------
--------------------------------------------------------------------------#---------------------------------------------------------------------------------------------------------------------------
------------------------TT------------------------------------------------#-------------------------------------T-------------------------------------------------------------------------------------
------------------------TT---------------------K--------------------------#-------------------------------------T-------------------------------------------------------------------------------------
------------------------##------------------------------------------------#-------------------------------------#-------------------------------------------------------------------------------------
-------------------------------------------------#------------------------#-------------------------------K-------------------------------------------------------------------------------------------
---------------------------------------------T--##-----------------------------------------------------------------------*------------------------------------------------------------------------F---
-M-------------------------------------------T-###-g-k------g-----gg----------------g--g-g---------------------------g---*----g-g---g-g-----g-----g--g--g--g-----g-----------g------g--g-----k----#---
XXXXXX-XXXXXXXXXXXXXXXXXXXXXX-XXXXXXXXXXXXXXXXXXXXXXXXXXXXXXXXXXXXXXXXXXXXXXXXXXXXXXXXXXXXXXXXXXXXXXXXXXXXXXXXXXXXXXXXXXXXXXXXXXXXXXXXXXXXXXXXXXXXXXXXXXXXXXXXXXXXXXX-XXXXXXXXXXXXXXXXXXXXXXXXXXXXXXXX
XXXXXX-XXXXXXXXXXXXXXXXXXXXXX-XXXXXXXXXXXXXXXXXXXXXXXXXXXXXXXXXXXXXXXXXXXXXXXXXXXXXXXXXXXXXXXXXXXXXXXXXXXXXXXXXXXXXXXXXXXXXXXXXXXXXXXXXXXXXXXXXXXXXXXXXXXXXXXXXXXXXXX-XXXXXXXXXXXXXXXXXXXXXXXXXXXXXXXX
