--------------------------------------------------------------------------------------------------------------------------------------------------------------
--------------------------------------------------------------------------------------------------------------------------------------------------------------
--------------------------------------------------------------------------------------------------------------------------------------------------------------
S----SSS--SSSSSSSSSSLSSSSSSSSSSSSSSSSSSSSSSSSSSSSSSSSSSSSSSSSSSSLSSSSSSSSSSSSSSSSSSSSSSSSSSSSSSSSSSSSSSSSSSSSSSSSSSSLSSSSSSSSSSSSSSSSSSSSSSSSSSSSSSSSSS-------
S-----------------------------S----------S----S--SS--------------------SS--------------------------------SS-------------------------------S----S--------------
S-----------------------------S----------S----S--SS--------------------SS--------------------------------SS-------------------------------S----S--------------
S------------------oo--------S----------S----S-----------------oo--------------------------------------------------oo--------------------S----S---------------
S----------------------------S----------S----S-------------------------------------------------------------------------------------------S----S---------------
S------------------SS--------S----------S----S-----------------SS--------------------------------------------------SS--------------------S----S---------------
S------------------SS--------S----------S----S---g-------------SS------oU--------------------------------oU--------SS--------------------S----S--C------------
S------#---------------------SS---------SS---SS--SS--------------------SS---------------------T---#--#---SS------------T-----------------SS---SS----T-#-------
S------#---------------#------S----#-----S----S------------------------------------#----------T---#--#-----------------T------------------S----S----T-#-------
S------#---------------#------S----#--#--S----S------------------------------------#----------T---#--#-----------------T----#---T---------S----S----T-#-------
S--M---#---------------#---------g-#--#---------------------------g-------g--------#----g---g-T---#--#-----------------T----#---T----------------E--T-#-----F-
XXXXXXXX-XX-XXXXXXXXXXXXXXXXXXXXXXXXXXXXXXXXXXXXXXX--X-XXXXXXXXXXXXXXXXXXXXXXXXXXXXXXX-XXXXXXXXX-XXXXXXXXXXXXXX-XXXXXXXXXXXXXXXXXXX--XXXXXXX-XXXXXXXXXX-XXXXXX
XXXXXXXX-XX-XXXXXXXXXXXXXXXXXXXXXXXXXXXXXXXXXXXXXXX--X-XXXXXXXXXXXXXXXXXXXXXXXXXXXXXXX-XXXXXXXXX-XXXXXXXXXXXXXX-XXXXXXXXXXXXXXXXXXX--XXXXXXX-XXXXXXXXXX-XXXXXX
