------------------------------------------------------------------------------------------------------------------------------------------------------
------------------------------------------------------------------------------------------------------------------------------------------------------
------------------------------------------------------------------------------------------------------------------------------------------------------
------------------------------------------------------------------------------------------------------------------------------------------------------
------------------------------------------------------------------------------------------------------------------------------------------------------
-------------------------------------------------------------------------oo---------------------------------------------oo---------------%------------
--------------oo----o------------------------------------------------------------o---------------------------#-----------------------o----------------
--------------------------------------%----------------------------------------------------------------------#-------%--------------------------------
------------------------------------------------------------------------------------------------------------##---------------S----------------S-------
---------------SS-S--------------SS-------------S-----------------------------------------------------------##--------------------------%-------------
--------%%%%%--------%%%%------------------%--------------------------%---SS------%------------------------###-----------SS-----------%---------------
---------|-|----------||-----------------------------------------------------------------------------------###----------------------------------------
---------|-|----------||-----------------------------------------------------------------------------------###-------------------------------------F--
-M-------|-|----------||-%-------------------%---------------------------------------------------%---------###----------------r--------%-------r---#--
XXXXXX---|-|----------||---XXX-X----X----X--------XX-XXX----XX-X-X-XX--------X-X----XX-XXXXXXX-----XX--XX-XXXXX--X----------XXXXXX-%---------XXXXXXXXX
XXXXXX---|-|----------||---XXX-X----X----X--------XX-XXX----XX-X-X-XX--------X-X----XX-XXXXXXX-----XX--XX-XXXXX--X----------XXXXXX-----------XXXXXXXXX
