----------------------------------------------------------------------------------------------------------------------------------------------------------------------------------------------------
----------------------------------------------------------------------------------------------------------------------------------------------------------------------------------------------------
----------------------------------------------------------------------------------------------------------------------------------------------------------------------------------------------------
----------------------------------------------------------------------------------------------------------------------------------------------------------------------------------------------------
----------------------------------------------------------------------------------------------------------------------------------------------------------------------------------------------------
-------------------------------------------------------------------------------------------------------------------------------------------------------------------------------------------k--------
-------------------------------------------------S---------------S---S---------------------------------------------------SSSC--------------------------------S--SC------------------------##--------
-----------------------------------------------------------------------------------------------------------------------------------------------------------------------------------------###--------
----------------------------------------#-----------------------------------------------------------------------------------------------------------------------------------------------####--------
---------------------Q------------------#-----k--------------------------------------------------------------------------SSSS-----------------------------------SS----------------------####--------
---------------S--------------SCS-S-----#---SSSS-S-------SS------SS--S----------------------------------------S---------------S------------------------------S------------SS-S----------####--------
--------------------------------K------##----K------------K-------------T---------------------------------------T----------------------------------------------------------K-----------#####--------
---------------------------------------##------------T------------------T------------------------T--------------T----------------------------------------------------------------------#####-----F--
-M--g----g--------------------K---K----##------K-----T------------------T---g--------------------T--------------T-------------K---------------------k---g----g--------g----------------#####-----#--
XXXXXXXXXXXXX-XXXXXXXXXXXXXXXXXXXXXXXXXXX-XXXXXXXXXXXXXXXXXXXXX-XXXXXXXXXXXXXXXX-XXXXXXXXXXXXXXXXXXXX-XXXXXXXXXXXX-XXXXX-----XXX-XXXX--XXXXXXXXXXX-XXXXXXXX-XXX---X-XXXXXXXXXXXX-XX-XXXXXXXXXXXXXXXX
XXXXXXXXXXXXX-XXXXXXXXXXXXXXXXXXXXXXXXXXX-XXXXXXXXXXXXXXXXXXXXX-XXXXXXXXXXXXXXXX-XXXXXXXXXXXXXXXXXXXX-XXXXXXXXXXXX-XXXXX-----XXX-XXXX--XXXXXXXXXXX-XXXXXXXX-XXX---X-XXXXXXXXXXXX-XX-XXXXXXXXXXXXXXXX
