------------------------------------------------------------------------------------------------------------------------------------------------------------------------------------------------------------------------------
------------------------------------------------------------------------------------------------------------------------------------------------------------------------------------------------------------------------------
------------------------------------------------------------------------------------------------------------------------------------------------------------------------------------------------------------------------------
------------------------------------------------------------------------------------------------------------------------------------------------------------------------------------------------------------------------------
------------------------------------------------------------------------------------------------------------------------------------------------------------------------------------------------------------------------------
------------------------------------------------------------------------------------------------------------------------------------------------------------------------------------------------------------------------------
-------------------------Q---------------------------------------Q---------------Q-------------------------------------------------------------Q--------------------------------Q---------------------------------------------
---------------o------------------------o-o----------------------------o-o------------------o-o---------------------------------------------------------------------------o---------------o-----------------------------------
------------------------------------------------------------------------------------------------------------------------------------------------------------------------------------------------------------------------------
------------------------------------------------------------------------------------------------------------------------------------------------------------------------------------------------------------------------------
---------------------Q---Q-------Q-------------------Q-----------?-----------QQ--Q-----------------T-------------------------------------------?-------------------T------------Q------------------T----------------o---------
-----T-----------------------------------------------------------------------------#---T-----------T---------T-----#-----------------------------------------------T-------------------------------T--------------------------
-----T--------------------------------------------------------------T--------------#---T-----------T---------T----##---------T-------------------------------------T-------------------------------T------------------T---F---
-M---T------------------------------------------------------y-------T--------------#---T-----------T---------T---###---------T-------------------------------------T-------------------------------T--------y---------T---#---
XXXXXXXXXXXXXXXXXXXXXXXXXXXXXXXXXXXXXXXXXXXXXXXXXXXXXXXXXXXXXXXXXXXXXXXXXXXXXXXXXXXXXXXXXXXXXXXXXXXXXXXXX-XXXXXXXXXXXXXX-XXXXXXXXXXXXXXXXXXXXXXXXXXXXXXXXXXXXXXXXXXXXXXXXXXXXXXXXXXX-XXXXXXXX-XXXXXXXXXXXXXXXXXXXXXXXXXXXXXX-X
XXXXXXXXXXXXXXXXXXXXXXXXXXXXXXXXXXXXXXXXXXXXXXXXXXXXXXXXXXXXXXXXXXXXXXXXXXXXXXXXXXXXXXXXXXXXXXXXXXXXXXXXX-XXXXXXXXXXXXXX-XXXXXXXXXXXXXXXXXXXXXXXXXXXXXXXXXXXXXXXXXXXXXXXXXXXXXXXXXXX-XXXXXXXX-XXXXXXXXXXXXXXXXXXXXXXXXXXXXXX-X
