------------------------------------------------------------------------------------------------------------------------------------------------------------------------------------------------------
------------------------------------------------------------------------------------------------------------------------------------------------------------------------------------------------------
------------------------------------------------------------------------------------------------------------------------------------------------------------------------------------------------------
------------------------------------------------------------------------------------------------------------------------------------------------------------------------------------------------------
------------------------------------------------------------------------------------------------------------------------------------------------------------------------------------------------------
------------------------------------------------------------------------------------------------------------------------------------------------------------------------------------------------------
------------------------------------------------------------------------------------------#-----------------------------------------------------------------------------------------------------------
------------------------------------------------------------------------------------------#-----------------------------------------------------------------------------------------------------------
------------------------------------------------------------------------------------------#-----------------------------------------------------------T-----------------------------------------------
--------------------------------------------#----------#----------------------------------#--------------------K--------------------------------------T-----------------------------------------------
-------------------------------------------##---------##----------------------------------#-----------------------------------------------------------#-----------------------------------------------
-----------K-------------------------------##---------##----------------------------------#----------------------#-------------------------TT---------------------------------------------------------
---------------------------------T--------K##--------K##--------------------------------------------------------##----------------------*--TT-----------------------------*-----T-----------------F---
-M-------------g-g-g---g-------g-T-----k---##------g--##----k------------k--gg-------gg-----------g--g--g----g-###----------K-----------*--TT-------g------g--------------*-g---T----gg-----------#---
XXXXXXXXXXXXXXXXXXXXXXXXX-XXXXXXXXXXXXXXXXXXXXXXXXXXXXXXXXXXXXXXXXXXXXXXXXXXXXXXXXXXXXXXXXXXXXXX-XXXXXXXXXXXXXXXXXXXXXX-XXXXXXXXXXXXXXXXXX-XXXXXXXXXXXXXXXXXXXXXXXXX-XXXXXXXXXXXXXXXXXXXXXX-X-X-XXXXXX
XXXXXXXXXXXXXXXXXXXXXXXXX-XXXXXXXXXXXXXXXXXXXXXXXXXXXXXXXXXXXXXXXXXXXXXXXXXXXXXXXXXXXXXXXXXXXXXX-XXXXXXXXXXXXXXXXXXXXXX-XXXXXXXXXXXXXXXXXX-XXXXXXXXXXXXXXXXXXXXXXXXX-XXXXXXXXXXXXXXXXXXXXXX-X-X-XXXXXX
