-------------------------------------------------------------------------------------------------------------------------------------------------------------------------------------------------------------------------------------------------------------------------------------------------------------------------------------------------------------------------------------
-------------------------------------------------------------------------------------------------------------------------------------------------------------------------------------------------------------------------------------------------------------------------------------------------------------------------------------------------------------------------------------
-------------------------------------------------------------------------------------------------------------------------------------------------------------------------------------------------------------------------------------------------------------------------------------------------------------------------------------------------------------------------------------
-------------------------------------------------------------------------------------------------------------------------------------------------------------------------------------------------------------------------------------------------------------------------------------------------------------------------------------------------------------------------------------
-------------------------------------------------------------------------------------------------------------------------------------------------------------------------------------------------------------------------------------------------------------------------------------------------------------------------------------------------------------------------------------
-------------------------------------------------------------------------------------------------------------------------------------------------------------------------------------------------------------------------------------------------------------------------------------------------------------------------------------------------------------------------------------
-------------------------------------------------------------------------------------------------------------------------------------------------------------------------------------------------------------------------------------------------------------------------------------------------------------------------------------------------------------------------------------
-------------------------------------------------------------------------------------------------------------------------------------------------------------------------------------------------------------------------------------------------------------------------------------------------------------------------------------------------------------------------------------
-------------------------------------------------------------------------------------------------------------------------------------------------------------------------------------------------------------------------------------------------------------------------------------------------------------------------------------------------------------------------------------
-----S---------------------------------------S----------------------------------S-------------------------------------o---------------------S------------------------S-1-----------oo--S--S-------------------------------------S--o--------------S-----------------------------------------1-------------------------o--------------------------------------------------------------
------------------------------------------------------------------------T------------T-----------------#-------------------------------------------T------#----------------T--------------------------TT-----------T-------T------------------------------------------------------------------------------T--------------------------TT--------T------------------------T-#----------
-----------T---------------------------T--------------------------------T------------T--------T-----K--#-----------------------------------------T-T------#----------------T--------------------------TT-----------T-------T------------------------------------------------------------------------------T----------------------T---TT--------T------------------------T-#-K--------
-----------T---------------------------T--------------------------------T------------T--------T--------#-----------------------------------------T-T------#-#--------------T---#----------------------TT-----------T-------T--------------#---------------------------------------------------------------T----t-----------#-----T---TT---T----T--------------#---------T-#------F---
-M---------T-k-g-----k-------k--------kT-------------------g--------g-g-T------------T-g------T--------#----k-k-ggg---------------g--g---------g-T-T------#-#-----g-----kk-T-k-#---k---------g--------TT-g-----gg--T--k----T-------------k#--g--------g--k-------g---g-k---g-k--------k--k---k--------k---T-g--t----g------#-----T---TT-k-T-g--T-------g---k--#-g--k----T-#------#-g-
XXX-XXXXXXXXXXXXXXXXXXXX-XXXXXXXXXXXXXXXX-XXXXXXXXX--X-X-XXXXXXXXXXXXXXXXX--XXXXXXX-XXXXXXXXX-XX-XXX-XXXXX-XXXXXXXXXX---XXXXXXXXXXXXXXXXXXXXXXXXXXXXXXXXXXXXXXX-XXXXXXXXXXXXXXXXXXXXXXXXXXXXXXXXX-XX-XXXXXXXXXXXXXXXXXXXXXXXXXXXXXXXXXXXXXXXXXXXXXXXXXXXXXXXX-XXXXXXXXXXXXXXXXXXXXXXXXXXXXXXXXXXX-XX-XXXXXXXXXXXXX-XXXXXXX-XX-XXXXXXXXXXXXXXXXXXXXXXXXXXXXXXXXXXXXXXXXX-XXXX-XXXXXXXX
XXX-XXXXXXXXXXXXXXXXXXXX-XXXXXXXXXXXXXXXX-XXXXXXXXX--X-X-XXXXXXXXXXXXXXXXX--XXXXXXX-XXXXXXXXX-XX-XXX-XXXXX-XXXXXXXXXX---XXXXXXXXXXXXXXXXXXXXXXXXXXXXXXXXXXXXXXX-XXXXXXXXXXXXXXXXXXXXXXXXXXXXXXXXX-XX-XXXXXXXXXXXXXXXXXXXXXXXXXXXXXXXXXXXXXXXXXXXXXXXXXXXXXXXX-XXXXXXXXXXXXXXXXXXXXXXXXXXXXXXXXXXX-XX-XXXXXXXXXXXXX-XXXXXXX-XX-XXXXXXXXXXXXXXXXXXXXXXXXXXXXXXXXXXXXXXXXX-XXXX-XXXXXXXX
