----------------------------------------------------------------------------------------------------------------------------------------------------------------------------------------
----------------------------------------------------------------------------------------------------------------------------------------------------------------------------------------
----------------------------------------------------------------------------------------------------------------------------------------------------------------------------------------
----------------------------------------------------------------------------------------------------------------------------------------------------------------------------------------
----------------------------------------------------------------------------------------------------------------------------------------------------------------------------------------
----------------------------------------------------------------------------------------------------------------------------------------------------------------------------------------
------------------------------------------------------------------------------------------###-------------------------------------------------------------------------------------------
------------------------------------------------------------------------------------------###--------------------------y----------------------------------------------------------------
------------------------------------------------------------------------------------------###------------------------#SS--o-------------------------------------------------------------
------------------------o--------------------o--------------------------------------------###-----------------------##------------------------o-----------------------------------------
------------------------------------------------------#--------------Q--------------------###------#---o--------o---##--SC----------------------------Q---SC-------------Q------#-------
--------------------------------#----------#--------y##-------T---------------------------###-----##----------------##--------------------------------------------------------y##-------
-------------------------------##---------##--------###-------T---------------------------###----###----------------##---SSS------------------------------------------------y-###---F---
----M--------------------------------------------y-####-------T---------------------------###---####----------------##-----------------------------------------------------######---#---
XXXXXX-XXXXXXXXXXXXXX-XXXX-XXXXXXXXXXX-XXXXXXXXXXXXXXXX-XXXXXXXXXXX-XXXXX-XXXXXXXX-XXX-XX-XXXX-XXXXX-XXXXXXX-X-XXXXXXX------X--XXXX-XXXXXXX-XXXXXXX-XXXXX-XXXXXXXXXXX-XXXXXXXXXXX-XXXXXX
XXXXXX-XXXXXXXXXXXXXX-XXXX-XXXXXXXXXXX-XXXXXXXXXXXXXXXX-XXXXXXXXXXX-XXXXX-XXXXXXXX-XXX-XX-XXXX-XXXXX-XXXXXXX-X-XXXXXXX------X--XXXX-XXXXXXX-XXXXXXX-XXXXX-XXXXXXXXXXX-XXXXXXXXXXX-XXXXXX
