----------------------------------------------------------------------------------------------------------------------------------------------------------------------------------------------------------------------
----------------------------------------------------------------------------------------------------------------------------------------------------------------------------------------------------------------------
----------------------------------------------------------------------------------------------------------------------------------------------------------------------------------------------------------------------
----------------------------------------------------------------------------------------------------------------------------------------------------------------------------------------------------------------------
----------------------------------------------------------------------------------------------------------------------------------------------------------------------------------------------------------------------
----------------------------------------------------------------------------------------------------------------------------------------------------------------------------------------------------------------------
---------SS-----S-------US--------------S---US------------------------------------------S-S---------------------SS-----------------------------US---------------------------S--------------S------SS-------------S----
------------------------------------------------------------------------------------------------T----------------------------------------------------------------------T----------------------------------------------
------T------------------------------------------------T----------------------------------------T-----------------------------------------------------T----------------T----------------------------------------------
------T----------------S-------------------S-----------T----T-----------------------------------X-------------------------------------------T-S-------T----------------X----------------------------------------------
------T---------------------------T-T------------------T----T-S---TT---------T----------------S-----------T-------2--------------t----T-T-S-T---------X-------t-------------------S---#------TT-----2-----S----t------
------T-----T-----------------TT--T-T---------------T--T----T-----TT-TT------T----------------------------T-TT---T-------T-------t----T-T---T------------T----t-----------------------#------TT----T-----------t------
------T-----T-----------------TT--T-T---------------T--T----T---T-TT-TT--#---T-T-----------------------T--T-TT---T----#--T-T-----t----T-T---T------t-----T----t-T---------T-----------##-----TT----T----T---T--t---F--
---M--T-----T-----------------TT--T-T---------------T--T----T---T-TT-TT-##---T-T--k--------------------T--T-TT---T---##--T-T-----t----T-T---T------t-----T----t-T---------T-----------##-----TT----T----T---T--t---#--
XXXXXXXXXX-XXXXXXXXXXXXXX-XXXXXXXXXXXXXXXXXXX-XXXXXXXXXXXXXXXXXXXXXXXXXXXXXXXXXXXXXXXXXXXXXXXXXXXXXXXXXXXXXXXXXXXXXXXXXXXXXXXXXXXXXXXXXXXXXXXXXX--XXXXXXXXXXXXXXXXXXXXXXXXXXXXXXXXXXXXXXXXXXXXXXXXXXXXXXXXXXXXXXXXXXXX
XXXXXXXXXX-XXXXXXXXXXXXXX-XXXXXXXXXXXXXXXXXXX-XXXXXXXXXXXXXXXXXXXXXXXXXXXXXXXXXXXXXXXXXXXXXXXXXXXXXXXXXXXXXXXXXXXXXXXXXXXXXXXXXXXXXXXXXXXXXXXXXX--XXXXXXXXXXXXXXXXXXXXXXXXXXXXXXXXXXXXXXXXXXXXXXXXXXXXXXXXXXXXXXXXXXXX
