-------------------------------------------------------------------------------------------------------------------------------------------------------------------------------------------
-------------------------------------------------------------------------------------------------------------------------------------------------------------------------------------------
-------------------------------------------------------------------------------------------------------------------------------------------------------------------------------------------
S---SSSSSSSSSSSSSSSSSSSSSSSS-----SSSSSSSS-SSSSSSSSSSSSSSSSSSSSSSSSSSSSSSSSSSSSSSSSSSSSSSSSSSSSSSSSSSSSSSSSSSSSSSSSSSSSSSSSSSSSSSSSSSSS-SS------------SSSS---SSSSSS----SSSSSSSSSSSSSSSSSSSSS
S------------------------------------------------------------------------------------------------------------------SSSSSSS-----------------------------------------------------------------
S------------------------------------------------------------------------------------------------------------------SSSSSSS-----------------------------------------------------------------
S------------------------------------------------------------------------------------------------------------------SSSSSSS-------------S---------------------------------------------------
S------------------------------------------------------------------------------------------------------------------------------------------------------------------------------------------
S----------------------------S--------------------------------------------------------------------------------------------------------------SSSS-SSS------S--------------------------------
S------------------------------------------------------------------------------------------------------------------------------------------------------------------------------------------
S--------------------------S--------T--------------------------------T---------------T-------------------------------SS?-S-----------S-SS---------------Q--------S------------------------F
S-------T-----------T-------------#-T---#----------------#-----------T-------T-------T-------------T-------TT--------S---S------------------------------------------------------T--T--T--SS
S-------T-t-------t-T-------------#-T---#---------------##-----------T-------T-------T-------------T-------TT--------S---S----------------S-----------------------------t-------T--T--T--SS
S-M-----T-t-------t-T-------------#-T---#-----k--k-----###-----------T------kT-k-----T------k----k-T---k--kTT---------oooS----------------------------------------------t-------T--T--T--SS
XXXXXXXXXXXXX-XXXXXXXXXXXXXX------X-X-X-X--XXXXXXXXXX-XXXX-XXXX-XXX-XX-XX-XXXXXXXXXX-X--X--XXX-XXXXXXXXXXXXXXX-XX---XXXXXXX-XXXX--XXXX-XX-------------XXX----XXXXX-----XXX-XXXXXXXXXXXXX-XX
XXXXXXXXXXXXX-XXXXXXXXXXXXXX------X-X-X-X--XXXXXXXXXX-XXXX-XXXX-XXX-XX-XX-XXXXXXXXXX-X--X--XXX-XXXXXXXXXXXXXXX-XX---XXXXXXX-XXXX--XXXX-XX-------------XXX----XXXXX-----XXX-XXXXXXXXXXXXX-XX
