-------------------------------------------------------------------------------------------------------------------------------------------------------------------------------------------
-------------------------------------------------------------------------------------------------------------------------------------------------------------------------------------------
-------------------------------------------------------------------------------------------------------------------------------------------------------------------------------------------
S---SSSSSSSSSSSSSSSSSSSSSSSSSSSSSSSSSSSSSSSSSSSSSSSSSSSSSSSSSSSSSSSSSSSSSSSSSSSSSSSSSSSSSSSSSSSSSSSS---SSSSSSSSS--------SSSSSSSSSSSSSSSSSSSSSSSS----SSS-----SSSSSSSSSSSSSSSSS-----------SSS
S-----------------------------------------------------------------------------------SSSSSSSSS----------------------------------------------------------------------------------------------
S-----------------------------------------------------------------------------------SSSSSSSSS----------------------------------------------------------------------------------------------
S-----------------------------------------------------------------------------------SSSSSSSSS----------------------------------------------------------------------------------------------
S------------------------------------------------------------------------------------------------------------------------------------------------------------------------------------------
S--------------------------------------------------------------------------------------------------------------------S---------------------------S------SSS-------------------SS---S-S-----
S-------------------------------------------------------------------------------------------------------------------------------------------S----------------------------------------------
S--------T---T-------SU--------------------T-----------------T-------------T----------SSS?-SS------S---------QQQ-----------------T-------------Q----------------------------Q-------------F
S--------T---T----------------#------------T---------T-T-----T------T------T----------SS---SS-------------T-------------------T--T------T-------------#-------------------T--------------SS
S--------T---T---------------##------------T---------T-T-----T------T------T----------SS---SS---t---------T-------------------T--T------T-------------#-------------------T------S-------SS
S-M------T---T----k----------##------------T---------T-T-----T------T--k---T------------oooSS---t---------T-------------------T--T------T-k--k--------#--------k----------T--------------SS
XXXXXXXXXX-X-X-XXXXXXXXX-X--XXX-XX--XXXXXXXX-XXXXX-XXXXXXXXXXX-XXX-XXXXXXX-X-X-XX-X--XXXXXXXXX-XXXXX-----XXXXXXX----------XXXXXXXX---XXXXXXXXXXX------X------XXXXX--XX---XXXX------------XX
XXXXXXXXXX-X-X-XXXXXXXXX-X--XXX-XX--XXXXXXXX-XXXXX-XXXXXXXXXXX-XXX-XXXXXXX-X-X-XX-X--XXXXXXXXX-XXXXX-----XXXXXXX----------XXXXXXXX---XXXXXXXXXXX------X------XXXXX--XX---XXXX------------XX
