------------------------------------------------------------------------------------------------------------------------------------------------------------------------------------------------------
------------------------------------------------------------------------------------------------------------------------------------------------------------------------------------------------------
------------------------------------------------------------------------------------------------------------------------------------------------------------------------------------------------------
------------------------------------------------------------------------------------------------------------------------------------------------------------------------------------------------------
------------------------------------------------------------------------------------------------------------------------------------------------------------------------------------------------------
------------------------------------------------------------------------------------------------------------------------------------------------------------------------------------------------------
---------------------------------------#--------------------------------------------------------------------------------------------------------------------------------------------------------------
---------------------------------------#--------------------------------------------------------------------------------------------------------------------------------------------------------------
-----------------------------------T---#---------------------------------------------------------------------------------------------------------T----------------------------------------------------
-----------------------------------T---#--------K------------------------------------------------------------------------------------------------T----------------------K-----------------------------
-----------------------------------#---#---------------------------------------------------------------------------------------------------------#----------------------------------------------------
----------------------K---K------------#----------#----------------------------------------------------K------------------------------------------------------------------#---------------------------
-------------------*-----------------------------##---T--------------------------------------------------------------------------------------------------*---------------##-----------------------F---
-M---gg------------*--------g-----------------k-###---T--g-k-k--g--------------g---g------g--------g---------gg--g----g-k-g--k--g-k----K------------g--g-*-----ggg------###-----------------------#---
XXXXXXXXXXXXXXXXXXXXXXXXXXXXXXXXXXXXXXXXXXXXXXXXXXXXXXXXXXXXXXXXXXXX-X-XXX-XXXXXXXXXXXXXXXXXXXXXX-XXXXXXXXXXXXXXXXXXXXXXXXXXXXXXXXXXXXXXX-XX-XXXXXXXXXXXXXXXXXXXXXXXXXXXXXXXXXXXXXX-XXXXXX-XXXXXXXXXXX
XXXXXXXXXXXXXXXXXXXXXXXXXXXXXXXXXXXXXXXXXXXXXXXXXXXXXXXXXXXXXXXXXXXX-X-XXX-XXXXXXXXXXXXXXXXXXXXXX-XXXXXXXXXXXXXXXXXXXXXXXXXXXXXXXXXXXXXXX-XX-XXXXXXXXXXXXXXXXXXXXXXXXXXXXXXXXXXXXXX-XXXXXX-XXXXXXXXXXX
