------------------------------------------------------------------------------------------------------------------------------------------------------------------------------------------------------
------------------------------------------------------------------------------------------------------------------------------------------------------------------------------------------------------
------------------------------------------------------------------------------------------------------------------------------------------------------------------------------------------------------
------------------------------------------------------------------------------------------------------------------------------------------------------------------------------------------------------
------------------------------------------------------------------------------------------------------------------------------------------------------------------------------------------------------
------------------------------------------------------------------------------------------------------------------------------------------------------------------------------------------------------
-------------------#----------------------------------------------------------------------------------------------------------------------------------------------------------------------------------
-------------------#----------------------------------------------------------------------------------------------------------------------------------------------------------------------------------
-------------------#----------------------------------------------------------------------------------------------------------------------------------------------------------------------------------
-------------------#-----------------------------------------------------------------------------------------------------------#----------------------------------------------------------------------
-------------------#----------------------------------------------------------------------------------------------------------##----------------------------------------------------------------------
-------------------#------------------------------------------------K---------------------------------------------------------##------------------------------------------------K---------------------
--------------------------------------*-*---*---T-------------T---T---------------*-------------------------------------------##-------------*----------------------------------------T-----------F---
-M----g-----------------------g----k--*-*---*---T--g--g--gg---T---T-----k---------*-gg--------------g-k----g---k--------g----k##----g---k--k-*--ggg----------------g-----g------------T-------g-K-#---
XXXXXXXXXXXXXXX-XXXXXXX-XXXXXXXXXXXXXXXXXXXXXX-XXXXXXXXXXXXX-XXXXXXXXXXXXXXXXXXXXXXXXXXXXXXX-XXXXXXXXXXXXXXXXXXXXXXXXXXXXXXXXXXXXXXXXXXXXXXXXXXXXXXXXX-XXXXXXXXXXXXXX-XXXXXXXXXXXXXXXXXXXXXXXXXXXXXXXX
XXXXXXXXXXXXXXX-XXXXXXX-XXXXXXXXXXXXXXXXXXXXXX-XXXXXXXXXXXXX-XXXXXXXXXXXXXXXXXXXXXXXXXXXXXXX-XXXXXXXXXXXXXXXXXXXXXXXXXXXXXXXXXXXXXXXXXXXXXXXXXXXXXXXXX-XXXXXXXXXXXXXX-XXXXXXXXXXXXXXXXXXXXXXXXXXXXXXXX
