----------------------------------------------------------------------------------------------------------------------------------------------------------------------------------------------------
----------------------------------------------------------------------------------------------------------------------------------------------------------------------------------------------------
----------------------------------------------------------------------------------------------------------------------------------------------------------------------------------------------------
----------------------------------------------------------------------------------------------------------------------------------------------------------------------------------------------------
----------------------------------------------------------------------------------------------------------------------------------------------------------------------------------------------------
-----------------------k----------------------------------------------------------------------------------------------------------------------------------------------------------------------------
--------S-------------##---------S---S--S---S------S-------------------S-----------S--------------------S--S---------------------------------------S---S-S------------------------------------------
---------------------###----------------------------------------------------------------------------------------------------------------------------------------------------------------------------
--------------------####----------------------------------------------------------------------------------------------------------------------------------------------------------------------------
--------------------####----------------------?---------------Q--?----------------------------------------------------------------------------------------------------------------------------------
--------S----S------####---------S---S--S---S------S--------T----------S-----------S---S-Q--------------S--S---------------------------------------S---S-S--S---#------S----------------------------
-------------------#####-------------------------------T----T-------------------TT------------------T----------------------T------------------------------------#-----------------------------------
-------------------#####-------------------------------T----T-------------------TT------------------T----------------------T------------------------------------#--------------------T-----------F--
-M------g--------g-#####-------------g-----------------T----T-------------------TT------------g-----T--------------g----g--T-----------------------------g------#--------------g--g--T-----k-k---#--
XXX-XXXXXXXXXXXXXXXXXXXXXX-XXXXXXXXXXXXXXXXXXXXXXXXXXXXXXXXXXXXXXXX-XXXXXXXXXX-XXXXXXXXXXXXXXXXXX-XXXXXXXXXXXXXXXXXXXX-XXXXXXXXXXXXXXXXXXXXXXXXX-XXXXXXXXXXXXXX-X-X-XXXXXXXXX-XXXXXXXXX-X-XXXXX-XXXX
XXX-XXXXXXXXXXXXXXXXXXXXXX-XXXXXXXXXXXXXXXXXXXXXXXXXXXXXXXXXXXXXXXX-XXXXXXXXXX-XXXXXXXXXXXXXXXXXX-XXXXXXXXXXXXXXXXXXXX-XXXXXXXXXXXXXXXXXXXXXXXXX-XXXXXXXXXXXXXX-X-X-XXXXXXXXX-XXXXXXXXX-X-XXXXX-XXXX
