-----------------------------------------------------------------------------------------------------------------------------------------------------------------------------------------------------
-----------------------------------------------------------------------------------------------------------------------------------------------------------------------------------------------------
-----------------------------------------------------------------------------------------------------------------------------------------------------------------------------------------------------
-----------------------------------------------------------------------------------------------------------------------------------------------------------------------------------------------------
------------------------------------------------------------------X----------------------------------------------------------------------------------------------------------------------------------
------------------------------------------------------------------X----------------------------------------------------------------------------------------------------------------------------------
-----------S------------------S----QQ----------------------S------X--S-----S--S-------------------S-------------------------------------------S------------C--SS---------------S--------C--S---------
------------------------------------------------------------------X----------------------------------------------------------------------------------------------------------------------------------
------------------------------------------------------------------X----------------------------------------------------------------------------------------------------------------------------------
----g-------------------------------------------------------------X------------------------------------------------------------------------------------E------------------T-------------------T------
----TT--------------------------T--?Q----S------T---------------C-X-----------------S----------------------------T----TT---T----#-------S---T-----T---TT--SS--------------T------------SS-----T------
----TT--------------------------T---------------T-----------------X-----g-------------T-----#----------g---------T----TT---T----#-----------T---T-T---TT----------------#-T-------------------T------
----TT--------------------------T---------------T-----------------X-----TT------------T-----#----------TT--------T----TT---T----##----------T---T-T---TT----------------#-T-------------------T--F---
--M-TT--------------------------T---------------T--------------gg-X-----TT------------T-----#--g-------TT-g------T----TT-g-T--g-##----------T---T-T---TT---k------------#-T--------g----k-----T--X---
XXXXXXX-XXXXXXXXXX-XXX--XXX-XXXXXXXXXXX-XXX-XXXXXXXXXXXXXXX-XXXXXXXXXXXXXXXXXXXXXXXXXXXXXXX-XXXXXXXXXXXXXXXX-XXXXXX-XXXXXXXXXXXXXXXXXXXXXXXXXXXXXXXXXXXXXXXXXXXXXXXXX---XXXXXXX-XXXXXXXXXXXXXXXXXXXXX
XXXXXXX-XXXXXXXXXX-XXX--XXX-XXXXXXXXXXX-XXX-XXXXXXXXXXXXXXX-XXXXXXXXXXXXXXXXXXXXXXXXXXXXXXX-XXXXXXXXXXXXXXXX-XXXXXX-XXXXXXXXXXXXXXXXXXXXXXXXXXXXXXXXXXXXXXXXXXXXXXXXX---XXXXXXX-XXXXXXXXXXXXXXXXXXXXX
