-------------------------------------------------------------------------------------------------------------------------------------------------------------------------------------------
-------------------------------------------------------------------------------------------------------------------------------------------------------------------------------------------
-------------------------------------------------------------------------------------------------------------------------------------------------------------------------------------------
S---SSSSSSSSSSSSSSSSSSSSSSSSSSSSSSSSSSSSSSSSSSSSSSSSSSSSS--------SSSSSSSSSSSSSSSSSSSSSS---SSSSSSSS-SSSSSSSSSSSSSSSSSSSSSSSSSSSSSSSS--SSSSSSSSSSS-SSSSSSSSSSSS-SSSSSSSSSSSSSSSSS-----SSSSSSS
S------------------------------------------------------------------------------------------------------------------------------------------------------------------------------------------
S------------------------------------------------------------------------------------------------------------------------------------------------------------------------------------------
S-------------------------QQ-----------------------------------------------------------------------------------------Q-----Q---------------------------------------------------------------
S------------------------------------------------------------------------------------------------------------------------------------------------------------------------------------------
S---------------------------------------------------------SSS-SS------------------------S--------------------------------------------------------------------------------------------------
S------------------------------------------------------------------------------------------------------------------------------------------------------------------------------------------
S-------------------------QQ-----------T-T------------------------T-----T-------------S----------S-------T-----------Q-----Q-T----S------------S-----T------------------------------------F
S--------T-----------TT----------------T-T--------------#---------T--#--T-------#------------------------T-------------------T-----------T---T-------T-#----#---------T-------#-------T--SS
S--------T---t-------TT----------------T-T--------------#---------T--#--T------##------------------------T-------------------T-----------T---T-----t-T-#---##---------T-------#-SSS---T--SS
S-M---k--T---t-------TT----------------T-T--------------#---------T--#--T-----###-------------k----------T-------------------T-----------T--kT-----t-T-#--###---------T-------#-------T--SS
XXXXXXXXXXXXXXXXX-XXXXXX-XXXXXXXX-XXX-XX-X-X--XXX-XX-XX-X---------X--X-XX--XXXXXX---XXX----XXXXXXX--X-XXXX-XXX-XXX-XXXXX-XXXXX-XXXX---XXXXXXXXXX--XXXX-X-XXXX--XXXX-XXXXXXXXX-X------XXX-XX
XXXXXXXXXXXXXXXXX-XXXXXX-XXXXXXXX-XXX-XX-X-X--XXX-XX-XX-X---------X--X-XX--XXXXXX---XXX----XXXXXXX--X-XXXX-XXX-XXX-XXXXX-XXXXX-XXXX---XXXXXXXXXX--XXXX-X-XXXX--XXXX-XXXXXXXXX-X------XXX-XX
