--------------------------------------------------------------------------------------------------------------------------------------------------------------
--------------------------------------------------------------------------------------------------------------------------------------------------------------
--------------------------------------------------------------------------------------------------------------------------------------------------------------
S----SSSSSSSSSSSSSSSSSSSSSSSSSSSSSSSSSSSSSSSSSLSSSSSSSSSSSSSSSSSSSSSSSSSSSSSSSSSSSSSSSSSSSSSSSSSSLSSSSSSSSSSSSSSSSSLSSSSSSSSSSSSSSSSSSSSSSSSSSSSSSSSSSS-------
S------------------------------------SSSSSS----------SSSSS--------------S-----------------------------SS--------S---------------SSSSSS-------S----------------
S------------------------------------SSSSSS----------SSSSS--------------S-----------------------------SS--------S---------------SSSSSS-------S----------------
S--------------------------------------------oo------------------------S------------------------oo-------------S--oo------------------------S-----------------
S----------------------------------------------------------------------S---------------------------------------S----------------------------S-----------------
S--------------------------------------------SS------------------------S------------------------SS-------------S--SS------------------------S-----------------
S------------------------------------g-g-g---SS------ooooU-------------S------------------------SS----oU-------S--SS------------g-g-g-------S-----------------
S--------#---@Q----------------------SSSSSS----------SSSSS-------------SS-----------#-----------------SS-------SS----------#----SSSSSS------SS--------#-------
S--------#---------------------------------------T----------------------S-----------#---------------------------S----------#-----------S-----S--------#-------
S--------#-------------T--------#----------------T------------T---------S-----------#---------------------------S----------#-----------S-----S--------#-------
S--M-----#-------------T--------#----------------T-----k------T-----------g---------#-g-g--g--------------------------g----#-----------S--------------#-----F-
XXXXXX-XXXXXXXXXXXXX-XXXXXXXXXXXXXXXXXXXXXX-XXXXXXXXXXXXXXXXXXXXXXXXXXXXXXXXXXXXXXXXXXXXXXXXXXXXXXX-XXXXX-X-X-XXXXXXXXXX--XXX-XXXXXXXX-X-XXXXXX-XX-XXXX--XXXXX
XXXXXX-XXXXXXXXXXXXX-XXXXXXXXXXXXXXXXXXXXXX-XXXXXXXXXXXXXXXXXXXXXXXXXXXXXXXXXXXXXXXXXXXXXXXXXXXXXXX-XXXXX-X-X-XXXXXXXXXX--XXX-XXXXXXXX-X-XXXXXX-XX-XXXX--XXXXX
