----------------------------------------------------------------------------------------------------------------------------------------------------------------------------------------------------------
----------------------------------------------------------------------------------------------------------------------------------------------------------------------------------------------------------
----------------------------------------------------------------------------------------------------------------------------------------------------------------------------------------------------------
----------------------------------------------------------------------------------------------------------------------------------------------------------------------------------------------------------
----------------------------------------------------------------------------------------------------------------------------------------------------------------------------------------------------------
----------------------------------------------------------------------------------------------------------------------------------------------------------------------------------------------------------
---------------S--------------SS---SSS-----SS-----------------------------S-----S-S------------------------------S----------SS-----------------S---------------------------S--S---------------------------
----------------------------------------------------------------------------------------------------------------------------------------------------------------------------------------------------------
----------------------------------------------------------------------------------------------------------------------------------------------------------------------------------------------------------
-------------------------------------------------------------------------------------------------------------------------------------------1--------------------------------------------------------------
-t---!----#-------#----S-----------------!----t-#-------------------t---------S-----------------------------------------t------t-------------t-------t-S-S----------------------t-----------------!-------
-t--------#--t----#---------------------------t-#-------------------t--------------------t------------------------------t-t----t-------------t-------t--------------------------t-------------------------
-t--------#--t----#---------------------------t-#---------t------t--t--------------------t-------------------------t----t-t----t-------------t-------t----------------t---------t-t-------------------F---
-t-M----g-#--t----#------g--------------------t-#---gg----t---g--t--t------g-------------t-----g--------------#----t----t-t----t--g----------t-------t----------------t------g--t-t-------------------#-g-
XXXXXXXXXXXXXXXXXXXXXXXXXXXXXXXXXXXXXXXXXXXXXXXXXXXXXXXXXXXXXXXXXXXXXXXX-XXXXXXXXXXX-XXXXXXXXXXXXXXXXXXXXX-XXXXXXXXXXXXXXXXXXXXXXXXXXXXXXXXXXXXXXXXXXXXXXXXXXX-XXXXXXXXX-XXXXXXXXXXXXXXXXXXXXXXXXXXXXXXXXX
XXXXXXXXXXXXXXXXXXXXXXXXXXXXXXXXXXXXXXXXXXXXXXXXXXXXXXXXXXXXXXXXXXXXXXXX-XXXXXXXXXXX-XXXXXXXXXXXXXXXXXXXXX-XXXXXXXXXXXXXXXXXXXXXXXXXXXXXXXXXXXXXXXXXXXXXXXXXXX-XXXXXXXXX-XXXXXXXXXXXXXXXXXXXXXXXXXXXXXXXXX
