----------------------------------------------------------------------------------------------------------------------------------------------------------------------------------------------------
----------------------------------------------------------------------------------------------------------------------------------------------------------------------------------------------------
----------------------------------------------------------------------------------------------------------------------------------------------------------------------------------------------------
----------------------------------------------------------------------------------------------------------------------------------------------------------------------------------------------------
----------------------------------------------------------------------------------------------------------------------------------------------------------------------------------------------------
----------------------------------------------------------------------------------------------------k-------------------------------------------------------k---------------------------------------
----------------------------S--------------------------S------------SC-----------------------------##-S-S---S----------------------------S-------S---------##----SC------S----S---------------------
--------------------------------------------------------------------------------------------------###-----------------------------------------------------###---------------------------------------
-------------------------------------------------------------------------------------------------####----------------------------------------------------####--#------------------------------------
--------------------------------------------------------------------SS---------------------------####-----------?----------------------------------------####--#-SS---------------------------------
-----S---------------S----S-S--------------S---S-------S---------------S----SS-------------------####-S-S---S-S----S---S-----------------S-------S--T----####--#---------S----S-SSS-----S-Q---SS----
-----------------------------------------------------------------------------K------------------#####----------------------------T------------------T---#####-##------------------K------------K----
-----------------------------------------------------------------------------------T------------#####----------------------------T------------------T---#####-##---------------------------------F--
-M--------k--------------------------------------------g-g-------------------------T------------#####---g---------K--------------T-------g----------T-k-#####-##---------g--------------K--------#--
XXXXXXXXXXXXX-XXXXXXXXXXXXXXXX--XXXXXXXX-XXXXXXXXXXXX-XXXXXXX-X-XXX---XXXX-XXXXXXXXXXXXXXXXXXXXXXXXXXXXXXXXXXXXXXXXXXXXXXXXXXX-XXXXX--XXXXXXXXXXXXXXXXXXXXXXXXXX---XXX-XXXXXXXXXXXXX-XXXXXXXXXXXXXXX
XXXXXXXXXXXXX-XXXXXXXXXXXXXXXX--XXXXXXXX-XXXXXXXXXXXX-XXXXXXX-X-XXX---XXXX-XXXXXXXXXXXXXXXXXXXXXXXXXXXXXXXXXXXXXXXXXXXXXXXXXXX-XXXXX--XXXXXXXXXXXXXXXXXXXXXXXXXX---XXX-XXXXXXXXXXXXX-XXXXXXXXXXXXXXX
