------------------------------------------------------------------------------------------------------------------------------------------------------
------------------------------------------------------------------------------------------------------------------------------------------------------
------------------------------------------------------------------------------------------------------------------------------------------------------
---------------ooo------------------------------------------------------------------------------------------------------------------------------------
------------------------------------------------------------------------------------------------------------------------------------------------------
-------------------%%%%%%%%%-------------------%%%------------oo--------------------------------------------------------------ooo---------------------
--------------------|-|-|-|---------------------|----------------------------------------------------R------------------------%%%---------------------
--------------------|-|-|-|---------------------|--------------------------------------------------------------%-----------%---|----------------------
--------------------|-|-|-|---------------------|-------------------------%-------------------S-------------------%------------|----------------------
-------------%%%%%%-|-|-|-|-------------S-----%-|-----------------------S-------SS---SS----------------------------------------|----------------------
---------%----||||--|-|-|-|---------------%-%---|--------------SS-%-----------------------%------------%-----------------------|--------%-------------
--------------||||--|-|-|-|---------------------|----------------------------------------------------------------------------U-|----------------------
--------------||||--|-|-|-|---------------------|------------------------------------------------------------------------------|-------------------F--
-M----------%-||||--|-|-|-|------------------%--|---------%--------------------------------%---r----ooo---%--------------------|----------------%--#--
XXXX-XX-------||||--|-|-|-|--X-XX-X-XXX---------|---X--X------------XXX-----X------X-----%---XXXX---%%%-----X---------XX-X---%%%%-XX--X---XXXXX---XXXX
XXXX-XX-------||||--|-|-|-|--X-XX-X-XXX---------|---X--X------------XXX-----X------X---------XXXX----|------X---------XX-X----||--XX--X---XXXXX---XXXX
