--------------------------------------------------------------------------------------------------------------------------------------------------------------
--------------------------------------------------------------------------------------------------------------------------------------------------------------
--------------------------------------------------------------------------------------------------------------------------------------------------------------
S----SSSSSSSSSSSSSSSSSSSLSSLSSSSSSSSSSSSSSSSSSSSSSSSSSSSSSSSSSSSSSSSSSSSSSSSSSSSSSSSSSSSSSSSSSLSSSSSLSSSSSSSSSSSSSSSSSSSSSSSSSSSSSSSSSSSSSSSSSSSLSSSSSSSSS----
S-----------------S--------------------------------------------------------------------------------------S--S-------------------------------------------------
S-----------------S--------------------------------------------------------------------------------------S--S-------------------------------------------------
S----------------S-----oo-oo-----------------------------------------------------------------oo----oo---S--S-----------------------------------oo-------------
S----------------S--------------------------------------------------------------------------------------S--S--------------------------------------------------
S----------------S-----SS-SS-----------------------------------------------------------------SS----SS---S--S-----------------------------------SS-------------
S----------------S-----SS-SS--------------------------C--------------------------------------SS----SS---S--S-----------------------------------SS-------------
S------#---------SS----------------------#----#--------------#---------------------------T--------------SS-SS-----------#------------------T-------T-----#----
S------#----------S----------------------#----#--------------#--------------------T------T---------------S--S---#---T---#---T----------#---T-------T-----#----
S------#----------S----------------------#----#--------------#-------#------------T------T---------------S--S---#---T---#---T----------#---T-------T-----#----
S--M---#------g------g-----------g----g--#----#-------E------#-g-----#------------T-g--g-T----------------------#---T---#---T--------g-#---T-g-----T-g---#--F-
XXXXXXXXXXXXXXXXXXXXXXXXXXXXXXX-XXXXXXXXXXXXXXXXXXXXXXXXX--XXXXXXXXXXXXXXXXXXX--XXXXXXXXXXXXXXXXX-XXXXXXXXXXXXXXXXXXXXXXXXXXXXXXXXXXXXXXX-XXXXXXXXXXXXXXXX-XXX
XXXXXXXXXXXXXXXXXXXXXXXXXXXXXXX-XXXXXXXXXXXXXXXXXXXXXXXXX--XXXXXXXXXXXXXXXXXXX--XXXXXXXXXXXXXXXXX-XXXXXXXXXXXXXXXXXXXXXXXXXXXXXXXXXXXXXXX-XXXXXXXXXXXXXXXX-XXX
