--------------------------------------------------------------------------------------------------------------------------------------------------------------------------------
--------------------------------------------------------------------------------------------------------------------------------------------------------------------------------
--------------------------------------------------------------------------------------------------------------------------------------------------------------------------------
--------------------------------------------------------------------------------------------------------------------------------------------------------------------------------
--------------------------------------------------------------------------------------------------------------------------------------------------------------------------------
--------------------------------------------------------------------------------------------------------------------------------------------------------------------------------
------------------S---------------------USS-------------------------------------------------USS-------------------USS----------------------------------------S------------------
--------------------------------------------------------------------------------------------------------------------------------------------------------------------------------
------------------------------#-------------------------------------------------------------------------------------------------------------------------------------------------
-----------------------------##-------------------------------------------------------------------------------------------------------------------------------------------------
----------Q-------S--Q------###-------------------------------------------QQ---------------------------------------------------------------------------------S----Q-------------
--------T------------------####-T----#---B-----K---------------K-K------------------------K--B------------K-----B--B-----K-------------------------B---#------------------------
----B---T------------------####-T----#---b----------B-------B---------------------B----------b--------B-------T-b--b--B-------TT---B-----B---------b---#--------------------F---
-M--b---T------------------####-T----#---B----------b-------b---------------------b----------B--------b-------T-b--B--b-------TT---b-----b---------B---#--------------------#---
XXXXXX-XXXXXXX-XXXXXXXXXXXXXXXXXXXXXXXXXXXXXXXXXXXXXXXXXXXXXXXXXXXXX-XXXXXXXXXX-XXXXXXXXXXXXXXXXXXXXXXXXXXXXXXXXXXXXXXXXXXXXXXXXXXXXXXXXXXXXXXXXXXXXXXXXXXXXXXX-XXXXXX-XXXXXXXXX
XXXXXX-XXXXXXX-XXXXXXXXXXXXXXXXXXXXXXXXXXXXXXXXXXXXXXXXXXXXXXXXXXXXX-XXXXXXXXXX-XXXXXXXXXXXXXXXXXXXXXXXXXXXXXXXXXXXXXXXXXXXXXXXXXXXXXXXXXXXXXXXXXXXXXXXXXXXXXXX-XXXXXX-XXXXXXXXX
