------------------------------------------------------------------------------------------------------------------------------------------------------
------------------------------------------------------------------------------------------------------------------------------------------------------
------------------------------------------------------------------------------------------------------------------------------------------------------
------------------------------------------------------------------------------------------------------------------------------------------------------
------------------------------------------------------------------------------------------------------------------------------------------------------
----------------oo---------------------------------ooo-----------------------------------------------------------------oooo---------------------------
---------------------------------------------------%%%---------o-------------#---oo------------------------o-----------%%%%---------------------------
-----------------------------------%--%----------S--|------------------------#---------------------------------------S--||----------------------------
---------------------------------%------------------|-----------------------##------------------------------------------||-------------%--------------
----------------------------------------------------|-----------------------##----SSSS----------------------------------||----------------------------
----------------------------%-----------------------|-----%%%%--%----------###------------------------------%-----------||---------------%------------
--------------------------------------------------U-|------||--------------###----------------------------------------U-||----------------------------
-----------------%%%%%------------------------------|------||--------------###------------------------------------------||-------------------------F--
--M---------------|||-------------------------------|------||--------------###------------------------------------------||---%---------------------#--
XXXXXXXXXXX--X----|||--XXXX--------------XXXXX----%%%%-%%%-||-----X--XXXX-XXXXXX-------XX-XX-XXXX-XXXX-XXX----XXX-XX--%%%%%----X-XXX-----------XXXXXXX
XXXXXXXXXXX--X----|||--XXXX--------------XXXXX-----||---|--||-----X--XXXX-XXXXXX-------XX-XX-XXXX-XXXX-XXX----XXX-XX---|||-----X-XXX-----------XXXXXXX
