------------------------------------------------------------------------------------------------------------------------------------------------------------------------------------------------------------------------------
------------------------------------------------------------------------------------------------------------------------------------------------------------------------------------------------------------------------------
------------------------------------------------------------------------------------------------------------------------------------------------------------------------------------------------------------------------------
------------------------------------------------------------------------------------------------------------------------------------------------------------------------------------------------------------------------------
------------------------------------------------------------------------------------------------------------------------------------------------------------------------------------------------------------------------------
-----------------------------------------------------------------------------------------------------------------------------------------y------------------------------------------------------------------------------------
--------------------------------------------------------------Q------Q-------------------------------------------------------------------##---------------------------------Q-----------------------------Q-------------------
---------------------o----------------o-----------o--------------------------------------------o-----------------------------o---------y###----------------------o-----o-------------oo--o-o----------------------------------
---------------------------------------------------------------------------------------------------------------------------------------####-----------------------------------------------------------------------------------
--------------------------------------------------------------------------------------------------------------------------------------#####-----------------------------------------------------------------------------------
---Q--Q-o---------------Q-------------------------------Q-----?------Q---------------------Q----------Q-------------Q-----T----------######-Q--o--------T-------------------Q---Q----------------Q--------?-------------------
------------------------------------#-----------#-------------------------#----------------------#----------------------T-T-----#---#######-------------T---------------------------------------------------------------------
-----------------------------------##-----------#-------------------------#----------------------#----------------------T-T-----#---#######-------------T-----------------------------------------------------------------F---
-M--------------------------------###-----------#-----------y-------------#----------------------#----------------------T-T-----#---#######-------------T-----------------------------------------------------------------#---
XXXXXXXXXXXXXXXXXXXXXXXXXXX-X-XXXXXXXXXXXXXXXXXXXXXXXXXXXX-XXXXXXXXXXXXXXXXXXXXXXXXXXXXXXXXXXXXXXXXXXXXXXXXXXXXXXXXXXXXXXXXXXXXXXXXXXXXXXXXXXXXXXXXXXXXXXX-X-XXXXXXXXXXXXXXXXXXXXXXXXXXXXXXXXX-XXXXX--XXXXXXXXXXXXXXXXXX-XXXXX
XXXXXXXXXXXXXXXXXXXXXXXXXXX-X-XXXXXXXXXXXXXXXXXXXXXXXXXXXX-XXXXXXXXXXXXXXXXXXXXXXXXXXXXXXXXXXXXXXXXXXXXXXXXXXXXXXXXXXXXXXXXXXXXXXXXXXXXXXXXXXXXXXXXXXXXXXX-X-XXXXXXXXXXXXXXXXXXXXXXXXXXXXXXXXX-XXXXX--XXXXXXXXXXXXXXXXXX-XXXXX
