------------------------------------------------------------------------------------------------------------------------------------------------------
------------------------------------------------------------------------------------------------------------------------------------------------------
------------------------------------------------------------------------------------------------------------------------------------------------------
------------------------------------------------------------------------------------------------------------------------------------------------------
------------------------------------------------------------------------------------------------------------------------------------------------------
-------------------------------ooooo--------------------------------------------------------------ooooooooooooooooo---R-------------------------------
-------------------------------%%%%%--------------------------------------------------------------%%%%%%%%%%%%%%%%%-----------------------------------
-----------------------------S--|||-------------------------------------------------------------S--|||||||||||||||------------------------------------
--------------------------------|||------------------------------------------------------%---------|||||||||||||||------------------------------------
--------------------------------|||----------------------------------------------------------------|||||||||||||||------------------------------------
-----%----%------%%%%%%%%--%----|||---------%------------------------------------%-----------------|||||||||||||||------------------------------------
------------------|-||||------U-|||--------------------------------------------------------------U-|||||||||||||||------------------------------------
------------------|-||||--------|||----------------------------------------------------------------|||||||||||||||---------------------------------F--
--M---%-----------|-||||--------|||----------------------------%%%---------------------------------|||||||||||||||---------------------------------#--
XXXX----X-----XX--|-||||------%%%%%%-X--X-----X-X--XX-XXXX-X----|---%%%-----XXXX---X---X---XXXX--%%%%%%%%%%%%%%%%%%-%----XX-XXX--XXXX-XXXXXXXXXX-XXXXX
XXXX----X-----XX--|-||||-------||||--X--X-----X-X--XX-XXXX-X----|----|------XXXX---X---X---XXXX---||||||||||||||||-------XX-XXX--XXXX-XXXXXXXXXX-XXXXX
