----------------------------------------------------------------------------------------------------------------------------------------------------------------------------------------
----------------------------------------------------------------------------------------------------------------------------------------------------------------------------------------
----------------------------------------------------------------------------------------------------------------------------------------------------------------------------------------
----------------------------------------------------------------------------------------------------------------------------------------------------------------------------------------
----------------------------------------------------------------------------------------------------------------------------------------------------------------------------------------
----------------------------------------------------------------------------------------------------------------------------------------------------------------------------------------
--------2---------------------------------------------------------------------------------------#--------##-----------------------------------------------------------------------#-----
-----------------------y------------------------------------------------------------------------#--------##-----------------------------------------------------------------------#-----
---------------------#SS--o---------------------------------------------------------------------#---oo---##-----------------------------------------------------------------------#-----
--------------------##------------o--------------o--------------------------o-------------------#--------##---?Q---------------------------------o-----------o---------------o----#-----
--------2-----o-----##--SC------o----------o-----------Q------------------------o--------Q------#--------##---------------------------Q--------------------o----------------------#-----
--------------------##-------------------------------------#------------------------------------#--------##-------------------------#---------------------------------------------#-----
--------------------##---SSS------------------------------##------------------------------------#--------##------y-----------------##---------------------------------------------#-F---
----M----y----------##------------------------y-----------------y-------------------------------#--------##---SSSS---------y-----------------------y-----------------y------------#-#---
XXXXXXXXXXXXXXXXXXXXXX------XXXXXXXXXX-XXXXXXXXXXXXXXXXXXXXXXXXXXXXXXXXXXX-XXXXXXXXXXXXXXXX---X-XXX--XX--XXXX----XXXXX--X-XXXX-XX-XXXXXXXXXX-XXXXXXXXXXXX-XXXXXXXXXXXXXXXXXXXXXXX-XXXXXX
XXXXXXXXXXXXXXXXXXXXXX------XXXXXXXXXX-XXXXXXXXXXXXXXXXXXXXXXXXXXXXXXXXXXX-XXXXXXXXXXXXXXXX---X-XXX--XX--XXXX----XXXXX--X-XXXX-XX-XXXXXXXXXX-XXXXXXXXXXXX-XXXXXXXXXXXXXXXXXXXXXXX-XXXXXX
