--------------------------------------------------------------------------------------------------------------------------------------------------------------
--------------------------------------------------------------------------------------------------------------------------------------------------------------
--------------------------------------------------------------------------------------------------------------------------------------------------------------
S----SSSSSSSSSSSSSSSSSSSSSSSSSSSSSSSSSSSSSSSSSLSSLSSSSSSSSSSSSSSSLSSSSSSSSSSSSSSSSSSSSSSSSSSSSSSSLSSSSSSSSSSSSSSSSSSSSSSSSSSSSSLSSSSSSSSSLSSSSSSSSSSSSS-------
S------SS-SS-----------------SS--------------------------------------------------------------------------S------SS--SS-------------------------SS-------------
S------SS-SS-----------------SS---------------------------------------------------g----------------------S------SS--SS-------------------------SS-------------
S--------------------------------------------oo-oo--------------oo---------------SS-------------oo------S---------------------oo--------oo--------------------
S--------------------------------------------------------------------------------SS---------------------S-----------------------------------------------------
S---------------S-U--------------------------SS-SS--------------SS---------------SS-------------SS------S--S-U----------------SS--------SS--------------------
S------oU-g-----SoS----------oU----C---------SS-SS--------------SS---------------SC-------------SS------S--SoS--oU--g---------SS--------SS-----oU-------------
S------SS-SS----SSS----------SS--------------------@Q----------------------------SS---------------------SS-SSS--SS--SS---T---------------------SS-----#-------
S-----------------------#--#--------------------------------------------------------------#--------------S---------------T----------------------------#-------
S---------------------T-#--#--------------------------------------------------------------#--------------S---------------T-------------------#--------#-------
S--M------------------T-#--#-------E----------------------g-g---------------g-------------#-g-------g--------------------T-------g----g------#--------#-----F-
XXXXXXXXXXXX-XXXXXXX-XXXXXXXXXXXXXXXXXXXXXX-XXXXXXXXXXX-XXXXXXXXXXXXXX-X-XXXXXXXXXXXX-XXXXXXXXXXXXXXXXXXXXXXXXXXXXXXXX-XXXXXXXXXXXXXXXXXXXXXXXXXXXXXXXX-X--XXX
XXXXXXXXXXXX-XXXXXXX-XXXXXXXXXXXXXXXXXXXXXX-XXXXXXXXXXX-XXXXXXXXXXXXXX-X-XXXXXXXXXXXX-XXXXXXXXXXXXXXXXXXXXXXXXXXXXXXXX-XXXXXXXXXXXXXXXXXXXXXXXXXXXXXXXX-X--XXX
