------------------------------------------------------------------------------------------------------------------------------------------------------
------------------------------------------------------------------------------------------------------------------------------------------------------
------------------------------------------------------------------------------------------------------------------------------------------------------
-------------ooooo----------------------------------------------o--o----------------------------------------------------------------------------------
-------------------------------------------------------------------------g----------------------------------------------------------------------------
-------------------%%%-----------------------------------------------%%%%%%%----oo-------------------------------------------------oo---ooo-R---------
--------------------|-------------------------------------------------|-|||--------------##--------------#------------------------------%%%-----------
--------------------|-------------------------------------------------|-|||--------------##--------------#-------------------------------|------------
--------------------|-------------------------------------------------|-|||--%---------####-------------##-------------------------------|------------
-----------%%%%%%%%-|-------------------SS----------------SS--%%%%%%%-|-|||------------####------SS-----##-------------------------------|------------
------------||||||--|-----------------------------%%%-%--------||-||--|-|||------SS---#####------------###------%%%-----------------SS---|------------
------------||||||--|------------------------------|-----------||-||--|-|||-----------#####------------###-------|---------------------U-|------------
------------||||||--|------------------------------|-----------||-||--|-|||-----------#####------------###-------|-----------------------|---------F--
-M--------%-||||||--|------------------------------|---------%-||-||--|-|||-----------#####------------###-------|--%--------------------|---------#--
XXXX----%---||||||--|--XXX-XXXX--XXX---------XXXX--|-----------||-||--|-|||----------XXXXXXXX-------XXXXXXX-XX---|----XXX----X---X-----%%%%---X-%-XXXX
XXXX--------||||||--|--XXX-XXXX--XXX---------XXXX--|-----------||-||--|-|||----------XXXXXXXX-------XXXXXXX-XX---|----XXX----X---X------||----X---XXXX
