-----------------------------------------------------------------------------------------------------------------------------------------------------------------------------------------------------
-----------------------------------------------------------------------------------------------------------------------------------------------------------------------------------------------------
-----------------------------------------------------------------------------------------------------------------------------------------------------------------------------------------------------
-----------------------------------------------------------------------------------------------------------------------------------------------------------------------------------------------------
------------------------------------------------------------------------------------------------------------------------------------------------------------------------------X----------------------
------------------------------------------------------------------------------------------------------------------------------------------------------------------------------X----------------------
------------S-------------------S-S-----------------S------S------------?---QQ--C-----------S-?--S-------------------------S---------------------------------S------?---------X----------S-----------
------------------------------------------------------------------------------------------------------------------------------------------------------------------------------X----------------------
------------------------------------------------------------------------------------------------------------------------------------------------------------------------------X----------------------
-----------------------------------------E-----T--------------------------T---------------------------------------------------------------------------------------------------X------E---------------
-----T-----------T----------------------TT-----T--------------------S-Q---T-?Q-SS-----------------------------------------------T-------------------C------T------Q-----------X-----TT---------------
-----T--------g--T------#---------------TT-----T-------#------------------T------------TT---------------------------------------T--------------------------T------------T-g---X-----TT--------g------
-----T--------TT-T------#---------------TT-----T--#----#------------------T------------TT---------------------------------------T--------------------------T------------T-TT--X-----TT--------TT-F---
--M--T--------TT-T------#---------------TT-----T-##----#-----g---------K--T-----k-g----TT----K-----------g----------------------T------------k-----gg------T-------K----T-TT--X-----TT--------TT-X---
XXXXXXXXXXXXXXXXXXXXXXX-XXX-XX-XXXXXXXXXXXXXXXXXXXXXXX-XXXXXXXXXXXXXXXXXXXXXXXXXXXXXXXXXXXXXXXXXXXXXXXXXXXXXXXX-XXXXXXXX-XXXXXXXXXX-XX-X-XXXXXXXXXXXXXXXXXXXXXXXXXXXXXXXXXXXXXXXXXXXXXX-XXXXXXXXXXXXX
XXXXXXXXXXXXXXXXXXXXXXX-XXX-XX-XXXXXXXXXXXXXXXXXXXXXXX-XXXXXXXXXXXXXXXXXXXXXXXXXXXXXXXXXXXXXXXXXXXXXXXXXXXXXXXX-XXXXXXXX-XXXXXXXXXX-XX-X-XXXXXXXXXXXXXXXXXXXXXXXXXXXXXXXXXXXXXXXXXXXXXX-XXXXXXXXXXXXX
