----------------------------------------------------------------------------------------------------------------------------------------------------------------------------------------
----------------------------------------------------------------------------------------------------------------------------------------------------------------------------------------
----------------------------------------------------------------------------------------------------------------------------------------------------------------------------------------
----------------------------------------------------------------------------------------------------------------------------------------------------------------------------------------
----------------------------------------------------------------------------------------------------------------------------------------------------------------------------------------
----------------------------------------------------------------------------------------------------------------------------------------------------------------------------------------
-----------------------------------------------------------------------------------------------------#------------#------------------------------------------------------US-------------
---------------------------------------------------------------------y-------------------------------#------------#---------------------------------------------------------------------
-----------------------------------------oo------------------------#SS--o----------------------------#------------#------------------------------y--------------------------------------
--------------------------?Q--------------------------------------##---------------------------------#------------#---------?Q----------o--------XS----------------------------?Q-------
------o--------------------------------------o-------SC-----------##--SC------------Q----------Q-----#-------Q----#-----------------------------XX------o---------------####------------
------------------------------------------------------------------##----------------------T----------#------------#----------------------------XXX------------------y-####--------------
-----------------------------y------------------------------------##---SSS----------------T----------#------------#-------------y-------------XXXX------------------####----------y-F---
----M---------y---y-y-----SSSS--------------------------------y-y-##--------y-------------T----------#------------#---------SSSSS------------XXXXX-----------------####--------SSSS-#---
XXXXXXXXX-X-XXXXXXXXXX-XX----XXXXXXX--X---XXXXX-XXXX-XXXX-X-XXXXXXXX------XXXX-XXX-XXXXX-XXXX-XXXXX--XX-X-XXXXXXX-XXXX-XXXX-----XXXX-XXXXXXXXXXXXX----XXXXXXXXXX-XXXX-----XX-X----XXXXXX
XXXXXXXXX-X-XXXXXXXXXX-XX----XXXXXXX--X---XXXXX-XXXX-XXXX-X-XXXXXXXX------XXXX-XXX-XXXXX-XXXX-XXXXX--XX-X-XXXXXXX-XXXX-XXXX-----XXXX-XXXXXXXXXXXXX----XXXXXXXXXX-XXXX-----XX-X----XXXXXX
