----------------------------------------------------------------------------------------------------------------------------------------------------------------------------------------------------
----------------------------------------------------------------------------------------------------------------------------------------------------------------------------------------------------
----------------------------------------------------------------------------------------------------------------------------------------------------------------------------------------------------
----------------------------------------------------------------------------------------------------------------------------------------------------------------------------------------------------
----------------------------------------------------------------------------------------------------------------------------------------------------------------------------------------------------
----------------------------------------------------------------------------------------------------------------------------------------------------------------------------------------------------
-----------US--S----------S--------------------------S---S-----S-S-----S-S-S---------S-------S-S----------SQS--------------S---------S----------------------------S-S---------S----------S----------
----------------------------------------------------------------------------------------------------------------------------------------------------------------------------------------------------
----------------------------------------------------------------------------------------------------------------------------------------------------------------------------------------------------
-----------------------------------------------------------------------------------------------------------K-------------------------------------?--------------------------------------------------
---S------#----S----------SS-----T-SS----------S-----S---S---S-S-S-----S-S-S---------S-------S-S-S------T-SSS--S-----------S----S----SS---T------------S----SS----S-S---------S--Q-------S----------
---------##----------------------T--K------------------------------------------T------------------------T--------------T------------------T---------TT---T---K-----------------------------T--------
---------###---------------------T---------------------------------------------T------------------------T--------------T------------------T---------TT---T---------------------------------T-----F--
-M-------###-g---------------g---T-------------K-----------------g-------------T-----------g--------k---T------K-------T------g-----------T---------TT-K-T-------------------------------g-T-g-g-#--
XXXXXXXXXXXXXXXXX--X-XXXXXXXXXXXXXXXXXXXXXXXXXXXX--XXXXXXXX-XXXXXXX-XXXXXXXXXXXXXX-XXXXXXXXXXXXXXXXXXXXXXXXXXXXXXXXX--XXXXXXXXXXXXXXXXXXXXXXXXXXXXXXXXXXXXXXXXXXXXXXXXX-X-XXXXXXXXXX-XXXXXXXXXXXXXXX
XXXXXXXXXXXXXXXXX--X-XXXXXXXXXXXXXXXXXXXXXXXXXXXX--XXXXXXXX-XXXXXXX-XXXXXXXXXXXXXX-XXXXXXXXXXXXXXXXXXXXXXXXXXXXXXXXX--XXXXXXXXXXXXXXXXXXXXXXXXXXXXXXXXXXXXXXXXXXXXXXXXX-X-XXXXXXXXXX-XXXXXXXXXXXXXXX
