----------------------------------------------------------------------------------------------------------------------------------------------------------------------------------------------------
----------------------------------------------------------------------------------------------------------------------------------------------------------------------------------------------------
----------------------------------------------------------------------------------------------------------------------------------------------------------------------------------------------------
----------------------------------------------------------------------------------------------------------------------------------------------------------------------------------------------------
----------------------------------------------------------------------------------------------------------------------------------------------------------------------------------------------------
----------------------------------------------------------------------------------------------k-------------------------------------------------------------------------------k---------------------
--------SQS----------S---------S------------------S------------------------------------------##------------------------------------------------------------------------------##---------------------
--------------------------------------------------------------------------------------------###-----------------------------------------------------------------------------###---------------------
------------------------------------#------------------------------------------------------####----------------------------------------------------------------------------####---------------------
---------K--------------------------#----?-------------------------------------------------####----------------------------------------------------------------------------####---------------------
--------SSS--------S-S-----S---S----#-------SS----S----------#---S--------TT--------SCS----####-S---T---------------------------------T----------------S----------S--------####---------------------
-----------------------------------##--------K---------------#------------TT----------K---#####-----T---------------------------------T-------------------T---------------#####---------------------
-----------------------------------##------------------------#------------TT--------------#####-----T------T--------------------------T-------------------T---------------#####------------------F--
-M-----------------K-g--g------g---##-------------g----------#--------g---TT------k-K-----#####-K-g-T------T----------------g---g-----T------g------------T-------K-------#####---k--------------#--
XXXXX-XXXXXX--XXXXXXXXXXXXXXXXXXXXXXX-XXXXXXXXXX-XXXXXXXXX-X-X--XXXXXXXXXXXXXX-X-XXXXXXXXXXXXXXXXXXXXX-XXXXXX--XXXXXXX-XXXXXXXXXXXXXXXXXXXX-XXXXXX-X-XXXXXXXXXXXXXXXXXXXXXXXXXXX-XXXXXXXX-XXXXXXXXXX
XXXXX-XXXXXX--XXXXXXXXXXXXXXXXXXXXXXX-XXXXXXXXXX-XXXXXXXXX-X-X--XXXXXXXXXXXXXX-X-XXXXXXXXXXXXXXXXXXXXX-XXXXXX--XXXXXXX-XXXXXXXXXXXXXXXXXXXX-XXXXXX-X-XXXXXXXXXXXXXXXXXXXXXXXXXXX-XXXXXXXX-XXXXXXXXXX
