------------------------------------------------------------------------------------------------------------------------------------------------------------------------------------------------------
------------------------------------------------------------------------------------------------------------------------------------------------------------------------------------------------------
------------------------------------------------------------------------------------------------------------------------------------------------------------------------------------------------------
------------------------------------------------------------------------------------------------------------------------------------------------------------------------------------------------------
------------------------------------------------------------------------------------------------------------------------------------------------------------------------------------------------------
------------------------------------------------------------------------------------------------------------------------------------------------------------------------------------------------------
---------------------------------------------------------------------------------------------------------------#--------------------------------------------------------------------------------------
---------------------------------------------------------------------------------------------------------------#--------------------------------------------------------------------------------------
-----------------------------------------------------------------------T------------------T------------T-------#------------------------------------------------------------T-------------------------
-----------------------------------------------------------------------T------------------T------------T-------#------------------------------------------------------------T-------------------------
-----------------------------------------------------------------------#------------------#------------#-------#------------------------------------------------------------#-------------------------
-----------------------------------------------------------------------------------------------T---------------#-----------------------------K-----------------------K--------------------------------
----------------------*------------------------------------------------------------------------T--------------------------------------------------------------------------------------------------F---
-M--------------------*----K------g-----------g-gg----------k------------g-g--------g---K------T-----g---g---g------------g---g-----------g-----g-----gg--g---------------------k------k-g--g-----#---
XXX-XXXXXXXXXXXXXXXXXXXXXXXXX-XXXXXXXX-XXX-XXXXXXXXX-XXXXXXXXXXXXXXXXXXXXXXXXXXXXXXXXXXXXXXXXX-XXXX-XXXXXXXXXXXXXXXXXXXXXXXXXXXXXX-XXXXXXXXXXXXXXXXXXXXXXXXXXXXXXXXXXXXXXX-XXXXXXXXXXXXXXXXXXXXXXXXX-X
XXX-XXXXXXXXXXXXXXXXXXXXXXXXX-XXXXXXXX-XXX-XXXXXXXXX-XXXXXXXXXXXXXXXXXXXXXXXXXXXXXXXXXXXXXXXXX-XXXX-XXXXXXXXXXXXXXXXXXXXXXXXXXXXXX-XXXXXXXXXXXXXXXXXXXXXXXXXXXXXXXXXXXXXXX-XXXXXXXXXXXXXXXXXXXXXXXXX-X
