--------------------------------------------------------------------------------------------------------------------------------------------------------------------------------
--------------------------------------------------------------------------------------------------------------------------------------------------------------------------------
--------------------------------------------------------------------------------------------------------------------------------------------------------------------------------
--------------------------------------------------------------------------------------------------------------------------------------------------------------------------------
--------------------------------------------------------------------------------------------------------------------------------------------------------------------------------
-----------k--------------------------------------------------------------------------------k------------------------------------k-----------k----------------------------------
-----------##------------------------SS---USS--S-------------------------------S------------##-----------USS---------------------##----------##---------------------------------
----------###------------------------------------------------------------------------------###----------------------------------###---------###---------------------------------
---------####-----------------------------------------------------------------------------####------------------B---------#----####--------####------#------------B-------------
--------#####----------------------------------------------------------------------------#####------------------b--------##---#####-------#####-----##------------b-------------
-------######------------------------SS--------S-------------------------------S--------######-----------------S#CS-----###--######------######----###-----------S#CS-----------
------#######----------------------#-------B------#-------------------K----------------#######----K-------B------------####-#######-----#######---####-#-T----------------------
------#######-----------T----------#----T--b------#---------------------T--------------#######------------b-------K--B-####-#######-----#######---####-#-T----------K-------F---
-M----#######-----------T----------#----T--B------#---------------------T--------------#######------------B----------b-####-#######-----#######---####-#-T------------------#---
XXXXXXXXXXXXXXXXX-XX-XXXXX-XXXXXXXXXXXXXXXXXXXXXXXXXX-XXXXXXXXXXXXXXXXXXXXXXXXXXXXXXXXXXXXXXXXXXXXXXXXXXXXXXXXXXXXXXXXXXXXXXXXXXXXXXXXXXXXXXXXXXXXXXXXXXXXXXXXXXXXXXXXXXXXXXXXXX
XXXXXXXXXXXXXXXXX-XX-XXXXX-XXXXXXXXXXXXXXXXXXXXXXXXXX-XXXXXXXXXXXXXXXXXXXXXXXXXXXXXXXXXXXXXXXXXXXXXXXXXXXXXXXXXXXXXXXXXXXXXXXXXXXXXXXXXXXXXXXXXXXXXXXXXXXXXXXXXXXXXXXXXXXXXXXXXX
