------------------------------------------------------------------------------------------------------------------------------------------------------------------------------------------------------------------------------
------------------------------------------------------------------------------------------------------------------------------------------------------------------------------------------------------------------------------
------------------------------------------------------------------------------------------------------------------------------------------------------------------------------------------------------------------------------
------------------------------------------------------------------------------------------------------------------------------------------------------------------------------------------------------------------------------
------------------------------------------------------------------------------------------------------------------------------------------------------------------------------------------------------------------------------
------------------------------------------------------------------------------------------------------------------------------------------------------------------------------------------------------------------------------
------------------------------------------------------------------------------------------------------------------------------------------------------------------------------------------------------Q-----------------------
------------o---------------o------o-------------------------o--o--------------------------o--------------------o--------------o-------------------o----o----o-------------------------------oo---------o-------------------o-
------------------------------------------------------------------------------------------------------------------------------------------------------------------------------------------------------------------------------
------------------------------------------------------------------------------------------------------------------------------------------------------------------------------------------------------------------------------
---------------------Q-----------------------------------------------Q-Q-------------------------------------------T----------------------T------o--------------------------------------------------o-Q-----------------------
----------------------------------------#------#------------------------------------------------------------T------T----------------------T-----------------------------------------------------------------------------------
----------T----------------------------##------#------------------------------------------------------------T------T----------------------T-------------------------------------------------------------------------------F---
-M-----y--T---------------------------###------#---------------------------------------y--------------------T------T----------------------T-----------------------------------------------------------------------y----y--#---
XXXXXXXXXXXXXXXXXXX-XXXXXXXXXXXXXXXXXXXXXXXX-XXXXXXXXXXXXXXXXXXXXX-XXXXXXXXXXXXXXXXXXXXXXXXXXXXX-XXXX-XXXXXXXXXXXXXXXXXX-XXX-XXXXXXXX-XXXXXXXXXXXXXXXX-XXXXXXXXXXXXX-XXXXXXXXXXX-XXXXXXXXX--XXXX-XXXXXXXXX-XXXXXXXXXXXXXXXXXXX
XXXXXXXXXXXXXXXXXXX-XXXXXXXXXXXXXXXXXXXXXXXX-XXXXXXXXXXXXXXXXXXXXX-XXXXXXXXXXXXXXXXXXXXXXXXXXXXX-XXXX-XXXXXXXXXXXXXXXXXX-XXX-XXXXXXXX-XXXXXXXXXXXXXXXX-XXXXXXXXXXXXX-XXXXXXXXXXX-XXXXXXXXX--XXXX-XXXXXXXXX-XXXXXXXXXXXXXXXXXXX
