--------------------------------------------------------------------------------------------------------------------------------------------------------------
--------------------------------------------------------------------------------------------------------------------------------------------------------------
--------------------------------------------------------------------------------------------------------------------------------------------------------------
S----SSSSSSSSSSSSSSSLSSSSSSSSSSSLSSSSSSSSSSSSSSSLSSSSSSSSSSSSSSSSSSSSSSSSSSSSSSSSSSSSSSSSSSSSSSSSLSSSSSSSLSSSSSSSSSSSSSSSSSSSSSSSSSSLSSSSSSSSSSSSSSSSSSSS-----
S----------------------------------SS-------------------------------------------------------------------------------------SS--SS------------------------------
S----------------------------g-----SS---------------------------------------------------------------------------------g---SS--SS------------------------------
S------------------oo-------SS-oo--------------oo---------------------------------------------oooo------oo-----------SS------------oo-------------------------
S---------------------------SS---------------------------------------------------------------------------------------SS---------------------------------------
S------------------SS-------SS-SS--------------SS---------------------------------------------SSSS------SS---S-U-----SS------------SS-------------------------
S------------------SS-------SC-SS--oU----------SS---------------------------------------------SSSS------SS---SoS-----SC---oU--oU---SS-------------------------
S-------------#-------------SS-----SS--------------#------@Q----T---------------------#-------------#--------SSS-----SS---SS--SS-T------------#---------#-----
S-------------#----------------------------#-------#-#----------T---T--------------TT-#-------------#----------------------------T------------#---------#-----
S-------------#----------------------------#-------#-#----------T---T--------------TT-#-------------#----------------------------T----------T-#---------#-----
S--M----------#--g-------------------------#-------#-#--g-------T---T--------------TT-#-------------#----------------------------T----------T-#-g-g-g---#---F-
XXXXXXXXXXXXXXXXXXXXXXX-XXXXXXXXXXXXXXXXXXXXXXXXXXXXXXXXXXXXXXXXXXXXXXX-XXX--XX-XXXXXXXXXXXX-XXXXXXXXXXXXXXXXXXXXXXXXXXXXXXXXXXXXXXXXX-XX-XXXXXXXXXXXXXXX-XXXX
XXXXXXXXXXXXXXXXXXXXXXX-XXXXXXXXXXXXXXXXXXXXXXXXXXXXXXXXXXXXXXXXXXXXXXX-XXX--XX-XXXXXXXXXXXX-XXXXXXXXXXXXXXXXXXXXXXXXXXXXXXXXXXXXXXXXX-XX-XXXXXXXXXXXXXXX-XXXX
