------------------------------------------------------------------------------------------------------------------------------------------------------------------------------------------------------------------------------
------------------------------------------------------------------------------------------------------------------------------------------------------------------------------------------------------------------------------
------------------------------------------------------------------------------------------------------------------------------------------------------------------------------------------------------------------------------
------------------------------------------------------------------------------------------------------------------------------------------------------------------------------------------------------------------------------
------------------------------------------------------------------------------------------------------------------------------------------------------------------------------------------------------------------------------
---------------------------------------------------------------------------------------------------------------------------------y----------------y---------------------------------------------------------------------------
-----------------------------------------------------------------------------------Q---------------------------------------------##-----Q---------##------------Q-----------Q-------------------------Q-----------------------
--------------------o------------oo------------------------------------------------------------o------------o------------------y###-o-----------y###---------------o-----o------o---------------------------------------------
-------------------------------------------------------------------------------------------------------------------------------####-------------####--------------------------------------------------------------------------
------------------------------------------------------------------------------------------------------------------------------#####------------#####--------------------------------------------------------------------------
-----------------------------------------------Q--------------------------------T--Q--T--Q-----------------------------------######---T-Q--T--######------------Q-----------?-------------------T-Q---Q-----------------------
-----------T---------------------------#--------------------------------------#-T-----T---------------T---------------------#######---T----T-#######--------------------------------------------T-----------------------------
-----------T--------------------------##--------------------------------------#-T-----T----T----------T---------------------#######---T----T-#######-------------------------------------T------T-------------------------F---
-M------y--T-------------------------###--------------------------------------#-T-----T----T--------y-T---y-----------------#######---T----T-#######-------------------------------------T------T-------------------------#---
XXXXXX-XXXXXXXXXXXXXXX-XXX-XXXXXXXXXXXXXXX-XXXXXXXX-XXXXXXXX-XXXXXXXXXXXXX-XXXXXXXXXXXXXXXXXXXXXXXXXXXXXXXXXXXXX-X-XXX-XX-XXXXXXXXXXXXXXXXXXXXXXXXXXX-XXXXXXXXXXXXXXXXXXXXXXXXXXXXXXXXXXXXXXXXXXXXXX-XXXXXXX---XXXXX-XXX-XXXXX
XXXXXX-XXXXXXXXXXXXXXX-XXX-XXXXXXXXXXXXXXX-XXXXXXXX-XXXXXXXX-XXXXXXXXXXXXX-XXXXXXXXXXXXXXXXXXXXXXXXXXXXXXXXXXXXX-X-XXX-XX-XXXXXXXXXXXXXXXXXXXXXXXXXXX-XXXXXXXXXXXXXXXXXXXXXXXXXXXXXXXXXXXXXXXXXXXXXX-XXXXXXX---XXXXX-XXX-XXXXX
