-------------------------------------------------------------------------------------------------------------------------------------------------------------------------------------------------------------------------------------------------------------------------------------------------------------------------------------------------------------------------------------
-------------------------------------------------------------------------------------------------------------------------------------------------------------------------------------------------------------------------------------------------------------------------------------------------------------------------------------------------------------------------------------
-------------------------------------------------------------------------------------------------------------------------------------------------------------------------------------------------------------------------------------------------------------------------------------------------------------------------------------------------------------------------------------
-------------------------------------------------------------------------------------------------------------------------------------------------------------------------------------------------------------------------------------------------------------------------------------------------------------------------------------------------------------------------------------
-------------------------------------------------------------------------------------------------------------------------------------------------------------------------------------------------------------------------------------------------------------------------------------------------------------------------------------------------------------------------------------
-----------------------------------------------------------------------------------------------------------------------------------------------------------------------------------------------------------------------------------------------o-------------------------------------------------------------------------------------------------------------------------------------
-------------------------------------------------------------------------------------------------------------------------------------------------------------------------------------------------------------------------------------------------------------------------------------------------------------------------------------------------------------------------------------
-------------------------------------------------------------------------------------------------------------------------------------------------------------------------------------------------------------------------------------------------------------------------------------------------------------------------------------------------------------------------------------
-------------------------------------------------------------------------------------------------------------------------------------------------------------------------------------------------------------------------------------------------------------------------------------------------------------------------------------------------------------------------------------
-------------------------------o------------------------------S----------oo--------------------------------------1----------o-----S-------------------------------------------------------------------------------------------------------S----------------------------S-----S-------S---------------------------------------------------------S-S-----------------S-----------------
------------T-----------------------------------------------------------------------------------------T-------------------T----------T-------------------------T--------------------------T----------------------------T---T----------------------------T------------------------------T--------------------------------------------------------------------------------T--T---------
------------T---------------------------------------------------------------T----------T--------------T-------------------T----------T-----------T-------------T------------T-------------T----------------------------T---T-------T--------------------T--------T---------------------T--------------------------------------------------------------------------------T--T---------
------------T---------------------------------------------------------------T------#---T--------------T-------------------T----------T------K----T-------------T----#-------T-------------T------#---------------------T---T-------T----#---------------T-#------T-------T-------------T--------------------------------------------------------------------------------T--T-----F---
-M-----kk---T-----g----------g-----kk-----------------k----k----k-----------T------#---T---kk----g----T-----------k---g-g-T----------T-----------T--g--------k-T-k--#-----k-T-------g-----T-k----#-k----g-gg--g--------T---T--kk---T----#---g--gg-------T-#-----kT-------T--------g----T----------g-------g---g--------g-----------------kkk----------------g---k-----g-T--T---k-#---
XXX-XXXXXXX-XXX-XXXXX--XXXXXXXXXXXXXXX-XXXX-XXXXX-X-XXXXXXXXXXXXXXXX-X-X----XXXXXXXXXXXXXXXXXXXXXXXXXXXXXX--XXXXXXXXXXXXXXXXXXXXXXXX-XXXXXX-X-XX-XXXXXXXXXXXXXXXXXXXXXXXXXXXXXXXXXXXXXXXXXXXXX--XXXXXXXXXXXXXXXXX-XXX--XXXXXXXXXXXXXXXXXXXXXXXXXXXXXXXXXXXXXXXXXXXXXXXXXXXXXXXXXXXXXXXXX-XX-XXXXXXXXXXX--XXXXXXXXXXX-XXXXXXXXXXXXX--XXXXXXXXXXXXXXXXX-XX-XXXXXXXXXXXXXXXXXXXXXXXXXXXX
XXX-XXXXXXX-XXX-XXXXX--XXXXXXXXXXXXXXX-XXXX-XXXXX-X-XXXXXXXXXXXXXXXX-X-X----XXXXXXXXXXXXXXXXXXXXXXXXXXXXXX--XXXXXXXXXXXXXXXXXXXXXXXX-XXXXXX-X-XX-XXXXXXXXXXXXXXXXXXXXXXXXXXXXXXXXXXXXXXXXXXXXX--XXXXXXXXXXXXXXXXX-XXX--XXXXXXXXXXXXXXXXXXXXXXXXXXXXXXXXXXXXXXXXXXXXXXXXXXXXXXXXXXXXXXXXX-XX-XXXXXXXXXXX--XXXXXXXXXXX-XXXXXXXXXXXXX--XXXXXXXXXXXXXXXXX-XX-XXXXXXXXXXXXXXXXXXXXXXXXXXXX
