----------------------------------------------------------------------------------------------------------------------------------------------------------------------------------------------------------------------
----------------------------------------------------------------------------------------------------------------------------------------------------------------------------------------------------------------------
----------------------------------------------------------------------------------------------------------------------------------------------------------------------------------------------------------------------
----------------------------------------------------------------------------------------------------------------------------------------------------------------------------------------------------------------------
----------------------------------------------------------------------------------------------------------------------------------------------------------------------------------------------------------------------
-----------------------------------------------------------------------------------------------------------------------------------------------------------------------------------------------------------g----------
--------S------------S-S-----------S-------S---S-S---S--------S------------------------S--------------US-----------S--------------SS-----------------S---S--------S-----S---S---US--------------------SS-S-SS---------
--------------------------------------------------------------------------------T---------------------------------------------------------------------------------------------------------T---------------------------
--------------------------------------------------------------------------------T---------T-----------------------------------------------------------------------------------------------T---------------------------
--------------------------------------------------------------------------------X---------T----------S-------------------------------T--------------------------------T--------S----------X---------------------------
--------------T--------------------S-------S----------------S-S------------------------S--X-------------------S----S-T-------S-------T---------------S------T---T-S---T-----------------------------------------------
------T-------T-T------------T-------------------------TT---------T----T---------------------------------------------T---------------T------------TT--------T---T-----T-----------------------------------------------
------T-------T-T-T---------TT--#-----T--------------TTTT---------T----T----------------------TT-T-------------------T----------T----T----T-----T-TT--------T---T-----T-TT--TT--------T-t------TT--T--T----TTT-----F--
---M--T-----k-T-T-T---------TT-##-----T------------k-TTTT---------T----T----------------------TT-T-------------------T----------T----T----T-----T-TT--------T---T-----T-TT--TT--------T-t------TT--T--T----TTT-----#--
XXXXXXXXXXXXXXXXXXXXXXXXXXXXXXXXXXXXXXXXXXXXXXXXXXXXXXXXXXXXXXXXXXXXXXXXXXXXXXXXXXXXXXXXXXXXXXXXXXXXXXX--XXXXXXXXXXXXXXXXXX-XXXXXXXXXXX-XXXXXXXXXXXXXXXXXXXXXXXXXXXXXXXXXXXXXXXXX-XXXXXXXXXXXXXXXXXXXXXXXXXXXXXXX-XXXX
XXXXXXXXXXXXXXXXXXXXXXXXXXXXXXXXXXXXXXXXXXXXXXXXXXXXXXXXXXXXXXXXXXXXXXXXXXXXXXXXXXXXXXXXXXXXXXXXXXXXXXX--XXXXXXXXXXXXXXXXXX-XXXXXXXXXXX-XXXXXXXXXXXXXXXXXXXXXXXXXXXXXXXXXXXXXXXXX-XXXXXXXXXXXXXXXXXXXXXXXXXXXXXXX-XXXX
