------------------------------------------------------------------------------------------------------------------------------------------------------------------------------------------------------
------------------------------------------------------------------------------------------------------------------------------------------------------------------------------------------------------
------------------------------------------------------------------------------------------------------------------------------------------------------------------------------------------------------
------------------------------------------------------------------------------------------------------------------------------------------------------------------------------------------------------
------------------------------------------------------------------------------------------------------------------------------------------------------------------------------------------------------
------------------------------------------------------------------------------------------------------------------------------------------------------------------------------------------------------
--------------------#-----------------------------------------------------#---------------------------------------------------------------------------------------------------------------------------
--------------------#-----------------------------------------------------#---------------------------------------------------------------------------------------------------------------------------
--------------------#-----------------------------------------------------#---------------------------------------------------------------------------------------------------------------------------
------------K-------#-----------------------------------------------------#-------------------------#-------------------------------------------------#------------------------------#----------------
--------------------#-----------------------------------------------------#------------------------##------------------------------------------------##-----------------------------##----------------
--------------#-----#------------K---K------------------------------------#--T---------------------##----K-----------------------K--T----------------##-K---------------------------##----------------
-------------##------------------------------------T--------------*----------T-----------*--------K##--------------*----------------T---------------K##-----------*----------------K##------------F---
-M----------###-------k--------g--------g--g--k----T-------gg-----*---------kT-----------*------K--##------g-gg----*---g-----g-----kT--k----------g--##---------g-*-g------g--------##------------#---
XXXXXXXXXXXXXXXXXX-XXXXXX-XXX-XXXXXXXXXXXXXXXXXXXXXXXXXXXXXXXXXXXXXXXXXXXXXXXXXXX-XX-XXXXXXXXXXXXXXXXXXXXXXXXXXXXXXXXXXXXXXXXXXXXXXXXXXXXXXX--XX-XXXXXXXXX-XXXXXXXXXXXXXXXXXXXXXXXXXXXXXX-XXXXXXXXXXXX
XXXXXXXXXXXXXXXXXX-XXXXXX-XXX-XXXXXXXXXXXXXXXXXXXXXXXXXXXXXXXXXXXXXXXXXXXXXXXXXXX-XX-XXXXXXXXXXXXXXXXXXXXXXXXXXXXXXXXXXXXXXXXXXXXXXXXXXXXXXX--XX-XXXXXXXXX-XXXXXXXXXXXXXXXXXXXXXXXXXXXXXX-XXXXXXXXXXXX
