----------------------------------------------------------------------------------------------------------------------------------------------------------------------------------------------------------
----------------------------------------------------------------------------------------------------------------------------------------------------------------------------------------------------------
----------------------------------------------------------------------------------------------------------------------------------------------------------------------------------------------------------
----------------------------SSSSS-----SSSSSSS------------SS-------------SSSSSSS------------------------------------------------------SSSSSS------------SS-------------------------------------------------
----------------------------------------------------------------------------------------------------------------------------------------------------------------------------------------------------------
------------------------------------o---------------------------------------------------------------------------------------------------------------------------------------------------------------------
-----------------------------------------------------------------?------------------------------------------o---------S-----------------------------------------------------------------------------------
----------------------------------------------------------------------------------------------------------------------------------------------------------------------------------------------------------
---------------------------------------------------------------------------------------S---------------------------------------------------------------------------------------------------------T--------
-----------S-------------------------------------------------T-----------------------------------------------------------------------------------------------------------------------------------T--------
------T-------------------------Q-T-------g-Q-------------#--T-T----S-----T--------------------------T--#------------------S--------------Q-----T-------Q-------------------S--------------------T--------
------T--------------T------------T-------#---------#-----#--T-T----------T---##---------------------T--#--------K------------------------------T------------------------------------------------T--------
------T--------------T-T----------T-------#---------#-----#--T-T----------T---##---------------------T--#---------------------------------------T--T-------------------T-----------------T-------T----F---
---M--T--------------T-T--g-------T------k#----g---k#-----#--T-T----------T---##------------#--------T--#-------g----kk------g------------------Tk-Tg--------g---#-----T------g----------T-------T----X---
XXXXXXX-XXXXXXXXXXX-XXXXXXXXXX-XX-XX-XXX-XXXX-XXX-XXXXXXXXX-XXXXXXX---XXXXXXXXXXXXXXXXXXX-XXXXXXXXX-XXXXXX-X--XXXXXXXXXX---XXXXXXXXXXXXXXXX-XXXXXXXXXXXXX-XXXXXXXXXXX-XXX-X-XXX--XXXXXXXXXXXXXXXXXXXXXXXXX
XXXXXXX-XXXXXXXXXXX-XXXXXXXXXX-XX-XX-XXX-XXXX-XXX-XXXXXXXXX-XXXXXXX---XXXXXXXXXXXXXXXXXXX-XXXXXXXXX-XXXXXX-X--XXXXXXXXXX---XXXXXXXXXXXXXXXX-XXXXXXXXXXXXX-XXXXXXXXXXX-XXX-X-XXX--XXXXXXXXXXXXXXXXXXXXXXXXX
