------------------------------------------------------------------------------------------------------------------------------------------------------------------------------------------------------
------------------------------------------------------------------------------------------------------------------------------------------------------------------------------------------------------
------------------------------------------------------------------------------------------------------------------------------------------------------------------------------------------------------
------------------------------------------------------------------------------------------------------------------------------------------------------------------------------------------------------
------------------------------------------------------------------------------------------------------------------------------------------------------------------------------------------------------
------------------------------------------------------------------------------------------------------------------------------------------------------------------------------------------------------
------------------#--------------------------#--------------------------------------------------------------------------------#-----#-----------------------------------------------------------------
------------------#--------------------------#--------------------------------------------------------------------------------#-----#-----------------------------------------------------------------
------------------#--------------------------#-------------------T------------------------------------------------------------#-----#-----------------------------------------------------------------
------------------#--------------------------#-------------------T----------K-------------------------------------------------#-----#-----------------------------------------------------------------
------------------#--------------------------#-------------------#------------------------------------------------------------#-----#-----------------------------------------------------------------
------------------#--------------------------#--------------------------------#-----------------------------------------------#-----#----------------------------------------------K------------------
-------------T-------------------*-------------*-----------------------------##-------------------T----------T--------T----------------T----------------------------------------------------------F---
-M-----g-----T-g-------g-g----k--*---g---g-K---*---g-----g-----g----g-------###-----g--------g----T--g-------T-g------T--g-------------T--ggg----gg---k-------g---------------k--------g--k-------#---
XXXXXXXXXXXXXXXXXXXXXXXXXXXXXXXXXXXXXXXXXXXXXXXXXXXXXX--XXXXXXXXXXXXXXXXXXXXXXXXXXXXXXXXXXXXXXXXXXXXXXXXXXXXXXXXXXXXXXXXXXX-XXXXXXXXXXXXXXXXXXX-XXXXXXXXXX-XXXXXXXXXXXXXXXXXXXXXXXXXXXXXXXXXXXXXXXXX-X
XXXXXXXXXXXXXXXXXXXXXXXXXXXXXXXXXXXXXXXXXXXXXXXXXXXXXX--XXXXXXXXXXXXXXXXXXXXXXXXXXXXXXXXXXXXXXXXXXXXXXXXXXXXXXXXXXXXXXXXXXX-XXXXXXXXXXXXXXXXXXX-XXXXXXXXXX-XXXXXXXXXXXXXXXXXXXXXXXXXXXXXXXXXXXXXXXXX-X
