--------------------------------------------------------------------------------------------------------------------------------------------------------------
--------------------------------------------------------------------------------------------------------------------------------------------------------------
--------------------------------------------------------------------------------------------------------------------------------------------------------------
S----SSSSSSSSSSSSLSSSSSSSSSSSSSSSSSSSSSSSSSSSSSSSSSSSLSSSSSSSSSSSLSSSSSSSLSSSSSSSSSSSSSSSSLSSSSSSSSSSSSSSSSSSSSSSSSSSSSSSSSSSSSSSSSSSSSSSSSSSSSSSSSSSSSSSS----
S------------------------------------------SS--SS-------SSSS--------------------------------------------------------------------------------------------------
S-----------g------------------------------SS--SS-------SSSS-------------------------------------g------------------------------------------------------------
S----------SS---oo----------------------------------oo----------oo----oooo---------------oo-----SS------------------------------------------------------------
S----------SS-----------------------------------------------------------------------------------SS------------------------------------------------------------
S----------SS---SS----------------------------------SS----------SS----SSSS---------------SS-----SS------------------------------------------------------------
S----------SC---SS-------------------------oU--g----SS--oooU----SS----SSSS---------------SS-----SC------------------------------------------------------------
S----------SS-#-------T-#----------------#-SS--SS-------SSSS--------------------------#---------SS-------------------#---------T-------------------------#----
S-------------#-------T-#----------------#--------------------------------------------#-----T------#-----------#-----#---------T-----T-------------------#----
S-------------#-------T-#-----T----------#-------------------------------------g------#-----T------#---------g-#-g---#-----#---T-----T-#-----T-----------#----
S--M----------#-------T-#--g--T--g-------#---------------------------------g---#------#-----T------#----g---g#-#-#---#--g--#---T---g-T-#-----T-g-------g-#--F-
XXXXXXXXXXXXXXXXXXXX-XXXXXXXXXXXXXXXXXX-XXXXXXXXX-XXXXXXXXXXXX-XXXXXXXXXXXXXXXXXXXXXXXXXXXXXXXXXXXXXXXXXXX-XXXXXXXXXXXXXXXXXXXXXXXXXXXXXX-XXXXXXXXX-XXXXXX-XXX
XXXXXXXXXXXXXXXXXXXX-XXXXXXXXXXXXXXXXXX-XXXXXXXXX-XXXXXXXXXXXX-XXXXXXXXXXXXXXXXXXXXXXXXXXXXXXXXXXXXXXXXXXX-XXXXXXXXXXXXXXXXXXXXXXXXXXXXXX-XXXXXXXXX-XXXXXX-XXX
