--------------------------------------------------------------------------------------------------------------------------------------------------------------------------------
--------------------------------------------------------------------------------------------------------------------------------------------------------------------------------
--------------------------------------------------------------------------------------------------------------------------------------------------------------------------------
--------------------------------------------------------------------------------------------------------------------------------------------------------------------------------
--------------------------------------------------------------------------------------------------------------------------------------------------------------------------------
--------------------------------------------------------------------------------------------------------------------------------------------------------------------------------
---------------------S----USS------S------------------------------USS-----------------------------------------------------------------S-USS-------------------------------------
--------------------------------------------------------------------------------------------------------------------------------------------------------------------------------
------------B---------------------------------------------#-------------------------------------------------#-------------------------------------------------------------#-----
------------b--------------------------------------------##------------------------------------------------##------------------------------------------------------------##-----
----------SS#CS------S-------------S--------------------###-----------------------------------------------###-Q---Q-------------------S--------Q------------------------###-----
---------------------------B-----------------B---#-----####-T------B---------------------#-----------K---####----------------------------B--K--------------------------####-----
--------------K--------B---b-----------------b---#-----####-T------b------------------B--#-B-------------####----------------------------b----------------TT-----------####-F---
-M-k-------------------b---B---------------k-b---#-----####-T------B------------------b--#-b-------------####----------------------------B----------------TT------k----####-#---
XXXXXXXXXXXXXXXXXXXXXXXXXXXXXXXXXXXXXXX-XXXXXXXXXXXXXXXXXXXXXXXXXXXXXXXXXXXXXXXXXXXXXXXXXXXXXXXXXXXXXXXXXXXXXXXXXXXXXXXXXXXXXXXXXXX-XXXXXXXXXXXXXXXXXXXXXXXXXXXXXXXXXXXXXXXXXXXX
XXXXXXXXXXXXXXXXXXXXXXXXXXXXXXXXXXXXXXX-XXXXXXXXXXXXXXXXXXXXXXXXXXXXXXXXXXXXXXXXXXXXXXXXXXXXXXXXXXXXXXXXXXXXXXXXXXXXXXXXXXXXXXXXXXX-XXXXXXXXXXXXXXXXXXXXXXXXXXXXXXXXXXXXXXXXXXXX
