--------------------------------------------------------------------------------------------------------------------------------------------------------------------------------
--------------------------------------------------------------------------------------------------------------------------------------------------------------------------------
--------------------------------------------------------------------------------------------------------------------------------------------------------------------------------
--------------------------------------------------------------------------------------------------------------------------------------------------------------------------------
--------------------------------------------------------------------------------------------------------------------------------------------------------------------------------
--------------------------------------------------------------------------------------------------------------------------------------------------------------------------------
-------------------------------------S-S-----S------------------------USS--------------SSS------------------------------USS---------------S------------S------------------------
--------------------------------------------------------------------------------------------------------------------------------------------------------------------------------
------------B-----------------------------------------------------------------------#-----------------B-------------------------------------------------------------------------
------------b----------------------------------------------------------------------##-----------------b-------------------------------------------------------------------------
-----------S#CS----------------------S-S-----S------------------Q-----------------###--SSS-----------S#CS------------------------Q--------S-Q----------S------------------------
--------------------------------#----------B-----T-----------------T---B--B------####---K--#--B----------------------B---B--T-----------T------------------K--------------------
-------B------K-B-B-------------#----------b-----T-----B-----------T---b--b------####------#--b-B-------K---B------T-b---b--T-----------T-----------------------------------F---
-M-----b--------b-b-------------#----------b-----T-----b-----------T---B--B------####------#--b-b-----------b------T-B---B--T-----------T-----------------------------------#---
XXXXXXXXXXXXXXXXXXXXX-XXXXXXXXXXXXXXXXXXXXXXXXXXXXXXXXXXXXXXXXXXXXXXXXXXXXXXXXXXXXXXXXXXXXXXXXXXXXXXXXXXXXXXXXXXXXXXXXXXXXXXXXXXXXXXXXXXXXXXXXXXXXXXXXXXXXXXXXXXXXXX-XXXXXXXXXXX
XXXXXXXXXXXXXXXXXXXXX-XXXXXXXXXXXXXXXXXXXXXXXXXXXXXXXXXXXXXXXXXXXXXXXXXXXXXXXXXXXXXXXXXXXXXXXXXXXXXXXXXXXXXXXXXXXXXXXXXXXXXXXXXXXXXXXXXXXXXXXXXXXXXXXXXXXXXXXXXXXXXX-XXXXXXXXXXX
