---------------------------------------------------------------------------------------------------------------------------------------------------------------------
---------------------------------------------------------------------------------------------------------------------------------------------------------------------
---------------------------------------------------------------------------------------------------------------------------------------------------------------------
-------------------------------------------------------------------------------------------------------------------------o-------------------------------------------
------------o-------------------------------------------------------------------o-----------------------o----------------------o----------o------o-----------o-------
---------------------------------------------------------------------------------------------------------------------------------------------------------------------
----------S--%%%-------S-------------------------------------S-------------S-----%%%-------------SS------%--------------SSS-----%----------%%-----%-----------%------
--------------------------------------SSSS--------------------------SS-S------------------------------------S-----------------------S----------S---------------------
---------------------------------------------------------------------------------------------------------------------------------------------------------------------
---------------------------------------------------------------------------------------------------------------------------------------------------------------------
------%--------------------%%-%-SS-%-------%----%--S-S-%-%--%--%%--------%%------------------S-%---%--%-------------%--------%----------------------------%----------
----S------------------------------------------------------------------------S--------------------------------S-S---------------------SS-----------------------------
-------------------------------------------------------------------------------------------------------------------------------------------------------------------F-
-M-----------------------------------------------------------------------------------------------------------------------------------------------------------------X-
XXX-------------XXXXXX----------------------%%%%--------%--%------------------------XXXXXXX---------------X-------%%-%%%%--------XX----------X-----XXXXXX------XXXXXX
XXX-------------XXXXXX--------------------------------------------------------------XXXXXXX---------------X----------------------XX----------X-----XXXXXX------XXXXXX
