------------------------------------------------------------------------------------------------------------------------------------------------------
------------------------------------------------------------------------------------------------------------------------------------------------------
------------------------------------------------------------------------------------------------------------------------------------------------------
------------------------------------------------------------------------------------------------------------------------------------------------------
------------------------------------------------------------------------------------------------------------------------------------------------------
---------------R----------------------------------------------------------------------------oo--------------------------------------------------------
------------------------------####-----------------------------------------------------------------------#--------------------------------------------
--------------------%-%-------####--------------------------------------------------------%--------------#--------------------------------------------
---------%-------------------#####---S------%-----------------------------------------------------------##------------S-------------------------------
-----------------------------#####-------------------SSS------------------------------------------------##--------------------------------------------
----------------------------######-------%---------%------------------------------%----------SS--------###---------------------------------%----------
----------------------------######---------------------------------------------------------------------###--------------------------------------------
----------------------------######---------------------------------------------------------------------###-----------------------------------------F--
-M--------------------------######----r---%------------------------------------------------------------###-------------r---------------------------#--
XXX--XX----XXX----%-----XXXXXXXXXXX-XXXX------X--X-----------X-XX--XX-X-X--XXXXX-%----X-X--------X-XX-XXXXX--XXX--X-XXXXXXXX--X--XXX--XXX----XX--XXXXX
XXX--XX----XXX----------XXXXXXXXXXX-XXXX------X--X-----------X-XX--XX-X-X--XXXXX------X-X--------X-XX-XXXXX--XXX--X-XXXXXXXX--X--XXX--XXX----XX--XXXXX
