--------------------------------------------------------------------------------------------------------------------------------------------------------------------------------
--------------------------------------------------------------------------------------------------------------------------------------------------------------------------------
--------------------------------------------------------------------------------------------------------------------------------------------------------------------------------
--------------------------------------------------------------------------------------------------------------------------------------------------------------------------------
--------------------------------------------------------------------------------------------------------------------------------------------------------------------------------
--------------------------------------------------------------------------------------------------------------------------------------------------------------------------------
------------------------------S-------------S-S----------USS------------------------------------------------------------------------------S------------------------S------------
--------------------------------------------------------------------------------------------------------------------------------------------------------------------------------
------------------------------------------#---------------------------------------------------------------------------#----------B----------------------------------------------
-----------------------------------------##--------------------------------------------------------------------------##----------b----------------------------------------------
-------------Q----------------S---------###-S-S--------------Q---------------------------------------------------Q--###---------S#CS------S------------------------S------------
------T---K------K--------------K------####-------K-------B-----K---B------T-T-----------------------------T-#-----####-------B-----------------K---------------------B---------
------T------------B-------------------####---------------b---------b------T-T--------------T------B-------T-#-----####-------b----K------------------------B---------b-----F---
-M----T------------b-------------------####---------------B---------b------T-T--------------T------b--k----T-#-----####-------b-----------------------------b---------b-----#---
XXXXXXXXXXXXXXXXXXXXXXXXXXXXXXXXXXXXXXXXXXXXXXXXXXXXXXXXXXXXXXXXXXXXXXXXXXXXXXXXXXXXXXXXXXXXXXXXXXXXXXXXXXXXXXXXXXXXXXXXXXXXXXXXXXXXXXXXXXXXXXXXXXXXXXXXXXXXXXXXXXXXXXXXXXXXXXXX
XXXXXXXXXXXXXXXXXXXXXXXXXXXXXXXXXXXXXXXXXXXXXXXXXXXXXXXXXXXXXXXXXXXXXXXXXXXXXXXXXXXXXXXXXXXXXXXXXXXXXXXXXXXXXXXXXXXXXXXXXXXXXXXXXXXXXXXXXXXXXXXXXXXXXXXXXXXXXXXXXXXXXXXXXXXXXXXX
