------------------------------------------------------------------------------------------------------------------------------------------------------
------------------------------------------------------------------------------------------------------------------------------------------------------
------------------------------------------------------------------------------------------------------------------------------------------------------
------------------------------------------------------------------------------------------------------------------------------------------------------
------------------------------------------------------------------------------------------------------------------------------------------------------
-------------R--------------------R----------------------------R-------R------------------------oo-----%-----------oo---------------------------------
------------------------------------------------------------------------------------------------------------------------------------------------------
------%-----------------------------------------------------------------------------------------------------------------------------------------------
--------------------------S----------------------------------------------------------------------------------%------------------S---------------------
--------S-----------------------S-------S----------------------------S--------------------------------%------------------------------S----------------
------------------------------%--------------------------%-%------%-------------------%----------SS-%---------------SS--%---------------%-------------
------------------------------------------------------------------------------------------------------------------------------------------------------
---------------------------------------------------------------------------------------------o-----------------------------------------------------F--
-M-------------------------r-------------------%-----------------o-%-----------------o------%%%------%--------------------%------r---------%-------#--
XXXX------------XX-X-XX--XXXX--------X-----XXX------X--X-----X---%-------X----X--X---%--XX---|-----------X-X----------------XX-XXXX-----------XXXXXXXX
XXXX------------XX-X-XX--XXXX--------X-----XXX------X--X-----X-----------X----X--X------XX---|-----------X-X----------------XX-XXXX-----------XXXXXXXX
