------------------------------------------------------------------------------------------------------------------------------------------------------------------------------------------------------------------------------
------------------------------------------------------------------------------------------------------------------------------------------------------------------------------------------------------------------------------
------------------------------------------------------------------------------------------------------------------------------------------------------------------------------------------------------------------------------
------------------------------------------------------------------------------------------------------------------------------------------------------------------------------------------------------------------------------
------------------------------------------------------------------------------------------------------------------------------------------------------------------------------------------------------------------------------
------------------------------------------------------------------------------------------------------------------------------------------------------------------------------------------------------------------------------
------------------------------------------------------------------------------------------------------------------------------------------------------------------------------------------------------------------------------
----------------o--------------------------o--------------------------oo----o------------o-------------------------------o----------------------------o-----------------------------------------------------------------------
------------------------------------------------------------------------------------------------------------------------------------------------------------------------------------------------------------------------------
------------------------------------------------------------------------------------------------------------------------------------------------------------------------------------------------------------------------------
------------------Q--------------T------Q-------------------o-------------------------------------------------------------------C-Q-------------------------Q--------------T---------T-----T---Q-------Q----------------------
---------------------------------T-------------#-------------------#-------------------------------------------------------------------------------------------#-----------T---------T-----T----------------------------------
---T-----------------------------T-------------#-------------------#------------------------------------T------------------------------------------------------#-----------T---------T-----T------------------------------F---
-M-T---------y-------------------T-------------#-------------------#------------------------------------T-----y----------------------------y-------------------#----y------T---------T-----T------------------------------#---
XXXXXXXX-XXXXXXXXXXXXXXXX-XXXXXXXXX-XXXXXXXXXXXXXXXXXXXXXXXXXXXX-XXXXXXXX--XXXXX-XXXXXX-XXXXXXXXXXX-XXXXXXXXXXXXXXXXXX-XXXX-XXXXXXXX--X-XXXXXXXXXXXXXXXXXXXXXXXXXXXXXXXX-XXXXXXXXXX-XXXXXXXXXXXXXXXXXXXXXXXXXXXXXXXXX-XXXXXXXX
XXXXXXXX-XXXXXXXXXXXXXXXX-XXXXXXXXX-XXXXXXXXXXXXXXXXXXXXXXXXXXXX-XXXXXXXX--XXXXX-XXXXXX-XXXXXXXXXXX-XXXXXXXXXXXXXXXXXX-XXXX-XXXXXXXX--X-XXXXXXXXXXXXXXXXXXXXXXXXXXXXXXXX-XXXXXXXXXX-XXXXXXXXXXXXXXXXXXXXXXXXXXXXXXXXX-XXXXXXXX
