----------------------------------------------------------------------------------------------------------------------------------------------------------------------------------------------------------------------
----------------------------------------------------------------------------------------------------------------------------------------------------------------------------------------------------------------------
----------------------------------------------------------------------------------------------------------------------------------------------------------------------------------------------------------------------
----------------------------------------------------------------------------------------------------------------------------------------------------------------------------------------------------------------------
----------------------------------------------------------------------------------------------------------------------------------------------------------------------------------------------------------------------
----------------------------------------------------------------------------------------------------------------------------------------------------------------------------------------------------------------------
-----S------------------------------------------------------S------SS-S--------------------------S------S------------------------------------US-------S---------USS------------------S------------------S--S----------
-------------------------------------------------------------------------------------------T--------------------------------------------------------------------------------------------------------------------------
--------------------------------------------------------------------------------------T----T-------------------------------------------T---------TT---------------------T-----------------T---------------------------
--------------------------------------------------------------------------------------T----T-------------------------------------------T----S----TT------------S--------T-----------------T---------------------------
-T--------------------S----------t---S----------T----T---T------T---------------------X---SX-----S--S---S-T----T---S--#-----------S-T--X---------XX-T-------------------T-S---S-----------T---------------------------
-T---------T-----T---------T-----t--------------T-T-TT---T------T-------------T---------------T-----------T----T-T----#--T----------T---------------T-------------------T-----------------T---------------------------
-T---------T----TT------t--T---T-t-----T-T-T----T-T-TT---T----T-T----------T--T--T------------T-----------T----T-T----##-T--#---T---T-----T---------T----T-T------------T--------------T--T-T---------T------TT----F--
-T-M-------T----TT------t--T---T-t-----T-T-T----T-T-TT---T----T-T----------T--T--T------------T-----------T-k--T-T----##-T-##---T---T-----T---------T----T-T------------T--------------T--T-T---------T------TT----#--
XXXXXXXXXXXXXXXXXXXXXXXXXXXXXXXXXXXXXXXXXXXXXXXXXXXXXXXXXXXXXXXXXXXXXXXXXXXXXXXXXXXXXXXXXXXXXXXXXXXXXXXXXXXXXXXXXXXXXXXXXXXXXX-XXXXXXXXXXXXXXX-XXXXXXXXXXXXXXXXXX--XXXXXXXXXXXXXXXXXXXXXXXXXXXXXXXXXXXXXXXXXXXXXXXXXXX
XXXXXXXXXXXXXXXXXXXXXXXXXXXXXXXXXXXXXXXXXXXXXXXXXXXXXXXXXXXXXXXXXXXXXXXXXXXXXXXXXXXXXXXXXXXXXXXXXXXXXXXXXXXXXXXXXXXXXXXXXXXXXX-XXXXXXXXXXXXXXX-XXXXXXXXXXXXXXXXXX--XXXXXXXXXXXXXXXXXXXXXXXXXXXXXXXXXXXXXXXXXXXXXXXXXXX
