--------------------------------------------------------------------------------------------------------------------------------------------------------------
--------------------------------------------------------------------------------------------------------------------------------------------------------------
--------------------------------------------------------------------------------------------------------------------------------------------------------------
S----SSLSSLSSSSLSSSSLSSSSLSSSSSSSSSSSSSSSSSSSSSSSSSSSSSLSSSSSLSSSSSSSSSSSSSSSSSSSSSSSSSSSSSSSSSSSSSSSSSSSSSSSSSSSSSSSSSSSSSSSSSSSSSLSSSSSSSSSSSSSSSSLSSS------
S---------------------------------------------------------------------SS-SS-SSS-------------------------SS-------------------SS-------------------------------
S---------------------------------------------------------------------SS-SS-SSS-------------------------SS-------------------SS-------------------------------
S-----oo-oo-oooo--ooo---oo----------------------------oo----oo--------------------------------------------------------------------oo---------------oo---------
S-------------------------------------------------------------------------------------------------------------------------------------------------------------
S-----SS-SS-SSSS--SSS---SS----------------------------SS----SS--------------------------------------------------------------------SS---------------SS---------
S-----SS-SS-SSSS--SSS---SS---C------------------------SS----SS--------oU-oU-ooU-------------------------oU-------------------oU---SS---------------SS---------
S---------------------#--------------#-----------------------------#--SS-SS-SSS-------------#-------#---SS-------------------SS------------------------#------
S---------------------#--------#-----#-----------------------------#-------------------T----#-------#-----------------------------------T--------------#------
S---------------------#----#---#---g-#--------T--T-------T---------#-------------------T--g-#-----T-#---------#-------------------------T--------------#------
S--M------------------#----#-E-#-g-#-#--------T--T-------T---------#-------------------T--#-#-----T-#---------#-------------------------T--------------#----F-
XXXXXXXXXXXXXXXXXXXXXXXXXXXXXXXXXXXXXXXXXXXXXXXXXXXXXXXXXXXXXXXXXXXXXXXXXXXXXXXXXX-XXXXXXXXXXX-XXXXXXXXXXXXXXXXXXXXXXXXX--XXXXXX-XXXX-XXXX-XXXXXXXXXXXXX-XXXXX
XXXXXXXXXXXXXXXXXXXXXXXXXXXXXXXXXXXXXXXXXXXXXXXXXXXXXXXXXXXXXXXXXXXXXXXXXXXXXXXXXX-XXXXXXXXXXX-XXXXXXXXXXXXXXXXXXXXXXXXX--XXXXXX-XXXX-XXXX-XXXXXXXXXXXXX-XXXXX
