------------------------------------------------------------------------------------------------------------------------------------------------------------------------------------------------------
------------------------------------------------------------------------------------------------------------------------------------------------------------------------------------------------------
------------------------------------------------------------------------------------------------------------------------------------------------------------------------------------------------------
------------------------------------------------------------------------------------------------------------------------------------------------------------------------------------------------------
------------------------------------------------------------------------------------------------------------------------------------------------------------------------------------------------------
------------------------------------------------------------------------------------------------------------------------------------------------------------------------------------------------------
------------------------------------------------------------------------------------------------------------------------------------------------------------------------------------------------------
------------------------------------------------------------------------------------------------------------------------------------------------------------------------------------------------------
-----------------------------------------------T---------------------------T--------------------------------------------------------------------------------------------------------------------------
-----------------------------------------------T---------------------------T--------------------#-------------------------------------------------------------#---------------------------------------
-----------------------------------------------#---------------------------#-------------------##------------------------------------------------------------##---------------------------------------
-------------------K---------------------------------------------------------------------------##------------------------------------------------------------##---------------------------------------
-----T---------*------------------------------------------------------------------------------K##--------------*--------------------------------------------K##-----------------------------------F---
-M---T---------*-----------------g----k------K-------g-------------------g------------gg-g--k--##--------------*-k--gggg-----g-----k------------------gg-----##------------------g--K-----g-g-g---#---
XXXXXXXXXXXXXXXXXXXXXXXXXXXXXXXXXXX-XXXXXXXXXXXXXXXXXXXX-XXXXXXXXXXXXXXXXXXXXX-XXXXXXXXXXXXXXXXXXXXXXXXXXXXXXXXXXXXXXXXXXXXXXXXXXXXXXXXXXXX--XXXXXXXXXXXXXXXXXXX-XX-XXXX-XXXXX-XXXXXXXXXXXXXXXXXXXXXXX
XXXXXXXXXXXXXXXXXXXXXXXXXXXXXXXXXXX-XXXXXXXXXXXXXXXXXXXX-XXXXXXXXXXXXXXXXXXXXX-XXXXXXXXXXXXXXXXXXXXXXXXXXXXXXXXXXXXXXXXXXXXXXXXXXXXXXXXXXXX--XXXXXXXXXXXXXXXXXXX-XX-XXXX-XXXXX-XXXXXXXXXXXXXXXXXXXXXXX
