----------------------------------------------------------------------------------------------------------------------------------------------------------------------------------------------------------
----------------------------------------------------------------------------------------------------------------------------------------------------------------------------------------------------------
----------------------------------------------------------------------------------------------------------------------------------------------------------------------------------------------------------
----------------------------------------------------------------------------------------------------------------------------------------------------------------------------------------------------------
----------------------------------------------------------------------------------------------------------------------------------------------------------------------------------------------------------
----------------------------------------------------------------------------------------------------------------------------------------------------------------------------------------------------------
----------------S-------S----------S-----------------------------------------------------------------------S------S---------@----S--S-----------------S-------S-----------------S-------S---S-------------
----------------------------------------------------------------------------------------------------------------------------------------------------------------------------------------------------------
----------------------------------------------------------------------------------------------------------------------------------------------------------------------------------------------------------
-----------------------------------------------------------------------------------------------------1----------------------------------1-----------------------------------------------------------------
------------#--------------#------------S---------------------------------t-----#-S----------S----------!------#------------!---------#----------#--------------------------------t-!-t-----------!-------
------------#--------------#----------------------------------------------t-----#------------------------------#----------------------#----------##-------------------------------t---t-------------------
----------t-#-------t------#---------------------------------t------------t---t-#------------------------------#----t-----------------#----------###------------------------------t---t---------------F-t-
-g-M------t-#-------t--g---#-----------------------g-------#-t------------t---t-#------------------------------#----t----------g--g---#----------####------g-g-gg-g----g---#---g--t---t--------#------#-t-
XXXXXXXX-XXXXXXXXXXXXXXXXXXXXX-XXXXXXXXXXXXXXXXXXXXXXX-XXXXXXXX-XX-XXXXXXXXXXXXXXXXXXXXXXXXXXXXXXXXXXXXXXXXXXXXXXXXXXXXXXXXXXXXXXXXXXXXXXXXXXXXXXXXXXXXXX-XXXXXXXXXXXXXXX-XXXXXXXXXXXXXXXXXXXXXXXXXXXXXXXX
XXXXXXXX-XXXXXXXXXXXXXXXXXXXXX-XXXXXXXXXXXXXXXXXXXXXXX-XXXXXXXX-XX-XXXXXXXXXXXXXXXXXXXXXXXXXXXXXXXXXXXXXXXXXXXXXXXXXXXXXXXXXXXXXXXXXXXXXXXXXXXXXXXXXXXXXX-XXXXXXXXXXXXXXX-XXXXXXXXXXXXXXXXXXXXXXXXXXXXXXXX
