------------------------------------------------------------------------------------------------------------------------------------------------------------------------------------------------------------------------------
------------------------------------------------------------------------------------------------------------------------------------------------------------------------------------------------------------------------------
------------------------------------------------------------------------------------------------------------------------------------------------------------------------------------------------------------------------------
------------------------------------------------------------------------------------------------------------------------------------------------------------------------------------------------------------------------------
------------------------------------------------------------------------------------------------------------------------------------------------------------------------------------------------------------------------------
------------------------------------------------------------------------------------------------------------------------------------------------------------------------------------------------------------------------------
--------------------------Q---------------------------------------------------------------------------------------------------------------------------------------------------------------------------------------------------
-----------o--------------------------------------------o--------------------------------------------------o-------------------------------oo-----------ooo------------------------------o------------------------------------
------------------------------------------------------------------------------------------------------------------------------------------------------------------------------------------------------------------------------
------------------------------------------------------------------------------------------------------------------------------------------------------------------------------------------------------------------------------
---------------Q---o------Q-----------------------------------------------------------------Q------TT-----------------------o----------o-------Q--------------------------Q-------------------------------------------T-------
-------------------------------------------------#-----------#------------------TT-----------------TT----#--------------------------------------------#-------------#----------T-----------------------#--------------T-------
-------------------------------------------------#-----------#------------------TT-----------------TT----#--------------------------------------------#-------------#----------T-----------------------#--------------T---F-T-
-M----------------------y--------------y----y----#-----------#------------------TT-----------------TT----#--------------------------------------------#---------y---#----------T------y----------------#--------------T---#-T-
XXXXXXX-XXXXXXXXXXXXXXXXXXXXXXXXXXXX-XXXXXXXXXX-XXXXXXXXXXXXXXXXXXXX--XXX-XXXXXXXXXXXXXXXXXXXXX-XXXXXXXXXXXXXX-X-XXX-X-XXXXXXXXXXXXXXXXXXXXXXXXXXXXXXXXXXXXXXXXXXXXXXXXXXXXXXXXXXXXXXXXXXXXXXXXXXXXXXXXX-XXXX-XXXXXXXXXXXXXXXX
XXXXXXX-XXXXXXXXXXXXXXXXXXXXXXXXXXXX-XXXXXXXXXX-XXXXXXXXXXXXXXXXXXXX--XXX-XXXXXXXXXXXXXXXXXXXXX-XXXXXXXXXXXXXX-X-XXX-X-XXXXXXXXXXXXXXXXXXXXXXXXXXXXXXXXXXXXXXXXXXXXXXXXXXXXXXXXXXXXXXXXXXXXXXXXXXXXXXXXX-XXXX-XXXXXXXXXXXXXXXX
