----------------------------------------------------------------------------------------------------------------------------------------------------------------------------------------------------------------------
----------------------------------------------------------------------------------------------------------------------------------------------------------------------------------------------------------------------
----------------------------------------------------------------------------------------------------------------------------------------------------------------------------------------------------------------------
----------------------------------------------------------------------------------------------------------------------------------------------------------------------------------------------------------------------
----------------------------------------------------------------------------------------------------------------------------------------------------------------------------------------------------------------------
------------------------------------------------------------------------------------------------------------------------------------------------------------------------g---------------------------------------------
-S-----S-------------S-----------------------------US-------S----------S------SSS--------------------------------------S---------------------------------S-------S--S---SS---S------------------------S--------S------
------------------------------------------------------------------------------------------------------------T-------T-----------------------------------------------------------------------------------TT------------
-----------------T--------------------------T----------------------------------------------T----------------T-------T-----------T----------------T------------------------------------------------------TT------------
-----------------T--------------------------T---T-S----------------------T-----------------T----------------X-------X-----------T----------------T------------------------------------------------------TT------------
-------S-T-S-----T-----S--T-----SS-T-T------T-S-T--------------T-------S-T-SS--------------X--------S------------------S-----t--X----t-----------T-t--------T-------S--------------S-#---T--------------XX------------
---------T-------T--------T--------T-T------T---T--------------T-----T---T----------------------------------------T----------t-------t---TT------T-t-K------T--------------------T---#---T----------------------------
---------T-------T--------T--------T-T---TT-T---T--------------T-----T---T----T----------#---TT---------T---------T-------T--t-------t--TTT------T-t-----TT-T-T-------T-TTTT-TTT-T---##--T--T-T------------T-T---T-F--
---M-----T-------T--------T--------T-T---TT-T---T--------k-----T-----T---T----T-----k---##---TT---------T-k-------T-------T--t-------t--TTT------T-t-----TT-T-T-------T-TTTT-TTT-T---##--T--T-T---------k--T-T---T-#--
XXXXXXXXXXXXXXXXXXXXXXXXXXXXXXXXXXXXXXXXXXXXXXXXXXXX-XX-XXXXXXXXXXXXXXXXXXXXXXXXXXXXXXXXXXXXXXXXXXXXXXXXXXXXXXXXXXXXXXXXXXXXXXXXXXXXXXXXXXXXXXXXXXXXXXXXXXXXXXXXXXXXXXXXXXXXXXXXXXXXXXXXXXXXXXXXXXXXXXXXXXXXXXXXXXXXXX
XXXXXXXXXXXXXXXXXXXXXXXXXXXXXXXXXXXXXXXXXXXXXXXXXXXX-XX-XXXXXXXXXXXXXXXXXXXXXXXXXXXXXXXXXXXXXXXXXXXXXXXXXXXXXXXXXXXXXXXXXXXXXXXXXXXXXXXXXXXXXXXXXXXXXXXXXXXXXXXXXXXXXXXXXXXXXXXXXXXXXXXXXXXXXXXXXXXXXXXXXXXXXXXXXXXXXX
