----------------------------------------------------------------------------------------------------------------------------------------------------------------------------------------
----------------------------------------------------------------------------------------------------------------------------------------------------------------------------------------
----------------------------------------------------------------------------------------------------------------------------------------------------------------------------------------
----------------------------------------------------------------------------------------------------------------------------------------------------------------------------------------
----------------------------------------------------------------------------------------------------------------------------------------------------------------------------------------
----------------------------------------------------------------------------------------------------------------------------------------------------------------------------------------
------------------------------------------------------------------------------------------US------------------------------------##--------y---------------------------------------------
--------------------y-----------------------------------------------------------------------------------------------------------##------#SSS--------------------------------------------
------------------#SS--o---------------oo----------------------------------y----------------------------------------------------##-----##-----------------------------------------------
-----------------##--------------------------------------------------------XS---------------------------------o-----------------##----###1------------------------------------o---------
-----------------##--SC--------------------------------------------#------XX-------------####---------Q-------------------------##----###-------SC-----------Q--------#-----------------
-----------------##---------#-------------------------T----------y##-----XXX-------y-######-------------------------------------##----###--SSS-----------------------##-----------------
-----------------##---SSS--##-------------------------T----------###----XXXX-------######---------------------------------------##----###---------------------------###-------------F---
----M-------y----##-----------------------------------T---------####---XXXXX------####-------------------------------y----------##----###-----------------------y--####-------------#---
XXXXXX--XXXXXXXXXXX------XXXXX-XXX--XX--XXXXXXX-XXX--XXXXXXXXX-XXXXX--XXXXXX--XX-XXX-------XX-XXXXX-XXXX-XXXXXXXXXXXXXXXXXXXXXX-XXXX-XXXXXXX----XXX-XX-XXX--XXXXXXXXXXX-XXXXXXXXXX-XXX-X
XXXXXX--XXXXXXXXXXX------XXXXX-XXX--XX--XXXXXXX-XXX--XXXXXXXXX-XXXXX--XXXXXX--XX-XXX-------XX-XXXXX-XXXX-XXXXXXXXXXXXXXXXXXXXXX-XXXX-XXXXXXX----XXX-XX-XXX--XXXXXXXXXXX-XXXXXXXXXX-XXX-X
