-------------------------------------------------------------------------------------------------------------------------------------------------------------------------------------------------------------------------------------------------------------------------------------------------------------------------------------------------------------------------------------
-------------------------------------------------------------------------------------------------------------------------------------------------------------------------------------------------------------------------------------------------------------------------------------------------------------------------------------------------------------------------------------
-------------------------------------------------------------------------------------------------------------------------------------------------------------------------------------------------------------------------------------------------------------------------------------------------------------------------------------------------------------------------------------
-------------------------------------------------------------------------------------------------------------------------------------------------------------------------------------------------------------------------------------------------------------------------------------------------------------------------------------------------------------------------------------
-------------------------------------------------------------------------------------------------------------------------------------------------------------------------------------------------------------------------------------------------------------------------------------------------------------------------------------------------------------------------------------
-------------------------------------------------------------------------------------------------------------------------------------------------------------------------------------------------------------------------------------------------------------------------------------------------------------------------------------------------------------------------------------
--------------------------------------------------------------------------------------------------------------------------------------------------------------------------------------------------------------------------------------------------------------------------------------------------------#----------------------------------------------------------------------------
--------------------------------------------------------------------------------------------------------------------------------------------------------------------------------------------------------------------------------------------------------------------------------------------------------#----------------------------------------------------------------------------
-----------------------------------------------------------------------------------------------------------------------------------------------------------------------------------------#--------------------------------------------------------------------------------------------------------------#----------------------------------------------------------------------------
----------------------------------------S-------------------------------------------------------S-----------------S------------o---------------------1-----------------------------------#---------------S------------------------------------oo---------------------------------------t----------o-----#-------------------------------S---------------------------------o----------
-----------------------------------------------------------------------T---------------------T----#---------------------------------------------------------------T-------T-------#------#--------------------------------------------------------T------T-----------------------------t-------------T--#-----------T----#-----------------------------------------------------------
------------------------------------------K-------------------T--------T---------------------T----#-T-------------------K-----------------------------------------T-------T-------#------#--------------------------------------------------------T------T-----------------------------t-------------T--#---------T-T----#--------------------------K-------------T-----T------------
------------#-----#------------#------------------------------T------K-T---#-----------------T----#-T-t--------------------T--------------------------------------T-------T-------#------#-t-----------------T------------------------#-----------T------T-----------------------------t-------------T--#---------T-T-#--#------T---------------------------------T-----T--------F---
-M----------#-----#------------#--g---------------------g-----T--g-----T---#-------k---------T----#-T-t-------g-----kkk----T-k--------------g-k-------k------g----T----k--T-g-k---#-k----#-t-------k-g-------T---k-g-------g----------#-----k-k---T----k-T-------------------k--gg-----t----gg-------T--#---------T-T-#--#--g-k-T------------------------k--------T-----T--------#---
XXXX-XXXXXXXXXX---XX-XXXXX-XX--XXXXXXXXXXX-XXXX-XXXXXXXXXXXX--XXXXXX-X-XX-XXXXXX-XXXXXXXXXXXXXXXXXXXXXXX-XXXXXXXXXXXXXXX-XXXXXXXXX-XXXXXXXXXXXXXXXXXXXXXXXXXXXXXXXXXXXXXXXXXXXXXXXXXXXXX-XXXXX-XXXXXXXXXXXXXXXXXXXXXXXXXXXXXXXXXXXXXXXXXX-XXXXXXXXXXXXXXXXXXXXXXXX-XXX-XXXXXXXXXXXXX---XXXXXXXXXXXXXXXX-XXXXXXXXXXXXXXX-XXXXXXXXXXXXXXXXXXXX---XXXXX-XXXXXXXXXXXXXXXXXXXXXXXXXXXXXXXX
XXXX-XXXXXXXXXX---XX-XXXXX-XX--XXXXXXXXXXX-XXXX-XXXXXXXXXXXX--XXXXXX-X-XX-XXXXXX-XXXXXXXXXXXXXXXXXXXXXXX-XXXXXXXXXXXXXXX-XXXXXXXXX-XXXXXXXXXXXXXXXXXXXXXXXXXXXXXXXXXXXXXXXXXXXXXXXXXXXXX-XXXXX-XXXXXXXXXXXXXXXXXXXXXXXXXXXXXXXXXXXXXXXXXX-XXXXXXXXXXXXXXXXXXXXXXXX-XXX-XXXXXXXXXXXXX---XXXXXXXXXXXXXXXX-XXXXXXXXXXXXXXX-XXXXXXXXXXXXXXXXXXXX---XXXXX-XXXXXXXXXXXXXXXXXXXXXXXXXXXXXXXX
