------------------------------------------------------------------------------------------------------------------------------------------------------------------------------------------------------------------------------
------------------------------------------------------------------------------------------------------------------------------------------------------------------------------------------------------------------------------
------------------------------------------------------------------------------------------------------------------------------------------------------------------------------------------------------------------------------
------------------------------------------------------------------------------------------------------------------------------------------------------------------------------------------------------------------------------
------------------------------------------------------------------------------------------------------------------------------------------------------------------------------------------------------------------------------
------------------------------------------------------------------------------------------------------------------------------------------------------------------------------------------------------------------------------
------Q---------------------------------------------------------Q----------------Q------------------------Q-------------------------------------------------------------------------------Q----------------Q------------------
------------------o-----------o---------------------o--------------------------------------------------o--------------------------------------o---------------------o-o---------------------------o---------------------------
------------------------------------------------------------------------------------------------------------------------------------------------------------------------------------------------------------------------------
------------------------------------------------------------------------------------------------------------------------------------------------------------------------------------------------------------------------------
------Q-------------------------o--T---T---Q-----Q-----------Q--?----------------?------------------Q-----?------------------o-----------------------------Q----Q-------------------------Q----------------?--T--Q------------
-----------------------------------T---T----------------------------------------------------------------------#--------------------------T--------------------------------------------------------------------T---------------
----------------------------T------T---T----------------------------------------------------------------------#--------------------------T------------------------------T---T---------------------------------T-----------F---
-M--------------------------T------T---T------------------------------------y----------y----------------------#-----------y-----------y--T----------y-------------------T---T-y----------------------y--------T-----------#---
XXXXXXXXXXX--XXXXXXXXXXXX-XXXXXXXXXXXXXXXXXXXXX-XXXXXXXXXXXXXXXXXXXXXXXXXXXXXXXXXXXXXXXXXXXXX-XXXXXXXXXXXXXXXXXXXXX-XX-XXXXXXXXXXX-XXXXXXXXXXXXXXXXXXXXXXXXXXXXXXXXXXXXXXXXXXXXX-X-XXXX-XXXXXXXXXXXXXXX-XXXXXXXXXXXXX-XXXXXXXX
XXXXXXXXXXX--XXXXXXXXXXXX-XXXXXXXXXXXXXXXXXXXXX-XXXXXXXXXXXXXXXXXXXXXXXXXXXXXXXXXXXXXXXXXXXXX-XXXXXXXXXXXXXXXXXXXXX-XX-XXXXXXXXXXX-XXXXXXXXXXXXXXXXXXXXXXXXXXXXXXXXXXXXXXXXXXXXX-X-XXXX-XXXXXXXXXXXXXXX-XXXXXXXXXXXXX-XXXXXXXX
