------------------------------------------------------------------------------------------------------------------------------------------------------------------------------------------------------------------------------
------------------------------------------------------------------------------------------------------------------------------------------------------------------------------------------------------------------------------
------------------------------------------------------------------------------------------------------------------------------------------------------------------------------------------------------------------------------
------------------------------------------------------------------------------------------------------------------------------------------------------------------------------------------------------------------------------
------------------------------------------------------------------------------------------------------------------------------------------------------------------------------------------------------------------------------
------------------------------------------------------------------------------------------------y-----------------------------------------------------------------------------------------------------------------------------
-------------------------------------Q-----------Q-------------------------------------Q--------##---------------------------------------------------------------------------------------------------Q------------------------
-----------------------------------------------o--------o-o-----------------------------------y###-----------o-----------------------------------------------o-----------oo----------------o------------------o---------------
----------------------------------------------------------------------------------------------####----------------------------------------------------------------------------------------------------------------------------
---------------------------------------------------------------------------------------------#####----------------------------------------------------------------------------------------------------------------------------
-------------------------------------?--Q--------Q-------------TT---------o------------?----######-------------C----T---------------T-----------C----------------T--T-----------Q--------------------Q------------------------
------------------------------------------#---------T----------TT-----------#--------------#######------------------T------#--------T----------------------------T--T-T-----------------------T-------------------------------
------------------------------------------#---------T----------TT-----------#--------------#######------------------T------#--------T----------------------------T--T-T-----------------------T---------------------------F-T-
-M--------------------------------y-------#---------T----------TT-y---------#--------------#######------------------T------#--------T-----y----------------------T--T-T-----------------------T---------y---y-------------#-T-
XXXXXXXXXXXXXXX-XXXXXX--XXXXXXXXXXXXXXXXXXXXXXXXXXXXXXXXXXXXXXXXXXXXXXXXXXXXX-XXXXXXXXXXXXXXXXXXXXXXXX-XXXXXXXXXXXXXXXXXXXXXXXXXX-XXXXXXXXXXXXXXXXXXXXXXXXXXXXXXXXXXXXXXXXXXXXXXXXXXXXXXXXXXXXXXXX-XXXXXXXXXXXXXXXX--X-XXXXXXX
XXXXXXXXXXXXXXX-XXXXXX--XXXXXXXXXXXXXXXXXXXXXXXXXXXXXXXXXXXXXXXXXXXXXXXXXXXXX-XXXXXXXXXXXXXXXXXXXXXXXX-XXXXXXXXXXXXXXXXXXXXXXXXXX-XXXXXXXXXXXXXXXXXXXXXXXXXXXXXXXXXXXXXXXXXXXXXXXXXXXXXXXXXXXXXXXX-XXXXXXXXXXXXXXXX--X-XXXXXXX
