----------------------------------------------------------------------------------------------------------------------------------------------------------------------------------------------------
----------------------------------------------------------------------------------------------------------------------------------------------------------------------------------------------------
----------------------------------------------------------------------------------------------------------------------------------------------------------------------------------------------------
----------------------------------------------------------------------------------------------------------------------------------------------------------------------------------------------------
----------------------------------------------------------------------------------------------------------------------------------------------------------------------------------------------------
-----------------------------------------------k---------------k-------------------k---------------------k------------------------------------------------------------------------------------------
----------------------------------------------##---S--S-------##------------------##--------------------##--S------------------------SC---------------------------------------S---------------------
---------------------------------------------###-------------###-----------------###-------------------###------------------------------------------------------------------------------------------
--------------------------------------------####------------####----------------####------------------####------------------------------------------------------------------------------------------
--------------------------?-----------------####------------####----------------####------------------####---------------------------SS-------------------------------------------------------------
----------------S---------------Q-S---------####---S--S-----####-T-------T-S----####-----S------------####--S-----------S----------#---------------T---------------------Q----S-S-------------------
--------------------------------------T----#####-----------#####-T-------T-----#####---------T-------#####--------------------T----#-----------T---T--------T----------T------------T---------------
--------------------------------------T----#####----------######-T-------T-----#####---------T-------#####--------------------T----#-----------T---T--------T-T--T-----T------------T------------F--
-M-g--------k----------k--------------T----#####---------#######-T-g---k-T---g-#####---------T---g---#####--------g-----------T----#-----------T---T---g----T-T--T-----T------------T----------g-#--
XXXXXXXXXXXXXXXXXXXXXXXXXXXXXXXXXXXXXXXXXXXXXXXXXXXXXXXXXXXXXXXXXXXXXXXXXXXXXXXXXXXXXX-XXXXXXXXXXXXXXXXXXXXXXXXX-XXXXX-XXXX-XXXXXX-X---X-XXXXXXXXXXXXXXXXXXXXXXXXXXXXXXXXXXXXXXXXXXXXXXXXXXXXXXXXXXX
XXXXXXXXXXXXXXXXXXXXXXXXXXXXXXXXXXXXXXXXXXXXXXXXXXXXXXXXXXXXXXXXXXXXXXXXXXXXXXXXXXXXXX-XXXXXXXXXXXXXXXXXXXXXXXXX-XXXXX-XXXX-XXXXXX-X---X-XXXXXXXXXXXXXXXXXXXXXXXXXXXXXXXXXXXXXXXXXXXXXXXXXXXXXXXXXXX
