-----------------------------------------------------------------------------------------------------------------------------------------------------------------------------------------------------
-----------------------------------------------------------------------------------------------------------------------------------------------------------------------------------------------------
-----------------------------------------------------------------------------------------------------------------------------------------------------------------------------------------------------
-----------------------------------------------------------------------------------------------------------------------------------------------------------------------------------------------------
-------------------------------------------------------------------------------------------------------------------------------------------------------------------------------X---------------------
-------------------------------------------------------------------------------------------------------------------------------------------------------------------------------X---------------------
----S-----------S--------------S-----------------------------------------SS----------S-------SS-?----------------QQ----S----QQ------QQ------------------------------S-?--------X---------------------
-------------------------------------------------------------------------------------------------------------------------------------------------------------------------------X---------------------
--------------------------------------------------------------------------------------------------------------------------------------------g----------------------------g-----X---------------------
--------------------------------------------------------------------------------------------------------------------------------------------#--T-------------------------#-----X---------------------
---------------------------------T-------------------T--------T---------------C-----------T---------------C------?Q---------?Q------?Q-----##--T-----------T------------##-----X---------------------
---------------------------------T--------g----------T--------T---------------------------T--------------------------------------------T---##--T-----------T------------##-----X-----#---------------
---------------------------------T--------TT---------T--------T---------------------------T-----------------K--------------------------T---##--T---K-------T----#-------##-----X-----#-----------F---
--M-----------------------g------T--------TT---------T--------T---g----------gg---------g-T----K---------gg----------------------------T---##--T-------g---T---##-k--K--##-----X-----#-----------X---
XXXXXXXXXXXXXXXXXXXXXXXXXXXXXXXXXXXXXXXX-XXXXXXXX-XXXXXXXXXXXXXXXXXX-XXXXXXXXXXXXXXXXXXXXXXXXXXXXXX-X-XXXXXXXXX-XXXXXXXXX-XXXXXXXXXXXXXXXXXXXXXXX-XXXXXXXXXXXXXXXXXXXXXXXXXXXXXXXXXX-XXXXXXXXXXXXXXXX
XXXXXXXXXXXXXXXXXXXXXXXXXXXXXXXXXXXXXXXX-XXXXXXXX-XXXXXXXXXXXXXXXXXX-XXXXXXXXXXXXXXXXXXXXXXXXXXXXXX-X-XXXXXXXXX-XXXXXXXXX-XXXXXXXXXXXXXXXXXXXXXXX-XXXXXXXXXXXXXXXXXXXXXXXXXXXXXXXXXX-XXXXXXXXXXXXXXXX
