-------------------------------------------------------------------------------------------------------------------------------------------------------------------------------------------------------------------------------------------------------------------------------------------------------------------------------------------------------------------------------------
-------------------------------------------------------------------------------------------------------------------------------------------------------------------------------------------------------------------------------------------------------------------------------------------------------------------------------------------------------------------------------------
-------------------------------------------------------------------------------------------------------------------------------------------------------------------------------------------------------------------------------------------------------------------------------------------------------------------------------------------------------------------------------------
-------------------------------------------------------------------------------------------------------------------------------------------------------------------------------------------------------------------------------------------------------------------------------------------------------------------------------------------------------------------------------------
-------------------------------------------------------------------------------------------------------------------------------------------------------------------------------------------------------------------------------------------------------------------------------------------------------------------------------------------------------------------------------------
-------------------------------------------------------------------------------------------o---------------------------------------------------------------------------------------------------------------------------------------------------------------------------------------------------------------------------------------------------------------------o-------------------
----------------------------------------------------------------------------------------------------------------------------------------------------------------------------------------------------------------------------------------------------------------------------------------------##-------------------------------------------------------------------------------------
----------------------------------------------------------------------------------------------------------------------------------------------------------------------------------------------------------------------------------------------------------------------------------------------##-------------------------------------------------------------------------------------
----------------------------------------------------------------------------------------------------------------------------------------------------------------------------------------------------------------------------------------------------------------------------------------------##-----------------------------#-------------------------------------------------------
-------------------oo---------------------------------------------------------------------------------o-S------oo-----------------------------------------------------o------------o------------------------------------------------------------o---------------------S----------------S------##-----------------o------o----#------------------S------------------------------S-----
-------------------------------T----------------------------------T-------------T--------------T----------T--------------T---------T-----------------------------------------------------------T-------------------------------------------------------T--------------------------T-----------##-----TT----------------------#--------------------------#----------------------------
---------K-------------------T-T----------------------------------T-------------T--------------T----------T--------------T---------T------------------------------------------T----------------T---------------------T---------T----------T---------T--T--------------------------T-----------##-----TT----------------------#--------------------------#---T-------T----------------
-----------------------------T-T-----------#----------------------T-------------T--------------T----#-----T--#-----------T---------T----------------------t-------------------T----------------T-----------#---------T-#-------T-------#--T---------T--T------------------#-------T-----------##-----TT----------------------#------------------------t-#---T-------T------------F---
-M-----k----k--k---k---------T-T-----------#----g------k---k------T-------k-----T--------k-gg--T----#-----T-k#-k---------T------kk-T-------------g--------t------k----------k-T----------------T----g------#---------T-#-------T-----g-#-kT-g-k---g-T--T-g------g---------#---g---T-----------##-----TT--g-------------------#---g---k-g------g-------t-#-kkT----gg-T----g-k-----#---
XXXXXXXXX-XXXXXXX-XXXXXXXXXXXXXXXXXXXXXXXXXXXXXXXXXXXXXXXXXXXXXXXXXXXXX-XXXXX--XXX-XXXXXXXXXXXXXX-XXXXXXXXXXXXXXXXXXX-XX-XXX--XXXXXXXXX-XXX-XXXXXXX-XXX-XXXXXXXXXXXXXXXXXXXXXXX-XX---XXXXXXXXX-XXX-XXXX-X--XXXXXX-XXXXXXXXXX-XXXXXXXXXXXXXXXXXXXXXXXXXXXXXXXXXXXXXXX-XXXXXXXXXXXX-XXXXXXXXX-X-XXXXXXXXXXXXXX-XXXXXXX-XXXXX-X-XXXXXXXXXXXXXXXXXXXXX-XXXXXXXXXXXXXXXXXXXX-XXXXXXXXXXXXX
XXXXXXXXX-XXXXXXX-XXXXXXXXXXXXXXXXXXXXXXXXXXXXXXXXXXXXXXXXXXXXXXXXXXXXX-XXXXX--XXX-XXXXXXXXXXXXXX-XXXXXXXXXXXXXXXXXXX-XX-XXX--XXXXXXXXX-XXX-XXXXXXX-XXX-XXXXXXXXXXXXXXXXXXXXXXX-XX---XXXXXXXXX-XXX-XXXX-X--XXXXXX-XXXXXXXXXX-XXXXXXXXXXXXXXXXXXXXXXXXXXXXXXXXXXXXXXX-XXXXXXXXXXXX-XXXXXXXXX-X-XXXXXXXXXXXXXX-XXXXXXX-XXXXX-X-XXXXXXXXXXXXXXXXXXXXX-XXXXXXXXXXXXXXXXXXXX-XXXXXXXXXXXXX
