----------------------------------------------------------------------------------------------------------------------------------------------------------------------------------------------------------
----------------------------------------------------------------------------------------------------------------------------------------------------------------------------------------------------------
----------------------------------------------------------------------------------------------------------------------------------------------------------------------------------------------------------
----------------------------------------------------------------------------------------------------------------------------------------------------------------------------------------------------------
----------------------------------------------------------------------------------------------------------------------------------------------------------------------------------------------------------
----------------------------------------------------------------------------------------------------------------------------------------------------------------------------------------------------------
----------------S----------S-----------S---S-----S-----------S-----------------S----------------------------------------------S-S------S-----------S-S----------------------SSS----S----------------------
----------------------------------------------------------------------------------------------------------------------------------------------------------------------------------------------------------
----------------------------------------------------------------------------------------------------------------------------------------------------------------------------------------------------------
----------------------------------------------------------------------------------------------------------------------------------------------------------------------------------------------------------
-!---#---#--S----------!-----S---!------------------t---#-----------------t------S-----t---S---S---------t---S----#------!-----------------------S-------t--------t------------------------------!------!-
-----#---#------------------------------------------t---#--------t--------t------------t-----------------t--------#--------------------------------------t--------t---------------------------------------
-----#---#------------------------------------------t---#-t------t--------t--t---------t-----------------t--------#--t--------------------t--------------t--------t-----------------------------------F---
---M-#---#-----------------------------------#------t---#-t------t---#----t--t---------t---------------g-t--------#--t--------------------t----#---------t--------t--------------------#-------#----#-#---
XXXXXXXXXXXXXXXXXXX-XXXXXXXXXXX-XXXXXXXXXXXXXXXXXXXXXXXXXXXXXXXXXXXXXXXXXXXXXXXXXXXXXXXXXXXXXXXXXXXXXXXXXXXXXXXXXXX-XXXXXXXXXXXXXXXXXXXXXXXXXXXXXXXXXXXXXXX-XXXXXXXXXXXXXXXXXX--XXXXX-XXXXXXXXXXXXXXXXXXXX
XXXXXXXXXXXXXXXXXXX-XXXXXXXXXXX-XXXXXXXXXXXXXXXXXXXXXXXXXXXXXXXXXXXXXXXXXXXXXXXXXXXXXXXXXXXXXXXXXXXXXXXXXXXXXXXXXXX-XXXXXXXXXXXXXXXXXXXXXXXXXXXXXXXXXXXXXXX-XXXXXXXXXXXXXXXXXX--XXXXX-XXXXXXXXXXXXXXXXXXXX
