----------------------------------------------------------------------------------------------------------------------------------------------------------------------------------------------------------
----------------------------------------------------------------------------------------------------------------------------------------------------------------------------------------------------------
----------------------------------------------------------------------------------------------------------------------------------------------------------------------------------------------------------
----------------------------------------------------------------------------------------------------------------------------------------------------------------------------------------------------------
----------------------------------------------------------------------------------------------------------------------------------------------------------------------------------------------------------
----------------------------------------------------------------------------------------------------------------------------------------------------------------------------------------------------------
-S----------------------------------------S-------SS-----------S-----------S-------------------------------------------#-------S-------------------SSS-S-----------!S-------------------------------------
----------------------------------------------------------------------------------------------------------------------##----------------------------------------------------------------------------------
---------------------------------------------------------------------------------------------------------------------###----------------------------------------------------------------------------------
--------------------------------------------------------------------------------------------------------------------####----------------------------------------------------------------------------------
-------#-S!------------------S---------------------------t---------------------------#-------S-------#-----------!-#####-----S----------------t------------!-----S@S-----!-----------#----S---------#-----
-------#----------------------------------------t--------t---------------------------#---------------#-------------#####----------------------t--------------------------------------#--------------#-----
-------#--------------t---------t---------------t--------t-t-------------------------#---------t-----#-------------#####----------------------t--t-----------------------------------#--------------#-F---
---M---#--------#--g--t---------t---#--gg-----#-t--------t-t-----g-------------------#-----#---t-----#-------g-----#####----------------------t--t------------g---g------------#-g-#-#--------------#-#---
XXXXXXXXXXXXXXXXXXXXXXXXXXXXXXXXXXXXXXXXXXXXXXXXXXXXXXX-XXXXXXXXXXXXX--XXXXXXXXXXXXXXXXXXXXXXXXXXXXX-XXXXXXXXXXXXXXXXXXXXXXXXXXXXXXXX-XXXXXX-XXXXXXXXXXXXXXXXXXXXXXXXXXXXXXXXXXXXXXXXXXXXXXXXXXXXXXXXXXXXX
XXXXXXXXXXXXXXXXXXXXXXXXXXXXXXXXXXXXXXXXXXXXXXXXXXXXXXX-XXXXXXXXXXXXX--XXXXXXXXXXXXXXXXXXXXXXXXXXXXX-XXXXXXXXXXXXXXXXXXXXXXXXXXXXXXXX-XXXXXX-XXXXXXXXXXXXXXXXXXXXXXXXXXXXXXXXXXXXXXXXXXXXXXXXXXXXXXXXXXXXX
