----------------------------------------------------------------------------------------------------------------------------------------------------------------------------------------
----------------------------------------------------------------------------------------------------------------------------------------------------------------------------------------
----------------------------------------------------------------------------------------------------------------------------------------------------------------------------------------
----------------------------------------------------------------------------------------------------------------------------------------------------------------------------------------
----------------------------------------------------------------------------------------------------------------------------------------------------------------------------------------
----------------------------------------------------------------------------------------------------------------------------------------------------------------------------------------
-----------------------------------------------------------------2----------------------------------------#-------------------------------------y---------------------------------------
----------------------------------------------------------------------------------------------------------#-----------------------------------#SSS--------------------------------------
------------------------------------------------------------------------------y---------------------------#----------------------------------##-----------------------------------------
---------------------------------------o--------------------------------------XS---------------o----------#---o--------------------o----o---###1----------------------------------------
------------------------------------------------QQ------------o--2-----------XX--------SC-----------------#----------------------Q----------###---------------------------------------o-
-----------------#--------------TT------------------------------------------XXX------------------------T--#-------------------T-------------###--SSSSSSSSSSSSSSS------------------------
----------------##--------------TT-----------------------------------------XXXX------------------------T--#-------------------T-------------###-------------------------------------F---
----M----y----------------------TT---------y----------y-----------y-------XXXXX------------------------T--#-----------------y-T-------------###----------------------------y-----y--#---
XXXXXX-XXXXXXXXXXXX--X-XXX--XXXXXXXXXXXXXXXXX-XXXXXX-XXXXXXXXXXXXXXXXXXXXXXXXXX---XXX--XXXXXXXXXXXXXXXXXX-XX-XXX--XX-X--XXXXXXXXXXXXXXXXXX-XXXXXXX---------------XXXXXXXXXXXX-XXXXXXXXXX
XXXXXX-XXXXXXXXXXXX--X-XXX--XXXXXXXXXXXXXXXXX-XXXXXX-XXXXXXXXXXXXXXXXXXXXXXXXXX---XXX--XXXXXXXXXXXXXXXXXX-XX-XXX--XX-X--XXXXXXXXXXXXXXXXXX-XXXXXXX---------------XXXXXXXXXXXX-XXXXXXXXXX
