---------------------------------------------------------------------------------------------------------------------------------------------------------------------
---------------------------------------------------------------------------------------------------------------------------------------------------------------------
---------------------------------------------------------------------------------------------------------------------------------------------------------------------
---------------------------------------------------------------------------------------------------------------------------------------------------------------------
-----o-----------------o--------------------o-----o--------o---------------o-------------o----------------o-------------------------------o----------------o---------
---------------------------------------------------------------------------------------------------------------------------------------------------------------------
------%-----------------%--------------------%-----%----S---%------------o--%-------------%----------------%%%---------------SS--oooo------%-------S-S---S--%%%------
-------------------------------------------------------------------------S---------S------------------------|--------------------SSSS------------S-----------|-------
------------------------------------------S--------------------o--------------------------------------------|------------------------------------------------|-------
------------------------------------------------------------------------------------------------------------|------------------------------------------------|-------
-------------------------------------------------------%-------S--%--%---------------S----------S---%-%-----|--------------------------%--------------%%%----|-------
--------------------------------------------------------------------------------------------------------S---|------------------------------------------|-----|-------
------------------------------------------------------------------------------------------------------------|------------------------------------------|-----|-----F-
-M----------------------------------------------------------------------------------------------------------|------------------------------------------|-----|-----X-
XXX----XXXXXXXXXXXXXX----XXXXXXXXXXXXXXXX-----XXX---XX-------X-----%%%%%%----XXXX----------XXXX-------------|-XXXXXXXXXXXXXX----%-----------XXXX-------|-----|-XXXXXX
XXX----XXXXXXXXXXXXXX----XXXXXXXXXXXXXXXX-----XXX---XX-------X------|-||-----XXXX----------XXXX-------------|-XXXXXXXXXXXXXX----------------XXXX-------|-----|-XXXXXX
