---------------------------------------------------------------------------------------------------------------------------------------------------------------------
---------------------------------------------------------------------------------------------------------------------------------------------------------------------
---------------------------------------------------------------------------------------------------------------------------------------------------------------------
---------------------------------------------------------------------------------------------------------------------------------------------------------------------
--------------------------------------------------------o-------oo------o-------------------------------------o-------------------------o--------------------o-------
---------------------------------------------------------------------------------------------------------------------------------------------------------------------
-------S----S------------------o-S-----------------------%%-------%%%%---%----SS-----------------S-------------%%%---------o-S-----------%%%%-----------------%%-----
-------------------------------S-----------------S-------------------------------------------------------------------------S-----------------------------------------
------------------------------------------------------o--------------------------------------------------------------------------------------------------------------
--------------------------o------------------------------------------------------------------------------------------------------------------------------------------
-----%%-%%-%-%%---%%---%-----%----%-%%-%--%-%-------%-S---------------------S---%-%%--%%--SS--%-%-%%-%%%-%-%%---------S-%-----%-------%------------------------------
----------------------------------------------SS---------------------------------------------------------------------------------------------------------------------
-------------------------------------------------------------------------------------------------------------------------------------------------------------------F-
-M-----------------------------------------------------------------------------------------------------------------------------------------------------------------X-
XXX-------------------%--%%%%-%---------%%---------%-------XXX--------X---X------%---%--------------%---%-%-------XXX----%%-----%%%%%%-------XXXXXXXXXXXXXX-----XXXXX
XXX--------------------------------------------------------XXX--------X---X---------------------------------------XXX------------------------XXXXXXXXXXXXXX-----XXXXX
