------------------------------------------------------------------------------------------------------------------------------------------------------------------------------------------------------------------------------
------------------------------------------------------------------------------------------------------------------------------------------------------------------------------------------------------------------------------
------------------------------------------------------------------------------------------------------------------------------------------------------------------------------------------------------------------------------
------------------------------------------------------------------------------------------------------------------------------------------------------------------------------------------------------------------------------
------------------------------------------------------------------------------------------------------------------------------------------------------------------------------------------------------------------------------
------------------------------------------------------------------------------------------------------------------------------------------------------------------------------------------------------------------------------
---------Q------------------Q------------------------------------------------------------------------------------------------------------------------------------------------Q------------------------------------------------
-----------------------o-------------o----------o--o-----------------------------------o-------------------------------o---o--o-------------------------------------o---o------------------------------o----------------------
------------------------------------------------------------------------------------------------------------------------------------------------------------------------------------------------------------------------------
------------------------------------------------------------------------------------------------------------------------------------------------------------------------------------------------------------------------------
---------Q------------------Q----------o-----------------T----------o------Q--------------------------------Q-------------------------------------------T-----T--------------Q-----------Q---T-----T------C-------------------
-------------------T---------------------------------#---T------------------------------------------------#---------------------------------------------T-----T------------------------------T-----T--------T-----------------
--------------T----T---------------------------------#---T------------------------------------------------#---------------------------------------------T-----T------------------------------T-----T--------T-------------F---
-M------------T--y-T---------------------------------#---T---------------y--------------------------------#-----------------------y-----------y---------T-----T---y--------------------------T-----T--------T-------------#---
XXXXXXXXXXXXXXXXXXXXXXXXXXXXXXXXXXXXXXXXX-XXX-XXXXXXXXXXXXX-XXXXX--XXXXXXXXXXXXXXXXXXXXXXXXXXXXXXXXXXXXXXXXXXX-XXXXXX-XXX-XXXXXXXXXXXXXXX-XXXXXXXXXXX-XXXXXXXXXXXXXXXXXXXXXXXXXXXXXXXXX-XXXXXXXXXXXXXXXXXXXXXXX--XXXXXXXXXXXXX
XXXXXXXXXXXXXXXXXXXXXXXXXXXXXXXXXXXXXXXXX-XXX-XXXXXXXXXXXXX-XXXXX--XXXXXXXXXXXXXXXXXXXXXXXXXXXXXXXXXXXXXXXXXXX-XXXXXX-XXX-XXXXXXXXXXXXXXX-XXXXXXXXXXX-XXXXXXXXXXXXXXXXXXXXXXXXXXXXXXXXX-XXXXXXXXXXXXXXXXXXXXXXX--XXXXXXXXXXXXX
