----------------------------------------------------------------------------------------------------------------------------------------------------------------------------------------------------------------------
----------------------------------------------------------------------------------------------------------------------------------------------------------------------------------------------------------------------
----------------------------------------------------------------------------------------------------------------------------------------------------------------------------------------------------------------------
----------------------------------------------------------------------------------------------------------------------------------------------------------------------------------------------------------------------
----------------------------------------------------------------------------------------------------------------------------------------------------------------------------------------------------------------------
----------------------------------------------------------------------------------------------------------------------------------------------------------------------------------------------------------------------
---------US-------------S---S--US---------S----------S------------------------------------------------------SS-----------------------US-SS-S------SS---S-----------------S---SS-----------S----S-SS-------------------
----------------T-----------------------------------------------------------------------------------------------------------------------------------------------------------------------------------------------------
----------------T-----------------------------------------------------T-------------------------------T----------------------------------------------------------------------------------------------T----------------
--------S-------X-------------S---------------------------------------T-------------------------------T-----------------------------S----------------------------------------------------------------T----------------
-----S------------------S--------------------T-T--------------S-------T-------S---------S-S----S----T-X---S--------------S----T------------S-----------------#----T-TT----------T------T-------------X--T-------------
---------------------------------------------T-T------------T---------T---------T-----------------K-T-------------------------T------------------------------#----T-TT----------T------T----------------T-------------
---------------------#----T--------T---------T-T-----TT-T---T----TT---T--t------T----#-------T------T-------T-----T-----------T-----------------T------------##---T-TT-------T--T--T---T----------------T----------F--
---M----------------##----T--------T---------T-T-----TT-T---T----TT---T--t------T---##-------T------T-------T-----T-----------T-----------------T------------##---T-TT-------T--T--T---T----------------T----------#--
XXXXXXXXXX-XXXXXXXXXXXXXXXXXXXXX-XXXXXXXXXXXXXXXXXXXXXXXXXXXXXXXXXXXXXXXXXXXXXXXXXXXXXXXXXXXXXXXXXXXXXXXXXXXXXXXXXXXXXXXXXXXXXXXXXXXXX-XXXXXXXXXXXXXXXXXXXXXXXXXXXXXXXXXXXXXXXXXXXXXX-XXXXXXXXXXXX-XXXXXXXXXXXXXXXXXXX
XXXXXXXXXX-XXXXXXXXXXXXXXXXXXXXX-XXXXXXXXXXXXXXXXXXXXXXXXXXXXXXXXXXXXXXXXXXXXXXXXXXXXXXXXXXXXXXXXXXXXXXXXXXXXXXXXXXXXXXXXXXXXXXXXXXXXX-XXXXXXXXXXXXXXXXXXXXXXXXXXXXXXXXXXXXXXXXXXXXXX-XXXXXXXXXXXX-XXXXXXXXXXXXXXXXXXX
