-----------------------------------------------------------------------------------------------------------------------------------------------------------------------------------------------------
-----------------------------------------------------------------------------------------------------------------------------------------------------------------------------------------------------
-----------------------------------------------------------------------------------------------------------------------------------------------------------------------------------------------------
-----------------------------------------------------------------------------------------------------------------------------------------------------------------------------------------------------
----------------------------------------------------------------------------X------------------------------------------------------------------------------------------------------------------------
----------------------------------------------------------------------------X------------------------------------------------------------------------------------------------------------------------
-----S-S----QQ---S---------------------------S-S-----------QQ--QQ-S--S-?----X-S------------S-------S------------------------------------S-------------S---SS-------------------------S-S-------------
----------------------------------------------------------------------------X------------------------------------------------------------------------------------------------------------------------
---------------------------------------------------g------------------------X---------------------------------g--------------------------------------------------------------------------------------
---------------------------------------------------#------------------------X-----T--------------T------------#-----------T--------------------------------------------------------------------------
------------?Q-------------S---T-T---T------------##-------?Q--?Q--------T--X-----T---T----------T-----S-----##-----------T-----------------------------------------S--S------T----------S-----------
-------------------------------T-T---T------------##---------------------T--X-----T---T----------T-----------##-----------T---------------------------------------------------T----------------------
-------------------------------T-T---T------------##---------------------T--X-----T---T----------T-----------##-----------T----------------#----------------------------------T------------------F---
--M-------g----------k---------T-T-g-T------------##-g----------------K--T--X-----T---T----------T--------k--##---------g-T---------------##----g-------g---------------------T------------------X---
XXXXXXX-XXXXXXXXX-XXXXXXXXXXX-XXXXXXXXXX-XXXXXXXXXXXXXXXXXXXXXXXXXXXXXXXXXXXXXXXXXXXXXXXXXXXXXXXXXXXX-XXXXXXXXXXXX-XXXXXXXXXXXXX-XXXX-XXXXXXXXXXXXXXXXXXXXXXXXXXXXXXXXXXXXXXXXXXXXXXX-XXXXXXX-XXXXXXX
XXXXXXX-XXXXXXXXX-XXXXXXXXXXX-XXXXXXXXXX-XXXXXXXXXXXXXXXXXXXXXXXXXXXXXXXXXXXXXXXXXXXXXXXXXXXXXXXXXXXX-XXXXXXXXXXXX-XXXXXXXXXXXXX-XXXX-XXXXXXXXXXXXXXXXXXXXXXXXXXXXXXXXXXXXXXXXXXXXXXX-XXXXXXX-XXXXXXX
