----------------------------------------------------------------------------------------------------------------------------------------------------------------------------------------
----------------------------------------------------------------------------------------------------------------------------------------------------------------------------------------
----------------------------------------------------------------------------------------------------------------------------------------------------------------------------------------
----------------------------------------------------------------------------------------------------------------------------------------------------------------------------------------
----------------------------------------------------------------------------------------------------------------------------------------------------------------------------------------
----------------------------------------------------------------------------------------------------------------------------------------------------------------------------------------
--------------------------#---------------------------------------------#-------------------------------------------------------------#--#----------------------------------------------
--------------------------#---------------------------------------------#-------------------------------------------------------------#--#----------------------------------------------
--------------------------#---------------------------------------------#-------------------------------------------oo----------------#--#----------y-----------------y-----------------
--------o-----------------#---------------------o-----------------------#------------------------------------------------o------------#--#----------XS----------------XS----------------
--------------------------#-----------------------o-----Q---------------#------------------------------Q---------------------SC-------#--#---------XX----------------XX------Q----------
--------------------------#----------T----------------------------------#---------------------------------------T---------------------#--#--------XXX---------------XXX-----------------
--------------------------#----------T----------------------------------#---------------------------------------T---------------------#--#-------XXXX--------------XXXX-------------F---
----M---------------------#----------T--------------------y-----y-y-----#-------------------------y-y-----------T---------------------#--#---y--XXXXX-----------y-XXXXX--------y----#---
XXXXXXXXXXXXXXXXX-X-XX-XX-XX--XXXXXXXXXXXXXXX-XXXXXXXXXXXXXXXXXXXXXXXX--XXXXXX-XX-XX-X-XXXXXXXXX-XXXXXXXXXXXXXXXXXX--XX-XXXX-XXX-XX---XX-XXXXXXXXXXXX--XXX--XX-XXXXXXXX--XXXXXXXXXXXXX-X
XXXXXXXXXXXXXXXXX-X-XX-XX-XX--XXXXXXXXXXXXXXX-XXXXXXXXXXXXXXXXXXXXXXXX--XXXXXX-XX-XX-X-XXXXXXXXX-XXXXXXXXXXXXXXXXXX--XX-XXXX-XXX-XX---XX-XXXXXXXXXXXX--XXX--XX-XXXXXXXX--XXXXXXXXXXXXX-X
