-------------------------------------------------------------------------------------------------------------------------------------------------------------------------------------------
-------------------------------------------------------------------------------------------------------------------------------------------------------------------------------------------
-------------------------------------------------------------------------------------------------------------------------------------------------------------------------------------------
S---SSSSS---SSSSSSSSSSSSSSSSSSSSSS----SS-SSSSSSSSSSSSSSS-SSSSSSSSSSSSSSSSSSS-SS------SSSSSSSSSSSSSSSSSSSSSSSSSSSSSSSSSSSSSSSSSSSSSSSSSSSSSSSSSSSSSSSSSSSSSSSSSSSSS-SSS----SSSSSSS---SSSSSSS
S---------------------------------------------------------------------------------------------------SSSSS----------------------------------------------------------------------------------
S---------------------------------------------------------------------------------------------------SSSSS----------------------------------------------------------------------------------
S-------------------------------------S--------------------------------------S----------------------SSSSS----------------------------------------------------------------------------------
S----------------------------------------------------------------------------------------------------------------------------------------T-------------------------------------------------
S---------S------------------------SS---------------------------------------------SS-----------------------------------------------------T------------------------------S------------------
S----------------------------------------------------------------------------------------------------------------------------------------T-------------------------------------------------
S-------Q-----------T--T---------S----SS---------------S-------------------S-SS-------TTT--T---TT--------#-----------------T-------------T----------TT-----TTT---S---Q--------------------F
S------------#------T--T------------------------------------------TT---T--------------TTT--T---TT-------##----------TT---#-T-#--------T--T----------TT-----TTT------------------#--------SS
S-----t------#------T--T------------------------------------------TT---T--------S-----TTT--T---TT------###----------TT--##-T-#--------T--T----------TT--t--TTT--------------t--##-S---t--SS
S-M---t------#------T--T------------------------------------k-----TT-k-T--------------TTT--T---TT-----####--------k-TT-###-T-#---k----T-kT----------TT--t--TTT--------------t--##-----t--SS
XXXXXXXXX----X-XXX-XX-XX--X-XXX-XX----XX---XX-XX-X-XXXXX--XXXXX-XXXXXXXXX-XX-XX-------XXX--X---XX----XXXXXXX-X--XXXXXXXXXX-X-X-XXXX--XXXXXXXX-X-XXXXXX-XXXXXXX-XXX--XX-----XXXXXX----XXX-XX
XXXXXXXXX----X-XXX-XX-XX--X-XXX-XX----XX---XX-XX-X-XXXXX--XXXXX-XXXXXXXXX-XX-XX-------XXX--X---XX----XXXXXXX-X--XXXXXXXXXX-X-X-XXXX--XXXXXXXX-X-XXXXXX-XXXXXXX-XXX--XX-----XXXXXX----XXX-XX
