----------------------------------------------------------------------------------------------------------------------------------------------------------------------------------------
----------------------------------------------------------------------------------------------------------------------------------------------------------------------------------------
----------------------------------------------------------------------------------------------------------------------------------------------------------------------------------------
----------------------------------------------------------------------------------------------------------------------------------------------------------------------------------------
----------------------------------------------------------------------------------------------------------------------------------------------------------------------------------------
----------------------------------------------------------------------------------------------------------------------------------------------------------------------------------------
-------------------------------------------------------------------------------------------------------------------------------------------------##-------------------------------------
-------------------------------------------------------------------------------------------------------------------------------------------------##-------------------------------------
--------------------------------------------------oo----------------------------------------------------------------------------------oo---------##-------------------------------------
----------------------------o-----------o-----------------------------o---------------?Q----------------o----------------------------------------##-------------?Q----------------------
------o----o------SC---------------#------------#-----------#-------------------------------o----------------------------------------------------##-------------------------------------
--#------------------------------y##----------y##---------y##------------------------------------------------------------------------------------##-------------------------------------
-##------------------------------###----------###---------###----------------------------y-------------------------------------------------------##-----------------y---------------F---
----M---------------------------####------y--####--------####---------------------y---SSSS------------------------------------y----------y-------##--y------y---SSSSS---------------#---
XXXXXXXXX-XXX-X---XXXXXX-XXXXX-XXXXX-XXXXXXXXXXXX--XXXXXXXXXX-XXXXXX-XXXX-XXX-XXXXXXX----XXXXXXXXXXXXXXXXXXXXXXX-XXXX-XX-XXX-XXXXX-XX--XXXX--XXX-XXXXXXXXX-XXXX-----XX-XXXX-XXXXX-XXXXXX
XXXXXXXXX-XXX-X---XXXXXX-XXXXX-XXXXX-XXXXXXXXXXXX--XXXXXXXXXX-XXXXXX-XXXX-XXX-XXXXXXX----XXXXXXXXXXXXXXXXXXXXXXX-XXXX-XX-XXX-XXXXX-XX--XXXX--XXX-XXXXXXXXX-XXXX-----XX-XXXX-XXXXX-XXXXXX
