------------------------------------------------------------------------------------------------------------------------------------------------------------------------------------------------------------------------------
------------------------------------------------------------------------------------------------------------------------------------------------------------------------------------------------------------------------------
------------------------------------------------------------------------------------------------------------------------------------------------------------------------------------------------------------------------------
------------------------------------------------------------------------------------------------------------------------------------------------------------------------------------------------------------------------------
------------------------------------------------------------------------------------------------------------------------------------------------------------------------------------------------------------------------------
-------------------------------------------------------------------------------------------------------------------------------------------------------------y----------------------------------------------------------------
----------Q---------------------Q--------------------------------------------------Q------------------------------------------------------------------Q------##---------------------------------------------------------------
--------------------------oo------------o-----------o--------------------------------------------------o---------------------------------------------------y###---------o-----------------------------------------o-----------
-----------------------------------------------------------------------------------------------------------------------------------------------------------####---------------------------------------------------------------
----------------------------------------------------------------------------------------------------------------------------------------------------------#####---------------------------------------------------------------
----------Q-------o-------------Q-------------Q--Q-----C------Q--------------------Q---------T----T----------------------------------o----------------Q--######--------------T-------------o----------------------------------
---------------------------------------------------------------------------------------------T----T--------------------------#--------------------------#######-----------T--T----------------------------------------#-------
---------------------------------------------------------------------------------------------T----T--------------------------#--------------------------#######-T---------T--T----------------------------------------#---F---
-M------------------y------------------------------------y--y--------------------------------T-y--T-------------y---y------y-#---------------y----------#######-T---------T--T--------------------------y-------------#---#---
XXXXX-XXXXXXXXXX-XXXXX-XXXXXXXXXXXXXXX-XXXXXXXXXXXXXXXXXXXXXXXXXXXXXXXXXXXXXXXXXXXXXXX--XXX-XXXXXXXX-XXXXXX-XX-XXXXXXXXXXXXXXXXX-XXXXXXXXXXXXXXX-XXXXXXXXXXXXXXXXXXXX-XXXXXXXXXXXXXXX-XX-XXXXX-XXX--XXXXXXXXXXXXXXXXXXXXXXXXXX
XXXXX-XXXXXXXXXX-XXXXX-XXXXXXXXXXXXXXX-XXXXXXXXXXXXXXXXXXXXXXXXXXXXXXXXXXXXXXXXXXXXXXX--XXX-XXXXXXXX-XXXXXX-XX-XXXXXXXXXXXXXXXXX-XXXXXXXXXXXXXXX-XXXXXXXXXXXXXXXXXXXX-XXXXXXXXXXXXXXX-XX-XXXXX-XXX--XXXXXXXXXXXXXXXXXXXXXXXXXX
