------------------------------------------------------------------------------------------------------------------------------------------------------
------------------------------------------------------------------------------------------------------------------------------------------------------
------------------------------------------------------------------------------------------------------------------------------------------------------
------------------------------------------------------------------------------------------------------------------------------------------------------
------------------------------------------------------------------------------------------------------------------------------------------------------
-------------------oo-----------------------------------ooo-----------------------------oo------------------------------------------------------------
--------------------------------------oo----------------%%%-------------------o-----------------------------------------------------------------------
----------%--------------%-------------------------------|-------------------------------------------%------------------------------------------------
------------------------------------------------%%%%%----|-------------------------------------%------------------------------------------------------
-------S-----------------------------------------|||-----|--------------------------S-----------------------------------------------------------------
---------------------------%-%%%%----%--%-%---%--|||-----|---------------------%------%--SS-----------------%-%----%%%---------------%%%%%--%%%-------
------------------------------||-----------------|||---U-|----------------------------------------------------------|-----------------|||----|--------
--------------------%%%-------||-----------------|||-----|----------------------------------------------------------|-----------------|||----|-----F--
-M-------------------|--------||-----------------|||-----|----------------%%%---%----------------------%------------|---------------o-|||----|-----#--
XXXX--------X-XXXX---|--------||--XX--------%----|||---%%%%-XX-XXX---X-X---|------%---------X----XXX-----X-%----%---|--X----XX--XXX-%-|||--%-|--XXXXXX
XXXX--------X-XXXX---|--------||--XX-------------|||----||--XX-XXX---X-X---|----------------X----XXX-----X----------|--X----XX--XXX---|||----|--XXXXXX
