--------------------------------------------------------------------------------------------------------------------------------------------------------------------------------
--------------------------------------------------------------------------------------------------------------------------------------------------------------------------------
--------------------------------------------------------------------------------------------------------------------------------------------------------------------------------
--------------------------------------------------------------------------------------------------------------------------------------------------------------------------------
--------------------------------------------------------------------------------------------------------------------------------------------------------------------------------
--------------------------------------------------------------------------------------------------------------------------------------------------------------------------------
---S---S-----------S----------------------S--S----S-----------------------------------------------------------------------------------SS--------S-------------------------------
--------------------------------------------------------------------------------------------------------------------------------------------------------------------------------
------------------------B--------------------------------------#--------------#-------------------------------------------------------------------------------------------------
------------------------b-------------------------------------##-------------##-------------------------------------------------------------------------------------------------
---S---S-----------S---S#CS--Q------------S--S----S----------###------------###--------------------Q------------------Q---------------SS--------S-------------------------------
----------B-------------------------B-----------------------####-----#-----####------T------#---------------T---#-------------K-------------------------B-----------------------
----------b---------------K---------b--------------------T--####--B--#-----####--B---T------#----------B----T---#-----------------B---------------------b------B------------F---
-M--------b-------------------------b--------------------T--####--b--#-----####--b---T------#----------b----T---#-----------------b---------------------b------b---k--------#---
XXXXX-XXXXXXXXXXXXXXXXXXXXXXXXXXXXXXXXXXXXXXXXXXXXXXXXXXXXXXXXXXXXXXXXXXXXXXXXXXXXXXXXXXXXXXXXXXXXXXXXXXXXXXXXXXXXXXXXXXXXXXXXXXXXXXXXXXXXXXXXXXXXXXXXXXXXXXXXXXXXXXXXXXXXXXXXXX
XXXXX-XXXXXXXXXXXXXXXXXXXXXXXXXXXXXXXXXXXXXXXXXXXXXXXXXXXXXXXXXXXXXXXXXXXXXXXXXXXXXXXXXXXXXXXXXXXXXXXXXXXXXXXXXXXXXXXXXXXXXXXXXXXXXXXXXXXXXXXXXXXXXXXXXXXXXXXXXXXXXXXXXXXXXXXXXX
