-----------------------------------------------------------------------------------------------------------------------------------------------------------------------------------------------------
-----------------------------------------------------------------------------------------------------------------------------------------------------------------------------------------------------
-----------------------------------------------------------------------------------------------------------------------------------------------------------------------------------------------------
-----------------------------------------------------------------------------------------------------------------------------------------------------------------------------------------------------
-----------------------------------------------X-------------------------------------X-------------XX------------------------------------------------------------------------------------------------
-----------------------------------------------X-------------------------------------X-------------XX------------------------------------------------------------------------------------------------
----S--------------S-?------S----------QQ----S-X--------S-----C----------------------X-----S-?-S---XX----------SS-------S-------S-S----C--------QQ--QQ---S-----------------------S----SS------QQ-----
-----------------------------------------------X-------------------------------------X-------------XX------------------------------------------------------------------------------------------------
-----------------------------------------------X-------------------------------------X-------------XX------------------------------------------------------------------------------------------------
-----------------------------------------------X-------------------------------------X-------------XX------------------------------------------------------------------------------------------------
--------T------S--------------------C--?Q------X-----#-------SS-----------------S----X-------------XX------S-T----------------S-------SS--------?Q--?Q-S---------T-------------T---------#----?Q-----
--------T--T-----------------------------------X-----#-------------------------------X-------------XX--------T---------------------------------------------------T---------g---T---------#-----------
--------T--T-----------------------------------X-----##---------------#--------------X-------------XX--------T---------------------------------------------------T---------TT--T---------##------F---
--M-----T--T--------K---g-------g--gg------g---X-g---##-------k------##----k---------X------K------XX--------T-------------------------k---g----------------g----T----g----TT--T---------##------X---
XXXXXXXXXXXXXXXXXXXXXXXXXXXXXXXXXXXXXXXXXXXXXXXXXXXXXXXXXXXXXXXXXXXXXXXXXXXXX-XXXXXXXXXX-XXXXXX-XXXXXXXXXXXXXXXXXXXXXXXXXXXXXXXXXX-XXXXXXXXXXXXXXXXXXXXXX-XXXXXXXXXXXXXXX-XXXXXXXXXXXXXXXXXXXXXXXXXXX
XXXXXXXXXXXXXXXXXXXXXXXXXXXXXXXXXXXXXXXXXXXXXXXXXXXXXXXXXXXXXXXXXXXXXXXXXXXXX-XXXXXXXXXX-XXXXXX-XXXXXXXXXXXXXXXXXXXXXXXXXXXXXXXXXX-XXXXXXXXXXXXXXXXXXXXXX-XXXXXXXXXXXXXXX-XXXXXXXXXXXXXXXXXXXXXXXXXXX
