------------------------------------------------------------------------------------------------------------------------------------------------------------------------------------------------------
------------------------------------------------------------------------------------------------------------------------------------------------------------------------------------------------------
------------------------------------------------------------------------------------------------------------------------------------------------------------------------------------------------------
------------------------------------------------------------------------------------------------------------------------------------------------------------------------------------------------------
------------------------------------------------------------------------------------------------------------------------------------------------------------------------------------------------------
------------------------------------------------------------------------------------------------------------------------------------------------------------------------------------------------------
----------------------------------------------------------------------------------#------------------------------------------------------------------------------------------#------------------------
----------------------------------------------------------------------------------#------------------------------------------------------------------------------------------#------------------------
---T------------------------------------------------------------------------------#------------------------------------------------------------------------------------------#------------------------
---T------------------------------------------------------------------------------#-------------#---#-------------------------------------------------K----------------------#------------------------
---#------------------------------------------------------------------------------#------------##--##------------------------------------------------------------------------#------------------------
-----------T--------------------------------------------------K-------------------#------------##--##---------------------------------------------------#--------------------#--K------------K--------
-----------T--*---------------------------------------T---------------------------------------K##-K##------------------T-------------------------------##-------TT--------------------------------F---
-M------g-kT--*--------------------------k--K-g-------T-----------gg-g--g---k-k----------------##--##---------g-----g--T-------------k-----------k----###-------TT-k--------------g-K--g----------#---
XXXXXXXXXXXXXXXXXXXXXXXXXXXXX-XXXXXXX-XXXXXXXXXXXX-XXXXXXXXXXXXXXXXXXXXXXXXXXXXX-XXXX-XXXXXXXXXXXXXXXX-XXXXXXXXX-X-XXXXXXXXXX-XXXXXXXXXX-XXXXXXXXXXXXXXXXXXXXX-XXXXXXXXXXX-XXXXXXXXXXXXXX-XXXXXXXXXXXX
XXXXXXXXXXXXXXXXXXXXXXXXXXXXX-XXXXXXX-XXXXXXXXXXXX-XXXXXXXXXXXXXXXXXXXXXXXXXXXXX-XXXX-XXXXXXXXXXXXXXXX-XXXXXXXXX-X-XXXXXXXXXX-XXXXXXXXXX-XXXXXXXXXXXXXXXXXXXXX-XXXXXXXXXXX-XXXXXXXXXXXXXX-XXXXXXXXXXXX
