----------------------------------------------------------------------------------------------------------------------------------------------------------------------------------------------------------
----------------------------------------------------------------------------------------------------------------------------------------------------------------------------------------------------------
----------------------------------------------------------------------------------------------------------------------------------------------------------------------------------------------------------
-----SS---------------------------------SS---------------------------------------------SSSSSSSSSSSS-----------------------------------SS------------------------------------------------------------------
-----------------------------------------------------------------------------------------SS---------------------------------------------------------------------------------------------------------------
-----------------------------------------------------------------------------------------SS---------------------------------------------------------------------------------------------------------------
----------------------------------------------------------S-@----------------------S------S-------------------S----------------------------S---------o-----------------S----------------------------------
------------------------------------------------------------------------------------------S----------o--------------------------------------------------------------------------------o-------------------
--------------------------------------------------S---------------------------------------S------------------------------------------------------------g--------------------o--------------S--------------
---------------------------------S-S-----o---------------------------o-----#---------o----S-------------------------------------------------------k----------S--#--#--------------------------------------
---------#------#------T-----------------S-----------Q------!---------Q----#--------------S----#-----------------------------------#---Q------Q-S-SS---S--------#--#----------------%----S----------------
------##-#------#------T--------------------B------------------------------#-------------------#--##-----------------------#-------#----------------------------#--#-------------------------------T------
------##-#------#------T--------------t-----b-B----------------------------#--#--------------#-#--##------------------B----#-------#----------------------------#--#----K--------------------------T-B----
-ygM--##-#------#----#-T--------------t-----bgb----------------------------#--#-----------gk-#-#--##------------k----rb----#k------#-------g-g-----g------g--r--#--#---------------------K------g--T-b--F-
XXXXXXXX-XXX-XXXXXXXXXXXXX-XXX-XXXXXXXXXXX-XXXXXXXXXXXXXXX-XXXXXXXXXXXXXXXXXXXXXXXX-X-XXXXXXXXXXXXXXXXXX-XX-XXXXXXXXXXXXXXXXXXXXXX-XXXXX-XXXXXXXXXXXX-XXX-XXXXXXXXXX-XXXXXXX-XXXXXX---XX-XXXXXXXX-XXXXXXXX
XXXXXXXX-XXX-XXXXXXXXXXXXX-XXX-XXXXXXXXXXX-XXXXXXXXXXXXXXX-XXXXXXXXXXXXXXXXXXXXXXXX-X-XXXXXXXXXXXXXXXXXX-XX-XXXXXXXXXXXXXXXXXXXXXX-XXXXX-XXXXXXXXXXXX-XXX-XXXXXXXXXX-XXXXXXX-XXXXXX---XX-XXXXXXXX-XXXXXXXX
