--------------------------------------------------------------------------------------------------------------------------------------------------------------------------------
--------------------------------------------------------------------------------------------------------------------------------------------------------------------------------
--------------------------------------------------------------------------------------------------------------------------------------------------------------------------------
--------------------------------------------------------------------------------------------------------------------------------------------------------------------------------
--------------------------------------------------------------------------------------------------------------------------------------------------------------------------------
------------------------------------------------------------------------------------------------------------------------------------------------------------k-------------------
----------------------S----S-S---------------------------------------------S-----USS-----S----------------------------------------------S-------------------##--S---------------
-----------------------------------------------------------------------------------------------------------------------------------------------------------###------------------
----------------------------------------------------------#------#----------------------------------------------------------------------------------------####------------------
---------------------------------------------------------##-----##---------------------------------------------------------------------------------------#####------------------
----------------------S----S-S--------------------------###----###---------S-------------S----------------------------------------------S------------Q--######--S--------Q------
--------------#----------------------K-------K---K-----####---####--#-------------B--------------------#----K-T--------#-------------------B-----------#######----#-------------
----T---------#------------------T--------B------------####---####--#-------------b---T------B--T------#------T--------#-------------------b-----------#######----#----T----F---
-M--T---------#------------------T--------b------------####---####--#-------------B---T------b--T------#------T--------#---k---------------b-----------#######----#----T----#---
XXXXXXXXXXXXXXXXX-XXXXXXXXXXXXXXXXXXXXXXXXXXXXXXXXXXXXXXXXXXXXXXXXXXXXXXXXXXXXXXXXXXXXXXXXXXXXXXXXXXXXXXXXXXXXXXXXXXXXXXXXXXXXXX-XXXXXXXXXXXXXXXXXXXXXXXXXXXXXXXXXXXXXXXXXXXXXXX
XXXXXXXXXXXXXXXXX-XXXXXXXXXXXXXXXXXXXXXXXXXXXXXXXXXXXXXXXXXXXXXXXXXXXXXXXXXXXXXXXXXXXXXXXXXXXXXXXXXXXXXXXXXXXXXXXXXXXXXXXXXXXXXX-XXXXXXXXXXXXXXXXXXXXXXXXXXXXXXXXXXXXXXXXXXXXXXX
