-----------------------------------------------------------------------------------------------------------------------------------------------------
-----------------------------------------------------------------------------------------------------------------------------------------------------
-----------------------------------------------------------------------------------------------------------------------------------------------------
-----------------------------------------------------------------------------------------------------------------------------------------------------
-----------------------------------------------------------------------------------------------------------------------------------------------------
-----oooo-------------------------------------------------------------------------%---------------------------------------------SS-------------------
----%%%%%%----o---SS---------------------------------------SSSSSS------o------------o--S-------------------------------------------------------SS----
-----||||--o----S--------S------------------------------SS-------------SS--S-SS-----SS-----S---S------------------------------g-----------S--S-------
-----||||-%%%---------------------------------SS----SS-------------------------------------------------SS-----------------%%%%%%---------------------
-----||||--|--S-----S--------------------------------------------S----------------------SS---------------------------------||||---SSS------------S---
-----||||--|-----------------------------r----------------------------------------------------------r--------r-------------||||----------------------
-----||||-o|------------------%%%%%%%%%%%%%%%%%---%%%--------------------------------------------%%%%%%%--%%%%%%%%%%%%%%%%%||||----------------------
-----||||%%%%%-----------------|||||||||||||||-----|----------------------------------------------|||||----|||||||||||||||-||||--------------------F-
-M---||||-|||------------------|||||||||||||||-----|----------------------------------------------|||||----|||||||||||||||-||||---oo---------------#-
XXX--||||-|||--------XXX-------|||||||||||||||---%-|------------------%---------%%%%--------------|||||----|||||||||||||||-||||--%%%-XXXX---------XXX
XXX--||||-|||--------XXX-------|||||||||||||||-----|-----------------------------||---------------|||||----|||||||||||||||-||||---|--XXXX---------XXX
