------------------------------------------------------------------------------------------------------------------------------------------------------------------------------------------------------
------------------------------------------------------------------------------------------------------------------------------------------------------------------------------------------------------
------------------------------------------------------------------------------------------------------------------------------------------------------------------------------------------------------
------------------------------------------------------------------------------------------------------------------------------------------------------------------------------------------------------
------------------------------------------------------------------------------------------------------------------------------------------------------------------------------------------------------
------------------------------------------------------------------------------------------------------------------------------------------------------------------------------------------------------
------------------------------------------------------------------------------------------------------------------------------------------------------------------------------------------------------
------------------------------------------------------------------------------------------------------------------------------------------------------------------------------------------------------
------------------------------------------------------------------------------------------------------------------------------------------------------------------------------------------------------
---------------------------#--------------------------------------------------------------------------------------------------------------------------------------------------------------------------
--------------------------##--------------------------------------------------------------------------------------------------------------------------------------------------------------------------
-------------------K------##-------------------------------------------------------------------------------------------------------------------------------------------K------------------------------
-------------------------K##--------------------------------------------------------------------T--------------------------------------*------------*----------*---*--------*------*--------------F---
-M-g-----g------g---------##----g------------g--------------g---g------------------g---------gg-T----------------g--g---g---g--g----k--*-g----------*------g-g-*---*--------*---g--*-------K-kk---#---
XXXXXXXXXXX-XXXXXXXXX--XXXXXXXXXXXXXXXXXXXXXXXXXXXXXXXX-XXXXXXXXXXXXXXXXXXXXXXXX-XXXXXX-XXXXXXXXXXXXXXXXXX-XXX-XXXXXXXXXXXXXXXXXXXXXXXXXXXXXXX-XXXXXXXXXXXXXXXXXXXXXXXXXXXXXXXXXXXXXXXXXXXXXXXXXXXXXXX
XXXXXXXXXXX-XXXXXXXXX--XXXXXXXXXXXXXXXXXXXXXXXXXXXXXXXX-XXXXXXXXXXXXXXXXXXXXXXXX-XXXXXX-XXXXXXXXXXXXXXXXXX-XXX-XXXXXXXXXXXXXXXXXXXXXXXXXXXXXXX-XXXXXXXXXXXXXXXXXXXXXXXXXXXXXXXXXXXXXXXXXXXXXXXXXXXXXXX
