-----------------------------------------------------------------------------------------------------------------------------------------------------
-----------------------------------------------------------------------------------------------------------------------------------------------------
-----------------------------------------------------------------------------------------------------------------------------------------------------
-----------------------------------------------------------------------------------------------------------------------------------------------------
----------------------------------o------------------------------------------------------------------------------------------------------------------
------------SSSS-----------------%%%---------SS--------------------------------------------------------------------SSS-------------------------------
--------------------SSSS---S------|-----------------S---S--------------------------------------------------------------------------SS-----SSSSS------
----------g-----------------------|--------g---------------S-----------o-o-o-o-----------------------------------g----------------------S------------
--------%%%%----------------------|----%%%%%%-----------------------%-%%%%%%%%%------------------------------%%%%%%-------------SS-------------------
---------||-----SSS-----S---S-----|-----||||---SSSS--S---S-------------|-|-|-|--------------------------------||||----SSS----------------------S-----
---------||-----------------------|-----||||---------------------------|-|-|-|-----------------------r--------||||------------------%%%--------------
-----%%%%||-----------------------|--%%%||||---------------------------|-|-|-|---%%%%%%%%%%%%%%%%%%%%%%%%%%%%%||||---------%%%%%%----|---------------
------||-||-----------------------|---|-||||---------------------------|-|-|-|----|||||||||||||||||||||||||||-||||----------||||-----|-------------F-
-M----||-||-----oo----------------|---|-||||---oo--------------------r-|-|-|-|----|||||||||||||||||||||||||||-||||----oo----||||-----|-------------#-
XXX---||-||----%%%-------X---X-%%%%%%-|-||||--%%%-----X-----------%%%%%%%%%%%%%%%-|||||||||||||||||||||||||||-||||---%%%----||||-----|----------XXXXX
XXX---||-||-----|--------X---X--||||--|-||||---|------X------------|||||||||||||--|||||||||||||||||||||||||||-||||----|-----||||-----|----------XXXXX
