------------------------------------------------------------------------------------------------------------------------------------------------------------------------------------------------------------------------------
------------------------------------------------------------------------------------------------------------------------------------------------------------------------------------------------------------------------------
------------------------------------------------------------------------------------------------------------------------------------------------------------------------------------------------------------------------------
------------------------------------------------------------------------------------------------------------------------------------------------------------------------------------------------------------------------------
------------------------------------------------------------------------------------------------------------------------------------------------------------------------------------------------------------------------------
------------------------------------------------------------------------------------------------------------------------------------------------------------------------------------------------------------------------------
--------------------------------------Q---------------------------Q---------------Q------------------------------------------------------Q----------------Q-----------------------------------Q------------Q-----Q------------
-------------------------------o------------o---------oo-----------------------------o-------o---------------------------------------------------------------------------------------------------o----o--------o--------o-----
------------------------------------------------------------------------------------------------------------------------------------------------------------------------------------------------------------------------------
------------------------------------------------------------------------------------------------------------------------------------------------------------------------------------------------------------------------------
--------------------------------------Q------------------T--T---T-Q-----C----o----?------------Q---------Q-------C---T---C---T-----------Q--------T-------Q--------------Q-----C--------------?---------Q--?-----?------------
----------------------------------#----------------------T--T---T----------------------#-----------------------------T-------T--------------------T-#---------------------------------------------------------------#---------
-----------------------T----------#----------------------T--T---T----T-----------------#-----------------------------T-------T-----------------T--T-#---------------------------------------------------------------#-----F---
-M---------------------T----------#----------------------T--T---T----T-----------------#-----------------------------T-------T-----------------T--T-#---------------------------------------------------------------#-----#---
XXXXXXXXXX-XXX-XXXXXXXXXXXXXXXXXXXXXXXXXXXXXXXXXXXXXXXXXXXXXXXXXXXXXXXXXXX-XXXXXXXXXXXXXXXXXXXXXXX-XXXXXXXXXXX--XXXXXXX-XXXXXXXXX-XXXXXXXXXXXXXXXXXXXXXXXXXXXXXX-XXXX--XXXXXXXXXXXXXXXXX-XXXXXXXXXXXXXXXXXXXXXXXXXXXXXXXXXXXXX
XXXXXXXXXX-XXX-XXXXXXXXXXXXXXXXXXXXXXXXXXXXXXXXXXXXXXXXXXXXXXXXXXXXXXXXXXX-XXXXXXXXXXXXXXXXXXXXXXX-XXXXXXXXXXX--XXXXXXX-XXXXXXXXX-XXXXXXXXXXXXXXXXXXXXXXXXXXXXXX-XXXX--XXXXXXXXXXXXXXXXX-XXXXXXXXXXXXXXXXXXXXXXXXXXXXXXXXXXXXX
