----------------------------------------------------------------------------------------------------------------------------------------------------------------------------------------
----------------------------------------------------------------------------------------------------------------------------------------------------------------------------------------
----------------------------------------------------------------------------------------------------------------------------------------------------------------------------------------
----------------------------------------------------------------------------------------------------------------------------------------------------------------------------------------
----------------------------------------------------------------------------------------------------------------------------------------------------------------------------------------
----------------------------------------------------------------------------------------------------------------------------------------------------------------------------------------
-------------------------------#---------#-------------------------------------#------------------------#-------------------------------------------------------------#-----------------
-------------------------------#---------#-------------------------------------#------------------------#------------------------------------------y------------------#-----------------
-------------------------------#---------#-------------------------------------#---------------------y--#----------------------------------------#SS--o---------------#-----------------
-------------------------------#---------#-------------------------------------#---------------------XS-#---------------------------------------##--------------------#-----------------
-------------------------------#---------#-------SSC-------Q-------------------#---------o--o-------XX--#-----------------o---------------------##--SC----o---------#-#-----------------
-------------------------------#---------#---------------------#---------------#-T-----------------XXX--#-------TT------------------------------##----------------y##-#-----------------
-------------------------------#---------#--------------------##---------------#-T----------------XXXX--#-------TT------------------------------##---SSS----------###-#-------------F---
----M--------------------------#---------#-------------------------------------#-T-------------y-XXXXX--#-------TT-----------------y-------y----##---------------####-#-------------#---
XXXXXX-XXXXXXX-XXXXXXX-XXXXXXX-XX-XX-XXX-XXXX-XX-XXXXXXXXXXXXXXXXX---XXXXXX-XX-XXXXXXX--XXXXXXXXXXXXXX--XXXXXXXXXXXXXX--XXXXX-XXXXXXXXXXXXXXXXXXXX------XXXXXXXXXXXXX-XXXXXXXXXXX--XXXXX
XXXXXX-XXXXXXX-XXXXXXX-XXXXXXX-XX-XX-XXX-XXXX-XX-XXXXXXXXXXXXXXXXX---XXXXXX-XX-XXXXXXX--XXXXXXXXXXXXXX--XXXXXXXXXXXXXX--XXXXX-XXXXXXXXXXXXXXXXXXXX------XXXXXXXXXXXXX-XXXXXXXXXXX--XXXXX
