-----------------------------------------------------------------------------------------------------------------------------------------------------------------------------------------------------
-----------------------------------------------------------------------------------------------------------------------------------------------------------------------------------------------------
-----------------------------------------------------------------------------------------------------------------------------------------------------------------------------------------------------
-----------------------------------------------------------------------------------------------------------------------------------------------------------------------------------------------------
-------------------------------------------------------------X---------------------------------------------------------------------------------------------------------------------------------------
-------------------------------------------------------------X---------------------------------------------------------------------------------------------------------------------------------------
------------------------S--------------S----QQ---------------X-USS-----------------QQ---S-------------QQ--------------S--QQ------------SS---S--------------S---------------S-S---QQ----S-------------
-------------------------------------------------------------X---------------------------------------------------------------------------------------------------------------------------------------
-------------------------------------------------------------X-------------------------------------------------------------------------------------------------g-------------------------------------
-------------------T-----------------------------------------X-----T----T------------------------------------------------------------------------T-------------#-------------------------------------
------------T------T----------------T-------?Q---------------X-----T----T--------T-?Q-------T--#----C-?Q------T--S-------?Q--------------------T-T------------##---------S-------?Q-----------T------
------------T------T----------------T------------T------#----X--t--T----T------#-T----------T--#--------------T----g---------------------------T-T----T-------##------------------------------T------
----------K-T------T----------------T------------T------#----X--t--T----T------#-T----------T--##-------------T----TT--------------------------T-T----T-------##------------------------------T--F---
--M---------T------T--g--------g----T-----g------T------#----X--t--T----T------#-T----------T--##--gg---------T----TT--------------------------T-T----T--g----##-------g----------------------T--X---
XXXXXXXXXXXXXX-XXXXXXXXXXXXXXXXXXXXXXXX-XXXXXXXXXXXXXXX-XXX-XXXXXXXXXXXXXXXXXX-XXXXXXXXX-XXXXXXXXXXXXXXXXXXXXXXXXXXXXXXXXXXXXXXXX-XXXXXXXXXXXXXXXXXXXXXXXXXXXXXXXXXXX-XXXXXXX-XXXXXXX-XXXXXXXXXXXXXXX
XXXXXXXXXXXXXX-XXXXXXXXXXXXXXXXXXXXXXXX-XXXXXXXXXXXXXXX-XXX-XXXXXXXXXXXXXXXXXX-XXXXXXXXX-XXXXXXXXXXXXXXXXXXXXXXXXXXXXXXXXXXXXXXXX-XXXXXXXXXXXXXXXXXXXXXXXXXXXXXXXXXXX-XXXXXXX-XXXXXXX-XXXXXXXXXXXXXXX
