----------------------------------------------------------------------------------------------------------------------------------------------------------------------------------------------------
----------------------------------------------------------------------------------------------------------------------------------------------------------------------------------------------------
----------------------------------------------------------------------------------------------------------------------------------------------------------------------------------------------------
----------------------------------------------------------------------------------------------------------------------------------------------------------------------------------------------------
----------------------------------------------------------------------------------------------------------------------------------------------------------------------------------------------------
------------------------------------------------k-------k-------------------------------------------------------------------------------------------------------------------------------------------
---------------------S---------S-------S-------##------##------S------------------------------------------S--------------------------------------------------S-S-S----------------------------------
----------------------------------------------###-----###-------------------------------------------------------------------------------------------------------------------------------------------
---------------------------------------------####----####-------------------------------------------------------------------------------------------------------------------------------------------
---------------------------------------------####----####---------------------------Q---------------------------------------------------------------------------------------------------------------
-------------------T-S---------S-------S-----####----####------S-----T-----------S------------------------S--------------------------S-----------S-T----Q----S-S-S-------------Q---------Q----------
-------------------T------------------------#####-T-#####------------T----------------------------------------------------T------------------------T-------T------------T--------------------T------
-------------------T-----------------T------#####-T-#####------------T----------------------------------------------------T------------------------T-------T------------T--------------------T---F--
-M----------k------T-g---------------T-g----#####-T-#####------------T---g---------------------g-g-----------------------gT-g-----------k--------K-T------gT------------T------------------g-T---#--
XXXXXXXXXXXXXXXXXXXXXXXXXXXXXXXXXX-XXXXXXXXXXXXXXXXXXXXXXXXXXXXXXXXXXXXXXXXXX-XXXXXXXXXXXX--XXXXXXXXXXXXXXXX-XXXXXXXXXXXXXXXXXXXXXXXXXXXXXXXXXXXXXXXXXXXXXXXXXXXXXXXXXXXXXXXXXXXXXXX-XXXXXXXXXX-XXXX
XXXXXXXXXXXXXXXXXXXXXXXXXXXXXXXXXX-XXXXXXXXXXXXXXXXXXXXXXXXXXXXXXXXXXXXXXXXXX-XXXXXXXXXXXX--XXXXXXXXXXXXXXXX-XXXXXXXXXXXXXXXXXXXXXXXXXXXXXXXXXXXXXXXXXXXXXXXXXXXXXXXXXXXXXXXXXXXXXXX-XXXXXXXXXX-XXXX
