----------------------------------------------------------------------------------------------------------------------------------------------------------------------------------------------------------
----------------------------------------------------------------------------------------------------------------------------------------------------------------------------------------------------------
----------------------------------------------------------------------------------------------------------------------------------------------------------------------------------------------------------
----------------------------------------------------------------------------------------------------------------------------------------------------------------------------------------------------------
----------------------------------------------------------------------------------------------------------------------------------------------------------------------------------------------------------
----------------------------------------------------------------------------------------------------------------------------------------------------------------------------------------------------------
----------@-S----------------------------S--S-----------------------S--S-----------S-------------S---------S-----------------------S------------S-SS--------------------------S---------------------------
----------------------------------------------------------------------------------------------------------------------------------------------------------------------------------------------------------
----------------------------------------------------------------------------------------------------------------------------------------------------------------------------------------------------------
----------------------------------------------------------------------------------------------------------------------------------------------------------------------------------------------------------
-#--------!-------------------#---SS--------------------!-------SS--------------!-------------t----------t---S-------S--S----##---------------------------!----------------------#----------S--S----------
-#------t---------------------#---------------------------------------------------------t-----t----------t-------------------##-------t------------------------------------------#------------------------
-#------t---------------------#-------------------------------t-------------------------t-----t----------t-------------------##-------t------t--------#--------------------------#--------------------F---
-#-M--g-t--------g-#--g--#----#-----------------------g-------t----g--------------------t-#---t----------t-------------------##-------t------t#------###-------g----#----------g-#---g--------------#-#---
XXXXXXXXXXXXXXXXXXXXXXXXXXXXXXXXXXXXX-XXXXXXXXXXXXXXXXXXXXXXXXXXXXXXXXXXXXXXXXXXXXXXXXXXXXXX-XXXXXXXXXXXXXXXXXXXXXXXXXXXXXXX-XXXXXXXXXXXXX--XXXXXXXXXXXXXXXXX-XXXXXXXXXX-XXXXXXXXXXXXXXXX-XXXXXXXXXXXXXXXX
XXXXXXXXXXXXXXXXXXXXXXXXXXXXXXXXXXXXX-XXXXXXXXXXXXXXXXXXXXXXXXXXXXXXXXXXXXXXXXXXXXXXXXXXXXXX-XXXXXXXXXXXXXXXXXXXXXXXXXXXXXXX-XXXXXXXXXXXXX--XXXXXXXXXXXXXXXXX-XXXXXXXXXX-XXXXXXXXXXXXXXXX-XXXXXXXXXXXXXXXX
