-------------------------------------------------------------------------------------------------------------------------------------------------------------------------------------------------------------------------------------------------------------------------------------------------------------------------------------------------------------------------------------
-------------------------------------------------------------------------------------------------------------------------------------------------------------------------------------------------------------------------------------------------------------------------------------------------------------------------------------------------------------------------------------
-------------------------------------------------------------------------------------------------------------------------------------------------------------------------------------------------------------------------------------------------------------------------------------------------------------------------------------------------------------------------------------
-------------------------------------------------------------------------------------------------------------------------------------------------------------------------------------------------------------------------------------------------------------------------------------------------------------------------------------------------------------------------------------
-------------------------------------------------------------------------------------------------------------------------------------------------------------------------------------------------------------------------------------------------------------------------------------------------------------------------------------------------------------------------------------
------------------------------------------------------------------------------------------------------------------------ooo-------------------------------------------------------------------------------------------------------------------------o--------------------------------------------------------------------------------------------------------------------------------
-------------------------------------------------------------------------------------------------------------------------------------------------------------------------------------------------------------------------------------------------------------------------------------------------------------------------------------------------------------------------------------
-------------------------------------------------------------------------------------------------------------------------------------------------------------------------------------------------------------------------------------------------------------------------------------------------------------------------------------------------------------------------------------
-------------------------------------------------------------------------------------------------------------------------------------------------------------------------------------------------------------------------------------------------------------------------------------------------------------------------------------------------------------------------------------
---S----------S---------------------oo------S--------------------S-----------------------------------------------------------S--------------1------------------------------------------------------------------------------------------------------------S----------------o---o---------------------------------------S--t-------------------------S------------------------S--------
----------------------------------------#---------------------------------------------------------------------------------------------------------------------T------------#----------------------------------------------------------------T-------------------------------#---#-----#---T------------------------------t-----T-----------------------------------------------------
----------------------------------------#-------------------------------------------T------------------------------T------------------------------------------T--------T---#---------------T-----------T-T----------------------------------T-------------------------------#---#-----#---T------------------------------t-----T-----------------------------------------------T-----
----------#-----------------------------#-------------------------------------------T--#---------------------T-----T---------------------T--------------------T--------T---#---------------T-----#-----T-T----------------------------------T----------------------t--------#---#-----#---T-------------#----------------t-----T-----------------------------------------------T-F---
-M--------#-----k-------------gg-g--k---#------------------k--k----k----------g---k-T-k#-----------------g---T---g-T----gggg----k--------T---k--------k----g--T-g------T---#----k--g----k--T-----#-----T-T-g---------g---g---g-------k------T-------gg-------------t--------#---#--k--#---T--------g---k#-g----k--g-k----t-----T-----k-----g------------k--gg-g---------g-k----T-#---
XXXXX--XXXXXXXXXXXXX-XXXXXXXXXXXXXXXXXXXXXXXXXXXXX-XX-XXXXXXXXXXXXXXXXXX--XXXXXXXXXXXXXXXXXXXXXXX-XXXXXXXXXXXXXXXXXX-XXXXXXXXXXXXXXXXXXXXXXXXXXX-XXXXXXX--XXXXXXXXXXXXXXX-XXXXXXXXXXXXXXXXXXXXX--XXX-XXXXXXXX--XX-XXXXXXXXXXXXXXXXX-XXXXXXXXXXXX-XXXXXXXXXXX-XXXX-XXXX-XXXXXXXXXXXXXX-X--XXXXX-XXXXXXXXXXXXXXXXXXXXXXXXX-XXXXXXX-XXXXXX--XXXXXXXXXXXXXXXXXXXXXXXXXXXXXXXXXXXXXXXXXXXX
XXXXX--XXXXXXXXXXXXX-XXXXXXXXXXXXXXXXXXXXXXXXXXXXX-XX-XXXXXXXXXXXXXXXXXX--XXXXXXXXXXXXXXXXXXXXXXX-XXXXXXXXXXXXXXXXXX-XXXXXXXXXXXXXXXXXXXXXXXXXXX-XXXXXXX--XXXXXXXXXXXXXXX-XXXXXXXXXXXXXXXXXXXXX--XXX-XXXXXXXX--XX-XXXXXXXXXXXXXXXXX-XXXXXXXXXXXX-XXXXXXXXXXX-XXXX-XXXX-XXXXXXXXXXXXXX-X--XXXXX-XXXXXXXXXXXXXXXXXXXXXXXXX-XXXXXXX-XXXXXX--XXXXXXXXXXXXXXXXXXXXXXXXXXXXXXXXXXXXXXXXXXXX
