----------------------------------------------------------------------------------------------------------------------------------------------------------------------------------------------------------------------
----------------------------------------------------------------------------------------------------------------------------------------------------------------------------------------------------------------------
----------------------------------------------------------------------------------------------------------------------------------------------------------------------------------------------------------------------
----------------------------------------------------------------------------------------------------------------------------------------------------------------------------------------------------------------------
----------------------------------------------------------------------------------------------------------------------------------------------------------------------------------------------------------------------
----------------------------------------------------------------------------------------------------------------------------------------------------------------------------------------------------------------------
------------S-----S-S---S---S-------S-----------------------------------S---S--S------------S-S----------------------US---------------------------------S-S--------S--SSSS--------------S---------S------------US-----
-----------------------------------------------------------------------------------------------------TT------------------------------------------------------TT-------------------------------------------------------
----------T-----------------------T------------------------------------------------------------------TT------------------------------------------------------TT-------------------T-----------------------------------
----------T-----------------------T-----------------------------------T------------------------------TT-----------T-S----------------------------------------TT-------------------T---------------------------S-------
-------S--T-------------S---S-----T-S-S------TT--------T--S-T-SS------T-----S--S-----T-T-----------t-XX---S-------T---------------------t---------------S----XX-------------------T-----S------T----------T-----------
----------T-----------------------T----------TT--------T----T---------T---T----------T-T-----------t--------------T---------------------t-------------T---------------------------T-----------TT----------T-----------
----------T-----------t-----------T-------T--TT--------T----T-------#-T---T--------T-T-T-----------t--------------T------------T--------t-T-----------T----------------------#----T-T---------TT----------T-T------F--
---M------T-----------t-----------T-------T--TT--------T----T----k-##-T---T--------T-T-T-----------t-k------------T-----k------T--k-----t-T---k-------T------k--------------##----T-T-------k-TT----------T-T------#--
XXXXXXXXXXXXXXXXXXXXXXXXXXXXXXXXXXXXXXXXXXXXXXXX-XXXXXXXXXXXXXXXXXXXXXXXXXXXXXXXXXXXXXXXXXXXXXXXXXXXXXXXXXXXXX-XXXXXXX-XXXXXXXXXXXXXXXXXXXXXXXXX-XXXXXXXXXXXXXXXXXXXXXXXXXXXXXX-XXXXXXXXXXXXXXXXXXXX-XXXXXXXXXXX-XXXXX
XXXXXXXXXXXXXXXXXXXXXXXXXXXXXXXXXXXXXXXXXXXXXXXX-XXXXXXXXXXXXXXXXXXXXXXXXXXXXXXXXXXXXXXXXXXXXXXXXXXXXXXXXXXXXX-XXXXXXX-XXXXXXXXXXXXXXXXXXXXXXXXX-XXXXXXXXXXXXXXXXXXXXXXXXXXXXXX-XXXXXXXXXXXXXXXXXXXX-XXXXXXXXXXX-XXXXX
