----------------------------------------------------------------------------------------------------------------------------------------------------------------------------------------------------
----------------------------------------------------------------------------------------------------------------------------------------------------------------------------------------------------
----------------------------------------------------------------------------------------------------------------------------------------------------------------------------------------------------
----------------------------------------------------------------------------------------------------------------------------------------------------------------------------------------------------
----------------------------------------------------------------------------------------------------------------------------------------------------------------------------------------------------
----------------------------------------------------------------------------------------------------------------------------------------------------------------------------------------------------
----------------S-----S----------------------S---S--------------SS-------------------S------------------SSC---------------------USSS-----S?S----------------S-----S--------------------------S------
----------------------------------------------------------------------------------------------------------------------------------------------------------------------------------------------------
----------------------------------------------------------------------------------------------------------------------------------------------------------------------------------------------------
--------------------------------------------------------------------------------------------------------SSS----------------------------Q------------------------------------------------------------
----------SCS---S-----S-T--------------------S-T-S------T--S----SS---------T---T---S-S----------------------S--S---------------#---------SSS---------S--T---S---S-S------------SS------------S------
------------K-----T-----T----------------------T--------T------------------T---T-----------------------------------------------#------------------T-----T------------T-------T--K-------------------
------------------T-----T----------------------T--------T------------------T---T-----------------------------------------------##-----------------T-----T------------T-----T-T-------------------F--
-M--------K-----g-T---g-T--------g-------------T-g-----gT--K------------g--T---T----------------------------K------------------##---g-------------T-----T---g--------T-----T-T----g-------g------#--
XXXXXXXXXXXXXXXXXXXXXXXXXXXXXXX-XXXX-XX--XXXXXXXXXXXXXXXXXXXXXXXXXX-XXXXXXXXXXXXXXXXXXXXXXXXXXX-XXXX-XX----XXXXXXXXXXXXXXXXXXX-XXXXXXXXXXXXXXXX--XXXXXXXXXXXXX-XXXXXXXXX-XXXXXXXXXXXXXXXXXXXXXXXXXXX
XXXXXXXXXXXXXXXXXXXXXXXXXXXXXXX-XXXX-XX--XXXXXXXXXXXXXXXXXXXXXXXXXX-XXXXXXXXXXXXXXXXXXXXXXXXXXX-XXXX-XX----XXXXXXXXXXXXXXXXXXX-XXXXXXXXXXXXXXXX--XXXXXXXXXXXXX-XXXXXXXXX-XXXXXXXXXXXXXXXXXXXXXXXXXXX
