------------------------------------------------------------------------------------------------------------------------------------------------------
------------------------------------------------------------------------------------------------------------------------------------------------------
------------------------------------------------------------------------------------------------------------------------------------------------------
------------------------------------------------------------------------------------------------------------------------------------------------------
------------------------------------------------------------------------------------------------------------------------------------------------------
------------------------------------------------------------------------------------------------------------------------------------------------------
------------------------------------------------------------------------------------------####--------------------------------------------------------
---------------------------------------%-----------------%--------oo-----------------%----####--%-----------------------------------------------------
-------------%---------------------------------------------------------------------------#####-----------------------------------------------%--------
-----------------------------------------------------------------------------------------#####--------------------------------------------------------
------%%%%%%------------------------------------%---------------------------------------######---------------------------------------%----------------
-------||||-----------------------------------------------------------------------------######--------------------------------------------------------
-------||||-----------------------------------------------------------------------------######-----------------------------------------------------F--
--M----||||---------------------%----------------%-----------------------%--------------######----------------------------------------%--------%---#--
XXXX---||||---------XXX---X-X-------XX----XX-XX-----XXXX---X-X-XX-%%%%-----X----XX-----XXXXXXXX----%--XX-XX-XX----X-XXXXXXXXXXXXXXX-------XX-----XXXXX
XXXX---||||---------XXX---X-X-------XX----XX-XX-----XXXX---X-X-XX--||------X----XX-----XXXXXXXX-------XX-XX-XX----X-XXXXXXXXXXXXXXX-------XX-----XXXXX
