------------------------------------------------------------------------------------------------------------------------------------------------------------------------------------------------------
------------------------------------------------------------------------------------------------------------------------------------------------------------------------------------------------------
------------------------------------------------------------------------------------------------------------------------------------------------------------------------------------------------------
------------------------------------------------------------------------------------------------------------------------------------------------------------------------------------------------------
------------------------------------------------------------------------------------------------------------------------------------------------------------------------------------------------------
------------------------------------------------------------------------------------------------------------------------------------------------------------------------------------------------------
------------------------------------------------------------------------------------------------------#------------------------#----------------------------------------------------------------------
------------------------------------------------------------------------------------------------------#------------------------#----------------------------------------------------------------------
------------------------------------------------------------------------------------------------------#------------------------#---------------------------------------------------T------------------
----------------------#-------------------------------------------------------------------------------#------------------------#---------------------------------------------------T------------------
---------------------##-------------------------------------------------------------------------------#------------------------#---------------------------------------------------#------------------
---------------------##-------------------------------------------------------------------------------#------------------------#----------------------------------------------------------------------
--------------------K##-----------*-------------------T-T------*------------------*-----------------------------------------------------------*---------------------------------*---------*-------F---
-M-g---------gg------##-----g-----*--------g----------T-T------*----------------k-*--g------g--gg--g--------------g---g----g--------------gg--*--------gg--------g----K------k--*---------*---gg--#---
XXXXXXXXXXXXXXXXX-XXXXXXXXXXXXXXXXXXXXXXXXXXXXXXX-XXXXXXXXXXXXXXXXXXXXXXXXXXXXXXXXXXXXXX-XXXXXXXXXXXXXXXXXXXXXXXXXXXXXXXXXXXXXXXX-XXXX-XXXXXXXXXXXXXXXXXXXXXXX-XXXXXXXXXXXXXXXXXXXXXXXXXXXXXXXXXXXXXXX
XXXXXXXXXXXXXXXXX-XXXXXXXXXXXXXXXXXXXXXXXXXXXXXXX-XXXXXXXXXXXXXXXXXXXXXXXXXXXXXXXXXXXXXX-XXXXXXXXXXXXXXXXXXXXXXXXXXXXXXXXXXXXXXXX-XXXX-XXXXXXXXXXXXXXXXXXXXXXX-XXXXXXXXXXXXXXXXXXXXXXXXXXXXXXXXXXXXXXX
