----------------------------------------------------------------------------------------------------------------------------------------------------------------------------------------------------
----------------------------------------------------------------------------------------------------------------------------------------------------------------------------------------------------
----------------------------------------------------------------------------------------------------------------------------------------------------------------------------------------------------
----------------------------------------------------------------------------------------------------------------------------------------------------------------------------------------------------
----------------------------------------------------------------------------------------------------------------------------------------------------------------------------------------------------
----------------------------------------------------------------------------------------------------------------------------------------------------------------------------------------------------
-----S-----------S--------S----------S?SS----------------S----------------S---------------S-S------------------------S--------------S------------SQS------------SC-S---S-----------------S----------
----------------------------------------------------------------------------------------------------------------------------------------------------------------------------------------------------
----------------------------------------------------------------------------------------------------------------------------------------------------------------------------------------------------
-----------------------------------------------------------------------Q--------------------------------------------------------------------------K-------------SS----------------------------------
-----S--Q--S--T--S--------S-----#----SSSS-------T--------S----T-----------S-----------T---S-S----S------SS-----------S-S------------S----T-------SSS---------------S-S-S-------T---------S----------
--------------T------T---------##---------------T-------------T---T-------------------T------------------K----------------------T--------T-------------------------------------T-------------TT-----
--------------T------T---------##---------------T-------------T---T-------------------T-----------------------------------------T--------T-------------------------------------T----T--------TT--F--
-M------------T------T---------##---------------T--------g----T-g-T----------g--------T-----g-k--K-g---------------g---K--------T--------T---------------------------------k---T----T-gg----gTT--#--
XXXXXXXXXXXXXXXXXXXXXXXXXXXXXXXXX-XXXXXXXXX-XXXXXXXXXX-XXXXXXXXXXXXX-XXXXXXXXXXXXXX-XXXXXXXXXXXXXXXXX-XXXXXXXXXXXXXXXXXXXXXXXX-XXXXXXX-XXXXXXXXXXXXXXXXXXX--XXX---XXXXXXXXXXXXXXXXXXXXXXXXXXXXXXXXXX
XXXXXXXXXXXXXXXXXXXXXXXXXXXXXXXXX-XXXXXXXXX-XXXXXXXXXX-XXXXXXXXXXXXX-XXXXXXXXXXXXXX-XXXXXXXXXXXXXXXXX-XXXXXXXXXXXXXXXXXXXXXXXX-XXXXXXX-XXXXXXXXXXXXXXXXXXX--XXX---XXXXXXXXXXXXXXXXXXXXXXXXXXXXXXXXXX
