-----------------------------------------------------------------------------------------------------------------------------------------------------
-----------------------------------------------------------------------------------------------------------------------------------------------------
-----------------------------------------------------------------------------------------------------------------------------------------------------
-----------------------------------------------------------------------------------------------------------------------------------------------------
----------------------------------------------------o-o-o--------------------------------------------------------------------------------------------
--------------------------%------------------------%%%%%%%-------------------------------------------------------------------------------------------
-----------------o----------------------------------|-|-|----------------------------------------------------------------------------SS--------------
-----------------SS---------------------o-----------|-|-|------o-------o-----o--------------------------SS-S-----------------------------------------
---------------------------------SS----%%%-%-%-%-%--|-|-|-----%%%-%-%-%%%-%-%%%---%-%-%-%-%-----%----SS-------------------------SS-------------------
----------------------------------------|-----------|-|-|------|-------|-----|---------------------------------------------------------S-------------
-------------------------------r--------|-----------|-|-|------|-------|-----|-----------------------------------------r-----------------------------
----------------------------%%%%%%------|-----------|-|-|------|-------|-----|---------------------%%%-----------%%%%%%%%%%%%%%%%--------------------
-----------------------------||||-------|-----------|-|-|------|-------|-----|----------------------|-------------||||||||||||||-------------------F-
-M---------------------------||||-------|-r-r-r-----|-|-|------|---r-r-|-r-r-|-------r---r----------|-------------||||||||||||||-------------------#-
XXXXXXXXXXX---%%%-------%%%%-||||------%%%%%%%%%%%%%%%%%%%%%%%%%%%%%%%%%%%%%%%%%%%%%%%%%%%%%%%%%%%%-|-----------%-||||||||||||||--------XXXXXXXXXXXXX
XXXXXXXXXXX----|---------||--||||-------||||||||||||||||||-|-|||||||||||||||||||-|||||||||||-|-|||--|-------------||||||||||||||--------XXXXXXXXXXXXX
