--------------------------------------------------------------------------------------------------------------------------------------------------------------
--------------------------------------------------------------------------------------------------------------------------------------------------------------
--------------------------------------------------------------------------------------------------------------------------------------------------------------
S----SSSSSSSSSSSSSSSSLSSSSSSSSSSSSSSSSSSSSSSSSSSSSSSSSSSSSSSSSLSSSSSSSSSSSSSSSSSSSSSSSSSSSSSSSSSSSSSSSSSSSSSSSSSSSSSSSSSSSSSSSSSSLSSSSSSSSSSS--SSLSSSSSSSS----
S------------------------------------------------------SSSS-----------------------------------------------------------------------------SS--------------------
S------------------------------------------------------SSSS-----------------------------------------------------------------------------SS--------------------
S-------------------oo-----------------------------------SS--oo-----------------------------------------------------------------oo--------------oo------------
S--------------------------------------------------------SS---------------------------------------------------------------------------------------------------
S-------------------SS--------------------S-U------------SS--SS-----------------------------------------------------------------SS--------------SS------------
S-------------------SS--------------------SoS----------ooSS--SS-----------------------------------------------------------------SS------oU------SS------------
S--------T--------------------------------SSS-#--------SSSS--------------------------------------@Q-#-------------##--------------------SS--#------------#----
S--------T-------------------------S----------#---T-------------------------------------#-----------#--------T----##-#----------------------#---------#--#----
S--------T---------------#---------S----------#-g-T--g------------------#---------------#-----------#--------T----##-#-------------#--------#---------#--#----
S--M-----T---------------#---g-----S----------#-#-T--#----g-------------#---------------#----g------#-g-g----T----##-#----g---g----#--------#---------#--#--F-
XXXXXXXXXXX-XXXX-X-XXXXXXXXXXXXXXX-X-XXX-XXXXXXXXXXXXXXXXXXXXXXXXXXXXXXXXXXXX-XXXXXX-X-XXXXXXXXXXXXXXXXXXXXXXXXXXXXXXXXXXXXXXXXXXXXXXX-XXXXXX-XXXXXXXXXXXX-XXX
XXXXXXXXXXX-XXXX-X-XXXXXXXXXXXXXXX-X-XXX-XXXXXXXXXXXXXXXXXXXXXXXXXXXXXXXXXXXX-XXXXXX-X-XXXXXXXXXXXXXXXXXXXXXXXXXXXXXXXXXXXXXXXXXXXXXXX-XXXXXX-XXXXXXXXXXXX-XXX
