--------------------------------------------------------------------------------------------------------------------------------------------------------------------------------
--------------------------------------------------------------------------------------------------------------------------------------------------------------------------------
--------------------------------------------------------------------------------------------------------------------------------------------------------------------------------
--------------------------------------------------------------------------------------------------------------------------------------------------------------------------------
--------------------------------------------------------------------------------------------------------------------------------------------------------------------------------
--------------------------------------------------------------------------------------------------------------------------------------------------------------------------------
--------------------S-------------------------------------------------------------------------USS-------------------------------S-------------S---------------------------------
--------------------------------------------------------------------------------------------------------------------------------------------------------------------------------
--------------------------B-----------B----------------#----------------------------------------------#--------------------------------------------#----------------------------
--------------------------b-----------b---------------##---------------------------------------------##-------------------------------------------##----------------------------
--------------------S----S#CS--------S#CS------------###---------------------------Q--Q-------------###-------------------------S-------------S--###---------------------Q------
--------T---------------------T---------------K--K--####--------K------------------------------B---####-----------------------------------------####----#-B-T-------------------
--------T-------------B-----K-T---------K-----------####-----B----------B----------------------b---####-----------B-------B-B-----B-------B-----####----#-b-T---------------F---
-M------T-------------b-------T---------------------####-----b----------b----------------------B---####-----------b-------b-b-----b-------b-----####----#-B-T---------------#---
XXXXXXXXXXXXXXXXXXXXXXXXXXXXXXXXXXXXXXXXXXXX-XXXXXXXXXXXXXXXXXXXXXXXXXXXXXXXXXXXXXXXXXXXXXXXXXXXXXXXXXXXXXXXXXXXXXXXXXXXXXXXXXXXXXXXXXXXXXXXXXXXXXXXXXXXXXXXXXXXXXXX-XXXXXXXXXXX
XXXXXXXXXXXXXXXXXXXXXXXXXXXXXXXXXXXXXXXXXXXX-XXXXXXXXXXXXXXXXXXXXXXXXXXXXXXXXXXXXXXXXXXXXXXXXXXXXXXXXXXXXXXXXXXXXXXXXXXXXXXXXXXXXXXXXXXXXXXXXXXXXXXXXXXXXXXXXXXXXXXX-XXXXXXXXXXX
