------------------------------------------------------------------------------------------------------------------------------------------------------------------------------------------------------------------------------
------------------------------------------------------------------------------------------------------------------------------------------------------------------------------------------------------------------------------
------------------------------------------------------------------------------------------------------------------------------------------------------------------------------------------------------------------------------
------------------------------------------------------------------------------------------------------------------------------------------------------------------------------------------------------------------------------
------------------------------------------------------------------------------------------------------------------------------------------------------------------------------------------------------------------------------
----------------------------------------------------------------------------------------------------------------------------------------------------------y-------------------------------------------------------------------
------------------------------------------Q---------------------------------------------------------------------------------------------------------------##---------Q--------------------------------------------------------
-------------------------o----------------------o-----o-------o-----------------o-----------------------o--------------o------o-------------------------y###-o---------------------------o-----------------------------o------
--------------------------------------------------------------------------------------------------------------------------------------------------------####------------------------------------------------------------------
-------------------------------------------------------------------------------------------------------------------------------------------------------#####------------------------------------------------------------------
-------o------------Q----------T---Q-Q----Q-----------------------------------------Q-----------------Q----------------------------Q-T-------Q----T---######---------?-------------o-T----------------Q-----------------------
-------------------------------T-------------------------------------------#-------------------------------#-------------------------T-----T------T--#######-------------------------T------------------#--#------------------
---------------TT--------------T--------T----------------------------------#-------------------------------#-------------------------T-----T------T--#######-------------------------T------------------#--#--------------F---
-M-------------TT-----y--------T--------T----y----------y---y--------------#------------------y-y----------#-------------------------T-----T------T--#######-------------------------T------y-----------#--#--------------#---
XXXXXXXXXXXXXXXXXXXXXXXXXXXX-XXXXXXXXXXXXXXXXXXXXX-XXXXXXXXXXXXXXXXXXXXXX-XXXXXXXXXXXXXXXXX-XXXXXXXXXXXXXXXXXXXXXX-XXXXXXXXXXXXXXXXXXXXXXXXXXXXXXXXXXXXXXXXXXXXXXXXXXXXXXXX-XXXXXXXXXXX-XXXXXXXXXXXXXXXXXXXXXX-XXX-XXXXXXXXXXX
XXXXXXXXXXXXXXXXXXXXXXXXXXXX-XXXXXXXXXXXXXXXXXXXXX-XXXXXXXXXXXXXXXXXXXXXX-XXXXXXXXXXXXXXXXX-XXXXXXXXXXXXXXXXXXXXXX-XXXXXXXXXXXXXXXXXXXXXXXXXXXXXXXXXXXXXXXXXXXXXXXXXXXXXXXX-XXXXXXXXXXX-XXXXXXXXXXXXXXXXXXXXXX-XXX-XXXXXXXXXXX
