-----------------------------------------------------------------------------------------------------------------------------------------------------------------------------------------------------
-----------------------------------------------------------------------------------------------------------------------------------------------------------------------------------------------------
-----------------------------------------------------------------------------------------------------------------------------------------------------------------------------------------------------
-----------------------------------------------------------------------------------------------------------------------------------------------------------------------------------------------------
--------------------------------------------------X--------------------------------------------------------------------------------------------------------------------------------------------------
--------------------------------------------------X--------------------------------------------------------------------------------------------------------------------------------------------------
--------------------------S---------S------S------X------------------------------S---S----S--QQ-S----------------------S----------------C---------------------S---S----------------------------------
--------------------------------------------------X--------------------------------------------------------------------------------------------------------------------------------------------------
--------------------------------------------------X------------------------------------------------------------g-------------------------------g-----------------------------------------------------
--------------------------------------------------X------------------------------------------------------------#---------------------T---------#-----------------------------------------------------
----------------------------------------T---------X-----------T-----#---T--------------------?Q----S---T------##----------T---S---C--T-SS-----##----------------T------------------------------------
----------g-----------------------------T---------X-----------T-----#---T------------------------------T--T---##----------T----------T--------##----------------T------------------------------------
----------TT----------------------------T---------X------#----T-----##--T------------------------------T--T---##----------T----------T--------##----------------T--------------------------------F---
--M---g-g-TT----------------------------T---------X-----##----T-----##--T--g---------------------------T--T---##----------T------gg--T--k-k-g-##----------g-----T------g-----gg---------g-g------X---
XXXX-XXXXXXXXX--XXXXXX-XXX-XXXXXXXXXXXXXXXXXXXXXXXXXXXXXXXXXXXXXXXXXXXXXXXXXXXX-XXX-XXX-XX-XXXXXXXXXXXXXXXXX-XXXXXXXXXX-XXXXXXXXXXXXXXXXXXXXXXXXXXXXXXXX-XXXXXXXXXXXXXXXXXXXXXXXXXXXXXXXXXXXX-XXXXXXX
XXXX-XXXXXXXXX--XXXXXX-XXX-XXXXXXXXXXXXXXXXXXXXXXXXXXXXXXXXXXXXXXXXXXXXXXXXXXXX-XXX-XXX-XX-XXXXXXXXXXXXXXXXX-XXXXXXXXXX-XXXXXXXXXXXXXXXXXXXXXXXXXXXXXXXX-XXXXXXXXXXXXXXXXXXXXXXXXXXXXXXXXXXXX-XXXXXXX
