------------------------------------------------------------------------------------------------------------------------------------------------------------------------------------------------------
------------------------------------------------------------------------------------------------------------------------------------------------------------------------------------------------------
------------------------------------------------------------------------------------------------------------------------------------------------------------------------------------------------------
------------------------------------------------------------------------------------------------------------------------------------------------------------------------------------------------------
------------------------------------------------------------------------------------------------------------------------------------------------------------------------------------------------------
------------------------------------------------------------------------------------------------------------------------------------------------------------------------------------------------------
-----------------------------------------------------------------------------#--------------------------------------------------------------#---------------------------------------------------------
-----------------------------------------------------------------------------#--------------------------------------------------------------#---------------------------------------------------------
--------------------------------------------------T------------T-------------#--------------------------------------------------------------#---------------------------------------------------------
--------------------------------------------------T------------T-------------#--------------------------------------------------------------#-------K-------------------------------------------------
--------------------------------------------------#------------#-------------#--------------------------------------------------------------#---------------------------------------------------------
-----------------------------------------------------------------------------#--------------------------------------------------------------#---------#-----------------------------------------------
--------------------------------------------------------------------------*--------------------------------------------------------------------------##-------------------------------------------F---
-M------------gg-----------------g-----------gg-g------------------g------*----g----------------g--g----------g---------K----------g------g---------###-g--------g---------k-------------g-g--gg--#---
XXXXXXXXXXXXXXXXXXXXXXXXXXXXXXX-XXXXXXXXXXXXXXXXXXXXXXXX-XX-XXXXXXXXXXXXXXXXXXXXXXXX-XXXXXXXXXXXXXXXXXXXXXXXXXXXXXXXXXXXXXXXXXXXXXXXXXXXXXXXXXXXXXXXXXXXXXXXXXXXXXXXX-XXXXXXXXXXXXXXX-XXXXXXXXXXXXXXXX
XXXXXXXXXXXXXXXXXXXXXXXXXXXXXXX-XXXXXXXXXXXXXXXXXXXXXXXX-XX-XXXXXXXXXXXXXXXXXXXXXXXX-XXXXXXXXXXXXXXXXXXXXXXXXXXXXXXXXXXXXXXXXXXXXXXXXXXXXXXXXXXXXXXXXXXXXXXXXXXXXXXXX-XXXXXXXXXXXXXXX-XXXXXXXXXXXXXXXX
