-------------------------------------------------------------------------------------------------------------------------------------------------------------------------------------------
-------------------------------------------------------------------------------------------------------------------------------------------------------------------------------------------
-------------------------------------------------------------------------------------------------------------------------------------------------------------------------------------------
S---SSSSS--SSSSSSSSSSSSSSSS-------SSSSSSSSSSSSS----SSSSSSSSSSSSSSSSSSSSSSSSSSSSSSS-------------SSSSSSSSSSSSSSSSSSSSSSSSSSSSSS---SSSSSSSSSSSSSSSSS---SSSSSSSSSSS--SSS-SSSSSS---SSSSSSSSS-SSS
S----------SSSSSSSSSS----------------------------------------------------------------------------------------------------------------------------------------------------------------------
S----------SSSSSSSSSS----------------------------------------------------------------------------------------------------------------------------------------------------------------------
S----------SSSSSSSSSS----------------------------------------------------------------------------------------------------------------------------------------------------------------------
S----------S-------------------------------------------------------------------------------------------------------------------------------------------------------------------------------
S----------S----------------S-SSS----------------S---------------------------------S--S----S-S--------------------------------S-------------------S----------------------------------------
S------------oo-------------------------------------------------S--------------------------------------------------------------------------------------------------------------------------
S----T--S---USS-SS?-S-----Q------------T------Q----------------------T-------T---Q------------------------T------------T---QQ----T--------------S-------------S----Q------S-----------S---F
S----T----------S---S--T------------T--T----------------T------------T---T---T--------------------#-------T------------T---------T---T------T-------------------------------------T------SS
S----T----------S---S--T------------T--T--t-------------T------------T---T---T-----------S-------##---t---T------------T---------T---T------T-------------------------------------T------SS
S-M--T-----------oooS--T------------T--T--t-------------T--k-----k---T---T---T-------------------##---t---T------------T---------T---T------T-k-----------------------------------T------SS
XXXXXX-XX--XXXXXXXXXXXXXXXX--------XXX-X-XXXXXX------XXXXXXXX-XXXXXX-X--XXX-XX--XX--------------XXX-XXXXXXX-XXX-XXXX---X--XXX----X-XXXXXX-XXXXXXX----XX-XX--XXX---XX---X-XX----XXXXXXXX--XX
XXXXXX-XX--XXXXXXXXXXXXXXXX--------XXX-X-XXXXXX------XXXXXXXX-XXXXXX-X--XXX-XX--XX--------------XXX-XXXXXXX-XXX-XXXX---X--XXX----X-XXXXXX-XXXXXXX----XX-XX--XXX---XX---X-XX----XXXXXXXX--XX
