--------------------------------------------------------------------------------------------------------------------------------------------------------------
--------------------------------------------------------------------------------------------------------------------------------------------------------------
--------------------------------------------------------------------------------------------------------------------------------------------------------------
S-----SS--SSSSSSSSSSSSSSSSSSSSSSSSSSSSSSLSSSSLSSSSSLSSSSSSSSSSSSSSSSSSS--SSSSSSLSSSSSSSSSSSSLSSSSSSSSSSSSSSSSSSSSSSSSSSSSSSSSSSSSSSSSSSSSSSSSSSSSSSSSSS-------
S-------------------SS-----------------------------------------------------SS------------------------SS--------SSS--------------SS-----SS---------------------
S-------------------SS-----------------------------------------------------SS------------------------SS--------SSS--------------SS-----SS---------------------
S-----------------------------------ooooo---oo----oo--------------------------oo-----------oo-------------------SS--------------------------------------------
S---------------------------------------------------------------------------------------------------------------SS--------------------------------------------
S-----------------------------------SSSSS---SS----SS--------------------------SS-----------SS-------------------SS-------------------------S-U----------------
S-------------------oU--------------SSSSS---SS----SS-----------------------oU-SS---C-------SS--------oU--------oSS--------------oU-----oU--SoS-C--------SU----
S------#------------SS-------------------------#----------@Q----------#----SS------------------------SS--------SSS-------#----#-SS-----SS--SSS--------#-------
S------#------#-------------#------------------#----------------------#------------------#-------------------------------#----#----#------------------#-------
S------#------#---T---------#---T--------------#----------------------#----------#-------#------------------T------------#----#----#--------------T-T-#-------
S--M---#------#-g-T---------#---T--------------#----------------------#----------#-E-----#------g-----------T----g-------#----#----#-----------E--T-T-#-----F-
XXXXXXXX-XXX-XXXXXXXXXXXXXXXXXXXXX-XXXXXXXXXXXXXXXXXXXXXXXXXXXXXX--XXXX-XXXXXXXXXXXXXXXXXXXXXXXXXXXXXXXXX-XXXXXXXXXXXXXXXXXX-XXXXXXXXXXXXXXXXXXXXXXXXXX-XXXXXX
XXXXXXXX-XXX-XXXXXXXXXXXXXXXXXXXXX-XXXXXXXXXXXXXXXXXXXXXXXXXXXXXX--XXXX-XXXXXXXXXXXXXXXXXXXXXXXXXXXXXXXXX-XXXXXXXXXXXXXXXXXX-XXXXXXXXXXXXXXXXXXXXXXXXXX-XXXXXX
