---------------------------------------------------------------------------------------------------------------------------------------------------------------------
---------------------------------------------------------------------------------------------------------------------------------------------------------------------
---------------------------------------------------------------------------------------------------------------------------------------------------------------------
------------------------------------------------------------------ooo------------------------------------------------------------------------------------------------
-------------------------------------------------------------------------------------------------o--------o-------------------------------o--------o-------oo--------
---------------------------------------------------------------------------------------------------------------------------------------------------------------------
--------------S-----------------------------%%-------------------SSSSS-S--------------o-----------%--------%%%%------------------------o---%--------%%%%-----%%%-----
--------------------------------------------------------------------------------------S------------------------------------------------S-----------------------------
-----------------------SS-------o--------------------------------------------------o---------------------------------------------------------------------------------
--------------------------------------------------------------------------------------------------------------------------------o------------------------------------
------%---%%%%-%-%--SS-----S-SS-S--------%-S-%%-%------%---%-%-%------%---------%%-S-----------%--------------------%-%%-S---%----%-%%-------------------------------
----------------------------------S----S-----------------------------------------------------------------------------------------------------------------------------
-------------------------------------------------------------------------------------------------------------------------------------------------------------------F-
-M-----------------------------------------------------------------------------------------------------------------------------------------------------------------X-
XXXX-%---%----------------------------------%%---%%%%%%--%%---%-%%-------%%%%%%%-----%----%%%%%----XXXXXX------XXXX--%------%-%%%%-%--%-----XXXXXX------X-------XXXXX
XXXX-----------------------------------------------------------------------------------------------XXXXXX------XXXX-------------------------XXXXXX------X-------XXXXX
