------------------------------------------------------------------------------------------------------------------------------------------------------------------------------------------------------------------------------
------------------------------------------------------------------------------------------------------------------------------------------------------------------------------------------------------------------------------
------------------------------------------------------------------------------------------------------------------------------------------------------------------------------------------------------------------------------
------------------------------------------------------------------------------------------------------------------------------------------------------------------------------------------------------------------------------
------------------------------------------------------------------------------------------------------------------------------------------------------------------------------------------------------------------------------
-------------------------------------------------------------------------------------------------------------------------------------------------------------------------y----------------------------------------------------
---------------------Q----------------------------------------------------------------Q----------------------------------------------------------------------------------##-----------------------------Q---------------------
-----------------------o-------------------------o-------------------o----------------------------------------------------------------------o-------o-----------o------y###----------------------o------------o---------------
-----------------------------------------------------------------------------------------------------------------------------------------------------------------------####---------------------------------------------------
----------------------------------------------------------------------------------------------------------------------------------------------------------------------#####---------------------------------------------------
---------------------Q---------------------------------------Q-Q----------------------Q-------Q-------------C-Q---------------------------------------------------o--######--------------Q--------------Q---------------------
-----------------------------------------------T--------------------------------------------------------------------------------------------------------------------#######---------T-----------------------------------------
-----------------------------------------------T-----------------------------T------------------T-------------------------------------------------------------------#######---------T-------T-----------------------------F---
-M-----------------------y---------------------T-----------------------------T------------------T-------------------------------------------------------y-----------#######---------T-------T-----------------------------#---
XXXXXXXXXXXXXXXXXXXXXXXXXXXXX-X-XXXXXXXXXXXX-XXXXXXXXXXXXXXXXXXXXXXXXXXXXXXXXXXXXXXXXXXXXXXX-XXXXXXXXX-XXXXXXXXXXXXXXXXXXXXXXXXXXXXXXXXXXXXXXXXXXXXXXXXXXXXXXXXXXXXXXXXXXXXXX-XXXXXXXXXXXXXXXXXXXXXXX-XXXXXXXXXXXX-XXXXXXXXXXX
XXXXXXXXXXXXXXXXXXXXXXXXXXXXX-X-XXXXXXXXXXXX-XXXXXXXXXXXXXXXXXXXXXXXXXXXXXXXXXXXXXXXXXXXXXXX-XXXXXXXXX-XXXXXXXXXXXXXXXXXXXXXXXXXXXXXXXXXXXXXXXXXXXXXXXXXXXXXXXXXXXXXXXXXXXXXX-XXXXXXXXXXXXXXXXXXXXXXX-XXXXXXXXXXXX-XXXXXXXXXXX
