-----------------------------------------------------------------------------------------------------------------------------------------------------
-----------------------------------------------------------------------------------------------------------------------------------------------------
-----------------------------------------------------------------------------------------------------------------------------------------------------
-----------------------------------------------------------------------------------------------------------------------------------------------------
-----------------------------------------------------------------------------------------------------------------------------------------------------
----------------------%--------------------------%--%-----------------SSSSSSSSS---------oooooo--------%------------------------%---------------------
---------------------------------------------------------------------------------------%%%%%%%%-----------------------------------------------S------
------S-SS---o---o----------------o---o-----o-----------------------g---------------S---||||||--o----------------------------------------------------
------------%%%-%%%------%-%-%-%-%%%-%%%-%-%%%---------------%%%%%%%%%------------------||||||-%%%---------------------SS----------------SS----------
-------------|---|----------------|---|-----|-----------------|||||||----------SSSS-----||||||--|----------------------------------------------S-----
-------------|---|----------------|---|-----|-----------------|||||||-------------------||||||--|---------------r------------------------------------
-------------|---|----------------|---|-----|---------%%%%%%%%|||||||-------------------||||||-o|-------%%%%%%%%%%%%%%%%---------%%%%%%%%%-----------
-------------|---|----------------|---|-----|----------||||||-|||||||-------------------||||||%%%%%------||||||||||||||-----------|||||||----------F-
-M-----------|---|----------r---r-|---|-----|----------||||||-|||||||----------oo-------||||||-|||-------||||||||||||||-----------|||||||----------#-
XXXX--------%%%%%%%%%%%%%%%%%%%%%%%%%%%%%%%%%%%%%%%%%%-||||||-|||||||---------%%%-------||||||-|||--%%%%-||||||||||||||----%%%%%%-|||||||-------XXXXX
XXXX---------|||||||-||-|||||||||||||||||||||||-||-||--||||||-|||||||----------|--------||||||-|||---||--||||||||||||||-----|-||--|||||||-------XXXXX
