----------------------------------------------------------------------------------------------------------------------------------------------------------------------------------------
----------------------------------------------------------------------------------------------------------------------------------------------------------------------------------------
----------------------------------------------------------------------------------------------------------------------------------------------------------------------------------------
----------------------------------------------------------------------------------------------------------------------------------------------------------------------------------------
----------------------------------------------------------------------------------------------------------------------------------------------------------------------------------------
----------------------------------------------------------------------------------------------------------------------------------------------------------------------------------------
-----------------------------------------------------------------------------#--------------#---------------------------#---------------------------------------------------------------
------------------------------------------------------y------------y---------#--------------#---------------------------#-----------y---------------------------------------------------
----------------------------y--oo-------------------#SS--o-------#SS--o------#--------oo----#---oo----------------------#---------#SS--o----------y-------------------y-----------------
----------------------------XS---------------------##-----------##-----------#--------------#---------------------------#--------##---------------#-------------------#-----------------
-----------Q---------------XX------------Q---------##--SC-------##--SC-------#--------------#------------o--Q---------#-#--------##--SC----------##------------------##-----------------
--------------------------XXX----------------------##-----------##-----------#--------------#------------------------##-#--------##------------y###----------------y###-----------T-----
-------------------------XXXX----------------------##---SSS-----##---SSS-----#--------------#-----------------------###-#--------##---SSS------####----------------####-----------T-F---
----M-------------------XXXXX-----------------y----##-----------##-----------#--------------#----------y-----------####-#--------##-----------#####-----y---------#####-----------T-#---
XXXXXX-X--XXXX-X--X-XXXXXXXXX---XXXXXX-XXXXXXXXXXXXXX------XXXXXXX------XXXX-XXXX-XX---XXX--XXX--XXXXXXXXXXXXXXXXXXXXXX-XXXXXX-XXXX------X-XXXXXXXX-XXXXXXXXXXXXXXXXXXX-XXXXXX-XXXXXXXXX
XXXXXX-X--XXXX-X--X-XXXXXXXXX---XXXXXX-XXXXXXXXXXXXXX------XXXXXXX------XXXX-XXXX-XX---XXX--XXX--XXXXXXXXXXXXXXXXXXXXXX-XXXXXX-XXXX------X-XXXXXXXX-XXXXXXXXXXXXXXXXXXX-XXXXXX-XXXXXXXXX
