--------------------------------------------------------------------------------------------------------------------------------------------------------------
--------------------------------------------------------------------------------------------------------------------------------------------------------------
--------------------------------------------------------------------------------------------------------------------------------------------------------------
S------SSSSSSSSSSSSSSSSSSSSLSSSSSSSSSSSSSSSSSSSSSSSSSSSSSSSSSSSSSSSSSSSSSSSSSSSSSLSSSSSSSSSSSSSSSSSSSSSSSSSSSSSSSSSSSSSSSSSSSSSLSSSLSSSSSSSSSSSSSSSS----------
S--------------SS----------------------------------------S-SSSSS-SS------SS-----------------------SS------------------SS--------------------------------------
S--------------SS----------------------------------------S-SSSSS-SS------SS-----------------------SS------------------SS--------------------------------------
S-------------------------oo----------------------------S-----------------------oo--------------------------------------------oo--oo-----------------S--------
S-------------------------------------------------------S-----------------------------------------------------------------------------------------------------
S-------------------------SS----------------------------S-----------------------SS--------------------------------------------SS--SS--------------------------
S--------------oU---------SS----------------------------S--ooooU-oU------oU-----SS----------------oU------------------g-------SS--SS-------------C------SU----
S--------------SS---#-----------------------------------SS-SSSSS-SS-#----SS----------#-T----------SS------------------SS--------------------T------#----------
S-------------------#-----------S--#--T------------------S----------#----------------#-T-------------#------#-------------------------------T------#----------
S-------------------#-g---------S--#--T-----g-----#------S----------#----------------#-T--#----------#------#------------------------g------T-#----#-S--------
S--M----------------#-#---------S--#--T---g-#-g---#----------k------#--------g-------#-T--#----------#--g---#--------------g---------#------T-#--E-#--------F-
XXXXX-XXXXX-X-XXXXXXXXXXXXXXXXX-X-XXXXXX-XXXXXXXXXXX-XXXXXXXXXXXXXXXXXXXXXXXXXXXXXXXXXXXXXXXXXXXXXXXXXXXXXXXXXXXXX-X-XXX-XXXXXXXXXXXXXXXXX-XXXXXXXXX----XXXXXX
XXXXX-XXXXX-X-XXXXXXXXXXXXXXXXX-X-XXXXXX-XXXXXXXXXXX-XXXXXXXXXXXXXXXXXXXXXXXXXXXXXXXXXXXXXXXXXXXXXXXXXXXXXXXXXXXXX-X-XXX-XXXXXXXXXXXXXXXXX-XXXXXXXXX----XXXXXX
