----------------------------------------------------------------------------------------------------------------------------------------------------------------------------------------
----------------------------------------------------------------------------------------------------------------------------------------------------------------------------------------
----------------------------------------------------------------------------------------------------------------------------------------------------------------------------------------
----------------------------------------------------------------------------------------------------------------------------------------------------------------------------------------
----------------------------------------------------------------------------------------------------------------------------------------------------------------------------------------
----------------------------------------------------------------------------------------------------------------------------------------------------------------------------------------
----------------------#--------------------------------------------------#----------------------------------------------#---------------------------------------------------------------
----------------------#-------y------------------------------------------#----------------------------------------------#---------------------------------------------------------------
----------------------#-----#SS--o---------------------------------------#--------------------------y-------------------#-------------------------------------oo-------oo---------------
----------------------#----##--------------------------------------------#--------------------------XS---------o--------#---------------------------------------------------------------
--------o-------------#----##--SC-------------o-------------------Q------#-------------------------XX--SC---------------#--Q----Q-----------------------------------------------o-o-----
----------------------#----##-----------------------------------------T--#------------------------XXX-------------------#---------------------------#---------------T-------------------
----------------------#----##---SSS-----------------------------------T--#-----------------------XXXX-------------------#--------------------------##---------------T---------------F---
----M--------------y--#----##-------------------------y---------------T--#-----------y----------XXXXX-------------------#------------y--y----y-------------y--------T---------y-----#---
XXXXXXXXXXXXXXXXXXXXX-XX-XXXX------XXXX-XX-XXXXXX-XXXXXXXX-XXXXXXXXXXXXX-XXXXXXXXXXXXXXXXXXXXXXXXXXXX--XXXX-XXXXXXXXXXX-XXXXXX-XXXXXXXXXXXX-XXXXXXXXXX--X-XXX--XXX-XXX--XXXXXXXXXXXXXXXX
XXXXXXXXXXXXXXXXXXXXX-XX-XXXX------XXXX-XX-XXXXXX-XXXXXXXX-XXXXXXXXXXXXX-XXXXXXXXXXXXXXXXXXXXXXXXXXXX--XXXX-XXXXXXXXXXX-XXXXXX-XXXXXXXXXXXX-XXXXXXXXXX--X-XXX--XXX-XXX--XXXXXXXXXXXXXXXX
