---------------------------------------------------------------------------------------------------------------------------------------------------------------------
---------------------------------------------------------------------------------------------------------------------------------------------------------------------
---------------------------------------------------------------------------------------------------------------------------------------------------------------------
---------------------------------------------------------------------------------------------------------------------------------------------------------------------
----oo------------------o--------------------------o-----------------------------------o--------------o-----------o---------------o------o----------------o----------
---------------------------------------------------------------------------------------------------------------------------------------------------------------------
------%------------------%%%%%%---------------------%--------------------------So-------%%%------------%%%%-----S--%---------------%------%-------------o--%%%-------
--------------------------||-|-----------------------------------------------------------|--------------||-------------------S-S------------------------S---|--------
----------------------o---||-|----------------------------------------------o------------|-------o------||--------------------------------------------------|--------
--------------------------||-|-----------------------------------------------------------|--------------||--------------------------------------------------|--------
----------------------S---||-|----------------------------------------------S----SS-SS---|-------S--%---||--------------------------------------------------|--------
--------------------------||-|-----------------------------------------------------------|-----S--------||--------------------------------------------------|--------
--------------------------||-|-----------------------------------------------------------|--------------||--------------------------------------------------|------F-
-M------------------------||-|-----------------------------------------------------------|--------------||--------------------------------------------------|------X-
XXX----XXXXXXXXXXXX-------||-|-XXXXXXXXXXXXXXXXXXX---XXXXXXXXXXXXXXXXXXXXX---------------|-XXX----------||-XXX------XXXXXXXX--------XXXX---XXXXXXXXXXX-%----|-XXXXXXX
XXX----XXXXXXXXXXXX-------||-|-XXXXXXXXXXXXXXXXXXX---XXXXXXXXXXXXXXXXXXXXX---------------|-XXX----------||-XXX------XXXXXXXX--------XXXX---XXXXXXXXXXX------|-XXXXXXX
