---------------------------------------------------------------------------------------------------------------------------------------------------------------------
---------------------------------------------------------------------------------------------------------------------------------------------------------------------
---------------------------------------------------------------------------------------------------------------------------------------------------------------------
---------------------------------------------------------------------------------------------------------------------------------------------------------------------
-----o------------------------------------------------o---------------------------oo-----------------------------------o-----------------o---------------o-----------
---------------------------------------------------------------------------------------------------------------------------------------------------------------------
------%------------------------------------------------%----------------------------%--------------------------------o--%%%---------------%---------------%%%%%%%----
---------------------------------------------------------------------------------------------------------------------S---|---------------------------------|-|-|-----
-------------------------------------------------------------------------------------------------------------------------|---------------------------------|-|-|-----
-------------------------------------------------------------------------------------------------------------------------|---------------------------------|-|-|-----
-------------------------------------------------------------------------------------------------------------------%-----|------------SS-------------------|-|-|-----
-------------------------------------------------------------------------------------------------------------------------|---------------------------------|-|-|-----
-------------------------------------------------------------------------------------------------------------------------|---------------------------------|-|-|---F-
-M-----------------------------------------------------------------------------------------------------------------------|---------------------------------|-|-|---X-
XXX----XXXXXXXXXXXXXXXXXXXXXXXXXXXXXXXXXXXXXXXXXXXXX----XXXXXXXXXXXXXXXXXXXXXXXX-----XXXXXXXXXXXXXXXXXXXXXXXXXXXXX--%----|-XXXXXXXXXX------XXXXXXXXXXX-----|-|-|-XXXX
XXX----XXXXXXXXXXXXXXXXXXXXXXXXXXXXXXXXXXXXXXXXXXXXX----XXXXXXXXXXXXXXXXXXXXXXXX-----XXXXXXXXXXXXXXXXXXXXXXXXXXXXX-------|-XXXXXXXXXX------XXXXXXXXXXX-----|-|-|-XXXX
