----------------------------------------------------------------------------------------------------------------------------------------------------------------------------------------------------------------------
----------------------------------------------------------------------------------------------------------------------------------------------------------------------------------------------------------------------
----------------------------------------------------------------------------------------------------------------------------------------------------------------------------------------------------------------------
----------------------------------------------------------------------------------------------------------------------------------------------------------------------------------------------------------------------
----------------------------------------------------------------------------------------------------------------------------------------------------------------------------------------------------------------------
----------------------------------------------------------------------------------------------------------------------------------------------------------------g-----------------------------------------------------
-S--------------S--S------------------------------S------S-S------SS--------------------------SS-S------S------------S-------------------------S----S-----------SS----------S-------------S--S---------S--S-----------
-----------------------------------------------------------------------------------------------------------------T----------------------------------------------------------------------------------------------------
-----------------------------------------------------------------------------T----------------------T------------T-------------------------------T------------------------------------------------------------T-------
-----------------------------------------------------------------------------T----------------------T------------X-------------------------------T------------------------------------------------------------T-------
-S------------T------T--T-----S----------------------------S---------#-----T-X----------------------X---S---T-T------S--------T-TTT--T--T--T-----X-------------------------SS----t-S------------#----T--------X-------
--------------T------T--T---T----T------K----------------------------#-----T-------T------------------------T-T----------T----T-TTT--T--T--T----------------K------------------T-t--------------#----T----------------
------T-T-----T-TT---T--T-TTT----T--#-T--------------t-------T----T--##----T-------T-T----------------------T-T----T-----T----T-TTT--T--T--T----------T---#---T-TTT------------T-t---T--#-------##---T-------------F--
---M--T-T--k--T-TT---T--T-TTT----T-##-T--------------t-------T----T--##----T-------T-T----------------------T-T----T-----T----T-TTT--T--T--T----------T--##---T-TTT--k---------T-t---T-##-------##---T-------------#--
XXXXXXXXXXXXXXXXXXXXXXXXXXXXXXXXXXXXXXXXXXXXXXXXXXXXXXXXXXXXXXXXXXXXXXXXXXXXXXXXXXXXXXXXXXXXXXX-XXXXXXXXXXXXXXXXXXXXXXXXXXXXXXXXXXXXXXXXXXXXXXXXXXXXXXXXXXXXXXXXXXXXXXXX-XXXXXXXXXXXXXXXXXXXXXXXXXXXXXXXXXXXXXXXXXXXXX
XXXXXXXXXXXXXXXXXXXXXXXXXXXXXXXXXXXXXXXXXXXXXXXXXXXXXXXXXXXXXXXXXXXXXXXXXXXXXXXXXXXXXXXXXXXXXXX-XXXXXXXXXXXXXXXXXXXXXXXXXXXXXXXXXXXXXXXXXXXXXXXXXXXXXXXXXXXXXXXXXXXXXXXX-XXXXXXXXXXXXXXXXXXXXXXXXXXXXXXXXXXXXXXXXXXXXX
