---------------------------------------------------------------------------------------------------------------------------------------------------------------------
---------------------------------------------------------------------------------------------------------------------------------------------------------------------
---------------------------------------------------------------------------------------------------------------------------------------------------------------------
---------------------------------------------------------------------------------------------------------------------------------------------------------------------
--------------------o---------------------------------------o-----------------o--------------------------------------------------------------------------------o-----
-----------------------------------------------------------------------------------------------------------------ooooooooooooo---------------------------------------
------------------o--%%%%%%%%%-----------S--------oo-S-------%-----------------%%%%%%%--------------------------SS----------------------------------------------%----
------------------S---|||-|-|---------------------SS----------------------------||-||----------------------------------------------------------------------SSS-------
----------------------|||-|-|----------S------------------o---------------------||-||-------------------------------------SSSS---------------------------------------
----------------------|||-|-|---------------------------------------------------||-||--------------------------------------------------------------------------------
----S-%%%%%%%%--------|||-|-|-------%------%%%-%----------S---------------------||-||--------------------------%-----------------------------------------------------
-------||-|||---------|||-|-|---------------|-----------------------------------||-||--------------------------------------------------------------------------------
-------||-|||---------|||-|-|---------------|-----------------------------------||-||----------------------------------------%%%%%%%%%%%%%%%%%%%%%%%%%%%%%%%-------F-
-M-----||-|||---------|||-|-|---------------|-----------------------------------||-||-----------------------------------------|||||||||||||||||||||||||||||--------X-
XXX----||-|||-%%%%----|||-|-|-XXXXX---------|-%--%------------XXXXXXXXXXXXXXX---||-||-XXXXXXXXXXXXXXXXXXXXX---%--%%%%%%%%%%---|||||||||||||||||||||||||||||------XXXX
XXX----||-|||--||-----|||-|-|-XXXXX---------|-----------------XXXXXXXXXXXXXXX---||-||-XXXXXXXXXXXXXXXXXXXXX-------||||||||----|||||||||||||||||||||||||||||------XXXX
