------------------------------------------------------------------------------------------------------------------------------------------------------------------------------------------------------------------------------
------------------------------------------------------------------------------------------------------------------------------------------------------------------------------------------------------------------------------
------------------------------------------------------------------------------------------------------------------------------------------------------------------------------------------------------------------------------
------------------------------------------------------------------------------------------------------------------------------------------------------------------------------------------------------------------------------
------------------------------------------------------------------------------------------------------------------------------------------------------------------------------------------------------------------------------
------------------------------------------------------------------------------------------------------------------------------------------------------------------------------------------------------------------------------
------------------------Q--------------------------------------------------Q--Q---------------------------------------------Q-----------------------------------------------------------------------Q--------------Q----------
--------------------------------o--------------o---------------------o---o----------------o------------------------------------------------o------------------------o---------------------------------o-----------------------
------------------------------------------------------------------------------------------------------------------------------------------------------------------------------------------------------------------------------
------------------------------------------------------------------------------------------------------------------------------------------------------------------------------------------------------------------------------
---C-------Q------------Q-Q--------C---C---------o---------------------Q---Q--?----------------------------------------o----Q----QQ--Q---------Q-Q--------Q----C--------o-----------------T---------?--------------Q----------
-------------------#----------------------#--------------------------------------------------T--T------#--------------------------------------------------------------------#-------------T-----------------------------------
-------------------#----------------------#--------------------------------------------------T--T------#--------------------------------------------------------------------#-------------T-------------------------------F---
-M---y-------------#----------------------#------------------y-------------------------------T--T------#-------------------------------------y------------------------------#-------------T-----------------------------y-#---
XXXXXXXXXXXXXXXXXXXXXXXXXXXXX-XXXXXXXXXXXXXXXXXXXXXXXXXXXXXXXXXXXX-XXXXXXXXXXXXXXXX-XXXX-XXXXXXXXX-XXXXXXXXXXXXXXXXXXXXXXXXXXXXXXXXXXXXXXXXXXXXXXXXXXXXXXXXXXXXXXXXXXXXXXXXXXXX--XXXXXXXXXXXXXXXXXXXXXXXXXXXXXXXXXXXXXXXXXXXXX
XXXXXXXXXXXXXXXXXXXXXXXXXXXXX-XXXXXXXXXXXXXXXXXXXXXXXXXXXXXXXXXXXX-XXXXXXXXXXXXXXXX-XXXX-XXXXXXXXX-XXXXXXXXXXXXXXXXXXXXXXXXXXXXXXXXXXXXXXXXXXXXXXXXXXXXXXXXXXXXXXXXXXXXXXXXXXXX--XXXXXXXXXXXXXXXXXXXXXXXXXXXXXXXXXXXXXXXXXXXXX
