---------------------------------------------------------------------------------------------------------------------------------------------------------------------
---------------------------------------------------------------------------------------------------------------------------------------------------------------------
---------------------------------------------------------------------------------------------------------------------------------------------------------------------
---------------------------------------------------------------------------------------------------------------------------------------------------------------------
-----------o-----------o---------------o-----oo---------------o------------------o-----------------o----o------------------o-----------o------------------------o----
---------------------------------------------------------------------------------------------------------------------------------------------------------------------
------------%---S---S---%%%%%%%---------%------%---------------%%%%%%%------------%-----------------%----%%%----------------%%%%%%%%%---%------------S----o------%---
-------------------------|||-|----------------------------------||-||----------------------------S--------|------------------|-|||||-------------------S--S----------
-------------------------|||-|----------------------------------||-||----------o------o-------------------|------------------|-|||||---------------S-----------------
-------------------------|||-|----------------------------------||-||-------------------------------------|------------------|-|||||---------------------------------
---------S-----%---------|||-|----S-%---------------------------||-||----------S------S--SS----%----------|------------------|-|||||------------------------SSS------
------------------S------|||-|----------------------------------||-||-------------------------------------|------------------|-|||||---------------------------------
-------------------------|||-|----------------------------------||-||-------------------------------------|------------------|-|||||-------------------------------F-
-M-----------------------|||-|----------------------------------||-||-------------------------------------|------------------|-|||||-------------------------------X-
XXXXX--------X-----------|||-|-XX--------XXX----XXXXXXXXXXXXX---||-||-XXXXXXXX-----XX----------------XX---|-XXXXXXXXXXXXX----|-|||||-X---XXXXXXXX--------%--------XXX
XXXXX--------X-----------|||-|-XX--------XXX----XXXXXXXXXXXXX---||-||-XXXXXXXX-----XX----------------XX---|-XXXXXXXXXXXXX----|-|||||-X---XXXXXXXX-----------------XXX
