----------------------------------------------------------------------------------------------------------------------------------------------------------------------------------------------------
----------------------------------------------------------------------------------------------------------------------------------------------------------------------------------------------------
----------------------------------------------------------------------------------------------------------------------------------------------------------------------------------------------------
----------------------------------------------------------------------------------------------------------------------------------------------------------------------------------------------------
----------------------------------------------------------------------------------------------------------------------------------------------------------------------------------------------------
---------------------------------------------------------------------------------------------------------------------------------k------------------------------------------------------------------
----------------------------------------------S------------USS----------------SC----------------------S-------------------------##------S-S-------------------------SC-------------------SS---------
-------------------------------------------------------------------------------------------------------------------------------###------------------------------------------------------------------
------------------------------------------------------------------------------------------------#-----------------------------####------------------------------------------------------------------
----------?-------------------------------------------------------------------SS----------------#-----------------------------####----------------------------------SS------------------------------
----------------------------------------------S--SS-------#-----S---T---S--------S-----------S--#-----S----#---S--S---SS------####------S-S---T-------S-------T--S------------T----------SS---------
--------------------------------------------------K-------#---------T--------------------------##----------#-----------K-----#####------------T---------------T------------T--T---------------------
----------------------------------------------------------##--------T--------------------------##---T------#-------------T---#####------------T---------------T------------T--T------------------F--
-M--------------------g----gg-----------------------g-gg--##--g-K---T---K----------------------##---T------#-------------T---#####--g---g-----T-g----------k--T--K---------T--T--------g---------#--
XXXXXXXX-XXX-XX-XXXXXXXXXXXXXXXXXXX-XXXXXXXXXXXXXXXXXXXXX-XXXXXXXXXXXXXXXXXXX---XXXXXXXXXXXXXXXXX-XXXXXXXX-X--XXXXXXXXXXXXXXXXXXXXXXXXXXXXXXXXXXXXXXXXXXX-XXXXXXXXX---XXXXXXXXXXXX--XXXXXXXXX-XXXXXX
XXXXXXXX-XXX-XX-XXXXXXXXXXXXXXXXXXX-XXXXXXXXXXXXXXXXXXXXX-XXXXXXXXXXXXXXXXXXX---XXXXXXXXXXXXXXXXX-XXXXXXXX-X--XXXXXXXXXXXXXXXXXXXXXXXXXXXXXXXXXXXXXXXXXXX-XXXXXXXXX---XXXXXXXXXXXX--XXXXXXXXX-XXXXXX
