-----------------------------------------------------------------------------------------------------------------------------------------------------------------------------------------------------
-----------------------------------------------------------------------------------------------------------------------------------------------------------------------------------------------------
-----------------------------------------------------------------------------------------------------------------------------------------------------------------------------------------------------
-----------------------------------------------------------------------------------------------------------------------------------------------------------------------------------------------------
-----------------------X-----------------------------------------------------------------------------------------------------------------------------------------------------------------------------
-----------------------X-----------------------------------------------------------------------------------------------------------------------------------------------------------------------------
---------------?-----S-X--------S---------------------------------------------------------------------------------SS-----------QQ----S-S----S-----------------------------USS------------------------
-----------------------X-----------------------------------------------------------------------------------------------------------------------------------------------------------------------------
-----------------------X------------------------------------------------------g----------------------------------------------------------------------------------------------------------------------
-----------------------X------------------------------------------------------#----------------------------------------------------------------------------E-----------------------------------------
---------#---Q---------X-#--------------S------------------------------------##-------T---T------------------------------------?Q---------S-------------T-TT----------------------T------------------
---------#-------------X-#------------------#---#----------------------------##-------T---T------------------------------T------------------------------T-TT---------------t----T-T------#-g---------
---------##------------X-##-----------------#---#---------#------------------##-------T---T------------------------------T------------------------------T-TT---------------t----T-T------#-TT----F---
--M------##---K----g---X-##---------k-------#---#--g-----##--g---------------##-------T---T------------g-----------------T------------------------g-----T-TT-----------g---t----T-T------#-TT----X---
XXXXXXXXXXXXXXXXXXXXXXXXXXXX--XX-XXXXXXXXX--XXX-XXXXXX-XXXXXXXX-XXXXXXXXXXXXXXXXXX-XXXXXXXXXXX-XXXXXXXXXXXXXXXXXXXXXXXXXXXXXXXXXXXXXXXXXXXXXXXXXXXXXXXXXXXXXXXXXXXXXXXXXXXXXXXXXXXXXX-XX-XXXXXXXXXXXX
XXXXXXXXXXXXXXXXXXXXXXXXXXXX--XX-XXXXXXXXX--XXX-XXXXXX-XXXXXXXX-XXXXXXXXXXXXXXXXXX-XXXXXXXXXXX-XXXXXXXXXXXXXXXXXXXXXXXXXXXXXXXXXXXXXXXXXXXXXXXXXXXXXXXXXXXXXXXXXXXXXXXXXXXXXXXXXXXXXX-XX-XXXXXXXXXXXX
