---------------------------------------------------------------------------------------------------------------------------------------------------------------------
---------------------------------------------------------------------------------------------------------------------------------------------------------------------
---------------------------------------------------------------------------------------------------------------------------------------------------------------------
---------------------------------------------------------------------------------------------------------------------------------------------------------------------
------------------------o--------------------------------------o--------------------------o------o--------------------------------o------------------o---------------
---------------------------------------------------------------------------------------------------------------------------------------------------------------------
------------------S------%%%%--------SS------%%%%%%-------------%%%%%%%%%%%%%%%%%%---------%------%%%%%%%%%%%%%-------SSS----------%%%%%%%%-----------%%%%%%%%%%%%---
----------------------S---||------------------||||---------------|||-|-|-|-|-|-||------------------|-|-|||-|-|----------------------||-|-|-------------|||||||-||----
----------S-----S---------||------------------||||---------------|||-|-|-|-|-|-||------------------|-|-|||-|-|----------------------||-|-|-------------|||||||-||----
--------------------------||------------------||||---------------|||-|-|-|-|-|-||------------------|-|-|||-|-|----------------------||-|-|-------------|||||||-||----
--------%---S-S-----------||-----%%%-------SS-||||%%%%%%%%%%%%---|||-|-|-|-|-|-||------------------|-|-|||-|-|----SS-%---%%%-%%%%---||-|-|-------------|||||||-||----
--------------------------||------|-----------||||-|-||-|||||----|||-|-|-|-|-|-||-------S----------|-|-|||-|-|------------|---||----||-|-|-------------|||||||-||----
--------------------------||------|-----------||||-|-||-|||||----|||-|-|-|-|-|-||------------------|-|-|||-|-|------------|---||----||-|-|-------------|||||||-||--F-
-M------------------------||------|-----------||||-|-||-|||||----|||-|-|-|-|-|-||------------------|-|-|||-|-|------------|---||----||-|-|-------------|||||||-||--X-
XXX----%------------------||-XX---|%%%-------%%%%%%|%||%|||||----|||-|-|-|-|-|-||-XXXX------XXXX---|-|-|||-|-|-XX---------|%%%||----||-|-|-XXXXXXXXX---|||||||-||-XXX
XXX-----------------------||-XX---|-|---------||||-|-||-|||||----|||-|-|-|-|-|-||-XXXX------XXXX---|-|-|||-|-|-XX---------|-|-||----||-|-|-XXXXXXXXX---|||||||-||-XXX
