--------------------------------------------------------------------------------------------------------------------------------------------------------------
--------------------------------------------------------------------------------------------------------------------------------------------------------------
--------------------------------------------------------------------------------------------------------------------------------------------------------------
S----SSSSSSSSSSSSSSSSSSSSSSSSSSSSLSSSSSSSSSSSSSSSSSSSSSSSSSSSSSSSSSSSSSSSSSSSSSSSSSSSSSSSSSSSSSLSSSSSSSSSSSSSSSSSSSSSSSSSSSSSSSSSSSSSSSSSSSSSSSSSSSSSSSSSS----
S-------SS--------S-----------------------------------SSSS-------------S-------------------SS-----SS----------------------------------------------------------
S-------SS--------S-----------g-----------------------SSSS-------------S-------------------SS-----SS----------------------------------------------------------
S----------------S-----------SS-oo------------------------------------S-----------------------oo--------------------------------------------------------------
S----------------S-----------SS---------------------------------------S---------------------------------------------------------------------------------------
S----------------S-----------SS-SS------------------------------------S-----------------------SS--------------------------------------------------------------
S-------oU-------S-----------SC-SS--------------C-----oooU------------S--------------------oU-SS--oU---------------C------------------------------------------
S-------SS-------SS----------SS-----------------------SSSS------------SS---------#-----@QQ-SS-----SS----------#--T---------------------------T-----------#----
S-----T-----------S--#-#-----------------------------------------------S---------#----------------------------#--T----------------#-----S----T-----------#----
S-----T-----------S--#-#--------------#----T---------------#--g--------S---------#----------------------------#--T-------------#--#-----S----T-----------#----
S--M--T--------------#-#--------------#----T-g--E----------#--#------------------#-----------------------g----#--T-E--------g--#--#-g---S----T-----------#--F-
XXXXXXXXXXXXXXXXXXXXXXXXXXX-XXXXXXXXXXXXXXXXXXXXXXX--XXXXXXXXXXXXXXXXXXXXXXXXXXXXXXXXXXXXXXXXXXXXXXXXX--XXXXXXXXXXXXXX--XX-XXXXXXXXXXXX-X-XXXXXXXXX-XXX-XX-XXX
XXXXXXXXXXXXXXXXXXXXXXXXXXX-XXXXXXXXXXXXXXXXXXXXXXX--XXXXXXXXXXXXXXXXXXXXXXXXXXXXXXXXXXXXXXXXXXXXXXXXX--XXXXXXXXXXXXXX--XX-XXXXXXXXXXXX-X-XXXXXXXXX-XXX-XX-XXX
