----------------------------------------------------------------------------------------------------------------------------------------------------------------------------------------------------------
----------------------------------------------------------------------------------------------------------------------------------------------------------------------------------------------------------
----------------------------------------------------------------------------------------------------------------------------------------------------------------------------------------------------------
----------------SS-SSSSS-----------------------------SS------SSSS------------------------------------------------------------------SSSSSSS---SS--------------------------------------SS------SS--------SSS
-----------------------------------------------------------------------o-----------------------------------------------------------------------------------------------------------------------------g----
------------------------------------------------------------------------------------------------------------------------------------------------------------------------------------------o----------%----
-------------S----------------------------------S---------------------------------------------------S---S--------------------S-o-------------------------------S-SS-S------S-S----------------------------
---o-----------------------------------------------------------------------------------------------------------------------------------------------------------------------------------------------o------
----------------------------------------------------------------------------------------------------------------------------------------------------------------------------------------------------------
-------o-----------------------------o----------------------------------------S----------------------------------------------------------------------------------------------------k----------------%-----
-----------------------Q-S---Q--------#-----S--------------Q----Q----------------------------------S----S--------------------S----------------S------------------------T-----------S--Q-------#----------F
-----------------#--------------------#---------------#-----------K------#-----------------T---------------------------------------------#-----------------------------T--------K-------------#---------SS
-----------------#---------K----------#---------------#--------------t---#----------------TT-------K-----------------------------T-------#--------------*--------------T-----TT---------------#---------SS
-M---------------#--k-----------------#------------g--#---g--k-----k-t---#----r---k-------TT---g---------------------------------T------k#--------------*----#---------T----gTT--------------k#----%----SS
XXXXXXXXXXXXX-XXXX--XXXX-XXXXXXXX--XXXXXX-XXXX-XXX-XXXX--XXXXX-XX-XXXXX--XX-X-XX-XXX-XXXXXXXXXXXXX-XXXXXXX-XXXXXXXXXXXXXXXXXXXX-XXXXX-X-XX-XXXX-XXXX-XXXXXXXXXXXXX-XXXXXX-X-XXXX-XXXXXX-X--XXXX-XX------XX
XXXXXXXXXXXXX-XXXX--XXXX-XXXXXXXX--XXXXXX-XXXX-XXX-XXXX--XXXXX-XX-XXXXX--XX-X-XX-XXX-XXXXXXXXXXXXX-XXXXXXX-XXXXXXXXXXXXXXXXXXXX-XXXXX-X-XX-XXXX-XXXX-XXXXXXXXXXXXX-XXXXXX-X-XXXX-XXXXXX-X--XXXX-XX------XX
