----------------------------------------------------------------------------------------------------------------------------------------------------------------------------------------------------------------------
----------------------------------------------------------------------------------------------------------------------------------------------------------------------------------------------------------------------
----------------------------------------------------------------------------------------------------------------------------------------------------------------------------------------------------------------------
----------------------------------------------------------------------------------------------------------------------------------------------------------------------------------------------------------------------
----------------------------------------------------------------------------------------------------------------------------------------------------------------------------------------------------------------------
----------------------------------------------------------------------------------------------------------------------g-----------------------------------------------------------------------------------------------
-S---------------USS--------------S----------------S------S---------------S------------------------S------------------SS---------S-------------------S-----------------------------------S----------------------------
----------------------------------------------------------------------------------------------------------------------------------------------------------------------------------------------------------------------
---------------------------------------------------------------T------------------------------------------------T-----------------------------------------------------------------------------------------------------
----------------S---------------------T------------------------T-------------------------T----------------------T------------------------T----------------------------------------------------------------------------
-------T-T-T-S--------------S---------T-----T-----SS--------t--X----T--------------------T----------------------T----------------S-----S-T-----------S-------------------t--T-----T--T--------------T------t----TT----
------TT-T-T----------TT-T------------T----TT---------------t-------T---------------T-T--T--------------T-----T-T-T----------------------T--T----------------------------t--T-T---T--T--------------T------t----TT----
------TT-T-T----------TT-T------------T----TT---------------t-------T-----TTT-------T-T--T------T-------T-T---T-T-T---TTT-----------TT---T--T---T--#------T-------T------t--T-T---T--T-------T------T-T----t----TT-F--
---M--TT-T-T----------TT-T----k-------T----TT---------------t-------T-----TTT-------T-T--T------T-------T-T---T-T-T---TTT-----------TT---T--T---T-##------T-------T------t--T-T---T--T-------T------T-T----t----TT-#--
XXXXXXXXXXXXXXXXXX--XXXXXXXXXXXXXXXXXXXXXXXXXXXXXXXXXXXXXXXXXXXXXXXXXXXXXXXXXXXXXXXXXXXXXXXXXXXXXXXXXXXXXXXXXXXXXXXXXXXXXXXXXXXXXXXXXXXXXXXXXXXXXXXXXXXXXXXXXXXXXXXXXXXXXXXXXXXXXXXXXXXXXXXXXXXXXXXXXXXXXXXXXXXXXXXXXX
XXXXXXXXXXXXXXXXXX--XXXXXXXXXXXXXXXXXXXXXXXXXXXXXXXXXXXXXXXXXXXXXXXXXXXXXXXXXXXXXXXXXXXXXXXXXXXXXXXXXXXXXXXXXXXXXXXXXXXXXXXXXXXXXXXXXXXXXXXXXXXXXXXXXXXXXXXXXXXXXXXXXXXXXXXXXXXXXXXXXXXXXXXXXXXXXXXXXXXXXXXXXXXXXXXXXX
