----------------------------------------------------------------------------------------------------------------------------------------------------------------------------------------------------------------------
----------------------------------------------------------------------------------------------------------------------------------------------------------------------------------------------------------------------
----------------------------------------------------------------------------------------------------------------------------------------------------------------------------------------------------------------------
----------------------------------------------------------------------------------------------------------------------------------------------------------------------------------------------------------------------
----------------------------------------------------------------------------------------------------------------------------------------------------------------------------------------------------------------------
----------------------------------------------------------------------------------------------------------------------------------------------------------------------------------------------------------------------
-------S---------S------S----S----US------------------------S------------------------------------------------US-----S---------------------------S-------------------------S-------------------S--------S----S---------
-----------------------------------------T--------------------------------T----------T--------------------------------------------------------------------------------------------------------------------------------
-----------------------------------------T---------T----------------------T------T---T-----------T----------------------------------------------------------T---------------------------------------------------------
---------------------T-----------S-------X---------T----------------------X---T--T---X-----------T----------S----T------------------------------------------T-------------------------------------------------T-------
-------------S-------T--S------------S-------T---T-T--------------------S-----T--T---------------T---------------T--S-t----S-------t--------------T---------X-----T--TT---S----------#----------------SS------T-t-----
---------------------T-----T---------------K-T--TT-T--------------------------T--T-----TTT-------T---------------T----t-T----T-----t---------T----T-T-------------T--TT--------------#-#-TT---------------T---T-t-----
---------T-------TTT-T-----T-TT--------------T--TT-T------#-TT-T--------------T--T-----TTT----T--T--T--TTTT------T----t-T----T-t---t--T-----TT----T-T-TT--T-------T--TT--------T-----###-TT---TT----------T---T-t--F--
---M-----T-------TTT-T-----T-TT--------------T--TT-T-----##-TT-T--------------T--T-----TTT--k-T--T--T--TTTT------T----t-T----T-t---t--T-----TT----T-T-TT--T-------T--TT--------T-----###-TT---TT----------T---T-t--#--
XXXXXXXXXXXXXXXXXXXXXXXXXXXXXXXXXXX-XXXXXXXXXXXXXXXXXXXXXXXXXXXXXXXXXXX-XXXXXXXXXXXXXXXXXXXXXXXXXXXXXXXXXXXXXX-XXXXXXXXXXXXXXXXXXXXXXXXXXXXXXXXXXXXXXXXXXXXXXXXX-XXXXXXXXXXXXXXXXXXXXXXX-XXXXXXXXXXXXXXXXXXXXXXXXXXXXX
XXXXXXXXXXXXXXXXXXXXXXXXXXXXXXXXXXX-XXXXXXXXXXXXXXXXXXXXXXXXXXXXXXXXXXX-XXXXXXXXXXXXXXXXXXXXXXXXXXXXXXXXXXXXXX-XXXXXXXXXXXXXXXXXXXXXXXXXXXXXXXXXXXXXXXXXXXXXXXXX-XXXXXXXXXXXXXXXXXXXXXXX-XXXXXXXXXXXXXXXXXXXXXXXXXXXXX
