--------------------------------------------------------------------------------------------------------------------------------------------------------------
--------------------------------------------------------------------------------------------------------------------------------------------------------------
--------------------------------------------------------------------------------------------------------------------------------------------------------------
S----SSSSSSSSSSSSSSSSSSSSSLSSSSSSSSSSSSSSSSSSSSSSSSSSSSSSSSSSSSSSSSSLSSSSLSSSSSSSSLSSSSSSSLSSSSSSSSSSSSSSSSSSSLSSSSSSSSSLSSSSSSSSSSSSSSSSSSSSSSSSSSSSSSSSS----
S---------------------------------------------------------------------------S-------SS-----------------------------------------SS-----------------------------
S---------------------------------------------------------------------------S-------SS-----------------------------------------SS------------g----------------
S------------------------oo--------------------------------------oooo---oo-S-----oo------oo------------------oo--------oo-------------------SS----------------
S--------------------------------------------------------------------------S----------------------------------------------------------------SS----------------
S------------------------SS--------------------------------------SSSS---SS-S-----SS------SS--------------S-U-SS--------SS-------------S-U---SS----------------
S-------C----------------SS--------------------------------------SSSS---SS-S-----SS-oU---SS--------------SoS-SS--------SS------oU-----SoS---SC----------------
S---------#----#-----------------------------------------------------------SS-------SS-------------#-----SSS---------------#---SS-----SSS---SS-------#---#----
S---------#----#-------#----------#------------------T----T-----------------S----------------------#-----------------------#-#-----------------------#---#----
S---------#----#-------#----------#------------------T----T-----------------S--T-------------------#---T-------------------#-#-----g-----------------#-#-#----
S--M----E-#----#-------#----------#------------------T----T-g------------------T-------------g-----#---T-------------g-----#-#-----#-----------------#-#-#--F-
XXXXXXXXXXXXX-XXXXXX-XXXXXXXXXXXXXXXXXXXXXXXX-X-XXXXXXX-XXXXXXX-XXXXXXXXXXXXXXXXXXXXXXXXXXXXXXX-XXXXXXXXXXXXXXXXXXXXXXXXXXXXXXXXXXXXXXXXXXXXXXXXXX-XXXXXXX-XXX
XXXXXXXXXXXXX-XXXXXX-XXXXXXXXXXXXXXXXXXXXXXXX-X-XXXXXXX-XXXXXXX-XXXXXXXXXXXXXXXXXXXXXXXXXXXXXXX-XXXXXXXXXXXXXXXXXXXXXXXXXXXXXXXXXXXXXXXXXXXXXXXXXX-XXXXXXX-XXX
