------------------------------------------------------------------------------------------------------------------------------------------------------------------------------------------------------------------------------
------------------------------------------------------------------------------------------------------------------------------------------------------------------------------------------------------------------------------
------------------------------------------------------------------------------------------------------------------------------------------------------------------------------------------------------------------------------
------------------------------------------------------------------------------------------------------------------------------------------------------------------------------------------------------------------------------
------------------------------------------------------------------------------------------------------------------------------------------------------------------------------------------------------------------------------
------------------------------------------------------------------------------------------------------------------------------------------------------------------------------------------------------------------------------
-------------------Q--------------------------------------------Q-------------------------------------------------------------------------------------------------------------------------------------------------------------
----------------------------------o---o----------------------------------------------------------------------------o------------o------o-----------------------------------o------------------o----------------------o--------
------------------------------------------------------------------------------------------------------------------------------------------------------------------------------------------------------------------------------
------------------------------------------------------------------------------------------------------------------------------------------------------------------------------------------------------------------------------
---------Q---------?---------------------------Q----------------?---Q--------C--------------------------------------------------------------------o------------------T-------------Q--------------Q----------------o----C-----
-------------------------------------------------------------------------------------------------#----------------------------------------T--------------------------T-----------------#--------------------------------------
-------------------------------------------------------------------------------------------------#----------------------------------T-----T--------------------------T-----------------#----------------------------------F---
-M--------------y------------y--------------------y----------------------------------------------#-------y-----------------y--------T-----T---------------y----------T----------y------#--------y-------------------------#---
XXXXXXXXXXXXXXXXXXXXXXXXXXX-XXXXXXXXXXXXXXXXXXXXXXXXXXXXXXXXXXXXXXXXXXXXXXXXXXXXXXXXXXXXXXXXXXXXXX-XXXXXXXXXXXXX--XXXXXXXXXXXXXXXXXXXXXXXXXXXXXXXXXXXXX-XXXXX--XXX-XXXX-XXXXXXXXXXXXX-XXXXXXXXXXXXXXXXX--X-X-XXXXXXXXXXXXXXXXX
XXXXXXXXXXXXXXXXXXXXXXXXXXX-XXXXXXXXXXXXXXXXXXXXXXXXXXXXXXXXXXXXXXXXXXXXXXXXXXXXXXXXXXXXXXXXXXXXXX-XXXXXXXXXXXXX--XXXXXXXXXXXXXXXXXXXXXXXXXXXXXXXXXXXXX-XXXXX--XXX-XXXX-XXXXXXXXXXXXX-XXXXXXXXXXXXXXXXX--X-X-XXXXXXXXXXXXXXXXX
