---------------------------------------------------------------------------------------------------------------------------------------------------------------------
---------------------------------------------------------------------------------------------------------------------------------------------------------------------
---------------------------------------------------------------------------------------------------------------------------------------------------------------------
---------------------------------------------------------------------------------------------------------------------------------------------------------------------
-------o-----------------------------------------------------------------------o---------------------------------o-----------------oo-----------o------o-------------
---------------------------------------------------------------------------------------------------------------------------------------------------------------------
--------%%%%%%%----------------------------------------------------------SSSo---%---------------------------------%%%%%%%%%%%%%%-----%-----------%------%------------
---------|||-|----------------------------------------SSS----------------------------------------------------------|-|||-||-|||------------SS------------------------
-----S---|||-|--------------------------------------------SSS--------------------------------------------------o---|-|||-||-|||--------------------------------------
---------|||-|-----------------------------------------------------------------------------------------------------|-|||-||-|||--------------------------------------
---------|||-|---------------------------------SS--S----------S---%-%--------S---------------------------------S---|-|||-||-|||--------------------------------------
---------|||-|-----------------------------------------------------------------------------------------------------|-|||-||-|||---------------------S----------------
---------|||-|-----------------------------------------------------------------------------------------------------|-|||-||-|||------------------------------------F-
-M-------|||-|-----------------------------------------------------------------------------------------------------|-|||-||-|||------------------------------------X-
XXXX-----|||-|-XXXXXXXXXXXXXXXXXXXXXXXXXXXXXX-------------------%%%%%%%%%%-------XXXXXXXXXXXXXXXXXXXXXXXXXXXXX-----|-|||-||-|||-XX----XXXX--------X------XXXXXXXXXXXX
XXXX-----|||-|-XXXXXXXXXXXXXXXXXXXXXXXXXXXXXX--------------------|-|-||||--------XXXXXXXXXXXXXXXXXXXXXXXXXXXXX-----|-|||-||-|||-XX----XXXX--------X------XXXXXXXXXXXX
