-----------------------------------------------------------------------------------------------------------------------------------------------------
-----------------------------------------------------------------------------------------------------------------------------------------------------
-----------------------------------------------------------------------------------------------------------------------------------------------------
-----------------------------------------------------------------------------------------------------------------------------------------------------
-----------------------------------------------------------------------------------------------------------------------------------------------------
--------------------------------------------------------------------------------------------%-------------------------SSSSSSSS-----------------------
-------------------SS-----------------------------------S------------------S--------------------o--S------------------------------------o----S-------
-------R-----------------o--ooo----------------------------------o---ooo-----------o---o--------SS------------------g-------------------SS-----------
---------------SS-------------------------------SS--------------------------------%%%-%%%----------------------%%%%%%%---------------%---------------
---------------------S-----------------------------------S------------------S------|---|------------S-----------|||||---------SSS-------------S------
-----------------------------%%%%--------r-r--r-----------------------%%%%---------|---|---------------------r--|||||--------------------------------
-----------%%%%%--------------||--%%%%%%%%%%%%%%%----------------------||----------|---|---------------%%%%%%%%%|||||--------------------------------
------------|||---------------||---|||||||||||||-----------------------||----------|---|----------------|||||||-|||||------------------------------F-
-M----------|||---------%%%%%-||---|||||||||||||----------------%%%%%%-||----------|---|----------------|||||||-|||||---------oo-------------------#-
XXXXXX----%-|||-------X--|||--||---|||||||||||||----------X------||||--||----X--%%%%%%%%%%%%%%%%------%-|||||||-|||||--------%%%-X-%%%%%-------XXXXXX
XXXXXX------|||-------X--|||--||---|||||||||||||----------X------||||--||----X---|||||||||-||-|---------|||||||-|||||---------|--X--|||--------XXXXXX
