-------------------------------------------------------------------------------------------------------------------------------------------------------------------------------------------------------------------------------------------------------------------------------------------------------------------------------------------------------------------------------------
-------------------------------------------------------------------------------------------------------------------------------------------------------------------------------------------------------------------------------------------------------------------------------------------------------------------------------------------------------------------------------------
-------------------------------------------------------------------------------------------------------------------------------------------------------------------------------------------------------------------------------------------------------------------------------------------------------------------------------------------------------------------------------------
-------------------------------------------------------------------------------------------------------------------------------------------------------------------------------------------------------------------------------------------------------------------------------------------------------------------------------------------------------------------------------------
-------------------------------------------------------------------------------------------------------------------------------------------------------------------------------------------------------------------------------------------------------------------------------------------------------------------------------------------------------------------------------------
-------------------------------------------------------------------------------------------------------------------------------------------------------------------------------------------------------------------------------------------------------------------------------------------------------------------------------------------------------------------------------------
-------------------------------------------------------------------------------------------------------------------------------------------------------------------------------------------------------------------------------------------------------------------------------------------------------------------------------------------------------------------------------------
-------------------------------------------------------------------------------------------------------------------------------------------------------------------------------------------------------------------------------------------------------------------------------------------------------------------------------------------------------------------------------------
-------------------------------------------------------------------------------------------------------------------------------------------------------------------------------------------------------------------------------------------------------------------------------------------------------------------------------------------------------------------------------------
-----------------------o------------------------------oo-----------------------------------------------------------------------S-------------------------------------------o--------------o-----------------------o------------S-------S---S-------------------------------o----------------------------------------------------------------------------t-o--------------------------
------------------------------------------------------------------#-T----------------T---T-------------------#--------------------------------------------------------------------------------------------------------------------TT--------------#------------T--------------------#-----------------T-------T--------------------------------------#--t--------T-------------------
------------------------------------------------------------------#-T----------------T---T-------K-----------#-T----------------------T--T---------------------------T------------------------------------------K------T----------TT--------------#------------T-------------T------#------T----------T-------T----------T---------------------------#--t--------T-------------------
----------------------------------------------T-------------------#-T----------------T---T-----------------#-#-T-----------#----------T--T---------------#-----------T--------#-----------------K----------------------T----------TT--------------#------------T-------------T------#------T----------T-------T----------T---------------------------#--t--------T---------------F---
-M-g---g------------------------------k--g-g--T-g---k-k-----------#-T----------------T-g-T--------------k--#-#-T-----------#-----g-g--T--T--gg-----g-----#---g--k---kT--------#--g-gg--------------------------------g-T--k--g----TT-----k--------#--k---------T---k---------T------#-g----T-------g--T-k-g-g-T---k----g-T------------k---g----------#--t---k-g--T----g-k-g--g-g-#---
XXXXXXXXXX-XXXXXXXXX-XXXXXXXXXXXX-XXXXXXXXXXXXXXXXXXXXXXXXXXXXXX-XXXXXXXXXXXXXXX-XXXXXXXXXXXXXXXX-XXXXXXXXXXXXXXXXXXXXXXXXXXX-XXXXXXXXXX-XXXXXX-XXXXXXX-XXXXXXXXXXXXXX-XXX---XXXXXXXXXXX-XXXXXX-X-X-XXXXXXX-XXXX-XXXXXXXXXXXXXXXX-XXXXXXXXXXXXXXXXXXXXXXXX-XXXXXXXXXXXXXXXXXXX-XX-XXXXXXXXXXXXX-XXXXXXXXXXXXXXXX-XXXXXXXXXX-XXXX-XXXXXXXXXXXX-X-XXX-XXX-XXXXXXXX-X-XXXXXXXXXXXXXXXXXX
XXXXXXXXXX-XXXXXXXXX-XXXXXXXXXXXX-XXXXXXXXXXXXXXXXXXXXXXXXXXXXXX-XXXXXXXXXXXXXXX-XXXXXXXXXXXXXXXX-XXXXXXXXXXXXXXXXXXXXXXXXXXX-XXXXXXXXXX-XXXXXX-XXXXXXX-XXXXXXXXXXXXXX-XXX---XXXXXXXXXXX-XXXXXX-X-X-XXXXXXX-XXXX-XXXXXXXXXXXXXXXX-XXXXXXXXXXXXXXXXXXXXXXXX-XXXXXXXXXXXXXXXXXXX-XX-XXXXXXXXXXXXX-XXXXXXXXXXXXXXXX-XXXXXXXXXX-XXXX-XXXXXXXXXXXX-X-XXX-XXX-XXXXXXXX-X-XXXXXXXXXXXXXXXXXX
