----------------------------------------------------------------------------------------------------------------------------------------------------------------------------------------
----------------------------------------------------------------------------------------------------------------------------------------------------------------------------------------
----------------------------------------------------------------------------------------------------------------------------------------------------------------------------------------
----------------------------------------------------------------------------------------------------------------------------------------------------------------------------------------
----------------------------------------------------------------------------------------------------------------------------------------------------------------------------------------
----------------------------------------------------------------------------------------------------------------------------------------------------------------------------------------
----------------------------------------------------------------------------------------------------------------------------------------------------------------------------------------
---------------------------y--------------------------------------------------------------------------y---------------------------------------------------------------------------------
-------------------------#SS--o---------------------------------------------------------------------#SS--o----------------------------------------------------oo------------------------
------------------------##-------------------------------------------------------------------------##-----------------------y---o-------------------------------------------------------
-----------#------------##--SC----------------------------------------#----------------------------##--SC----Q----Q---------##------------------------o-----------------o---------------
---------y##------------##------------------------------------------y##-----T----------------------##---------------T-----y###----------------------------------------------------------
---------###------------##---SSS------------------------------------###-----T----------------------##---SSS---------T----#####------------------------------------------------------F---
----M-y-####----------y-##----------------y------------------------####-----T---------y---y----y---##---------------T---######---------------------y----------------y--------y------#---
XXXXXXXXXXXX-XXXXXXXXXXXXX------XX-XXXX-XXXXXXXXX-XXXXXXXX-XXX-XXXXXXXX-XXXXXXX-XXX-XXXXXXXXX-XXX-XXX------XXXXXXXXXXXXXXXXXXX-XXXX-XXXX-XX-XXXXXXXXXXXXXX-XX--XX-XXXXXXXXX-XXXX-XXXXXXX
XXXXXXXXXXXX-XXXXXXXXXXXXX------XX-XXXX-XXXXXXXXX-XXXXXXXX-XXX-XXXXXXXX-XXXXXXX-XXX-XXXXXXXXX-XXX-XXX------XXXXXXXXXXXXXXXXXXX-XXXX-XXXX-XX-XXXXXXXXXXXXXX-XX--XX-XXXXXXXXX-XXXX-XXXXXXX
