----------------------------------------------------------------------------------------------------------------------------------------------------------------------------------------------------
----------------------------------------------------------------------------------------------------------------------------------------------------------------------------------------------------
----------------------------------------------------------------------------------------------------------------------------------------------------------------------------------------------------
----------------------------------------------------------------------------------------------------------------------------------------------------------------------------------------------------
----------------------------------------------------------------------------------------------------------------------------------------------------------------------------------------------------
----------------------------------------------------------------------------------------------------------------------------------------------------------------------------------------------------
-----------------SC--S--------SS---------------------------------S-----S----S---------S----S------------------S--S------------------------------------------S-----------------------S--S--S---------
----------------------------------------------------------------------------------------------------------------------------------------------------------------------------------------------------
----------------------------------------------------------------------------------------------------------------------------------------------------------------------------------------------------
-----------------SS---------------------------------------------------------------------------------------------------------------------------------------------------------------------------------
---------------------S-SS-----SS-------------------S-------------S-----S----SS--------S----S-T----------------S--S--T--------S-------S-S---------------Q--Q-S-----------------------S--S--S---------
------------------------K---------------T------------------T------------------------T--------T--------T-------------T-T----------------------T-----------------------------T------------------------
----------------------------------------T------------------T--------------T---------T--------T--------T-------------T-T----------------------T----T-----------T-T----------T---------------------F--
-M----k-----k---------------------------T---g-g--------g---T--------------T---------T-g----g-T--k-----T-k--------g-gT-T------K-------K-K--g-gT----T-----------T-T----------T--------------g--g---#--
XXXXXXXXXXXXXXXX---XXXXXXXXXXXXXX-XX-XXXXXXXXXXXXXXXXXXXX-XXXXX-XXXXXXXXXXXXXXXXX-XXXXXX-XXXXXXXXX-XXXXXXXXX-XXXXXXXXXXXXXXXXXXXX--XXXXXXXXXXXXX-XXXXXXXXXXXXXXXXXXXXXXXXXXXXXXXX--XXXXXXXXXXXXXXXXX
XXXXXXXXXXXXXXXX---XXXXXXXXXXXXXX-XX-XXXXXXXXXXXXXXXXXXXX-XXXXX-XXXXXXXXXXXXXXXXX-XXXXXX-XXXXXXXXX-XXXXXXXXX-XXXXXXXXXXXXXXXXXXXX--XXXXXXXXXXXXX-XXXXXXXXXXXXXXXXXXXXXXXXXXXXXXXX--XXXXXXXXXXXXXXXXX
