-------------------------------------------------------------------------------------------------------------------------------------------------------------------------------------------------------------------------------------------------------------------------------------------------------------------------------------------------------------------------------------
-------------------------------------------------------------------------------------------------------------------------------------------------------------------------------------------------------------------------------------------------------------------------------------------------------------------------------------------------------------------------------------
-------------------------------------------------------------------------------------------------------------------------------------------------------------------------------------------------------------------------------------------------------------------------------------------------------------------------------------------------------------------------------------
-------------------------------------------------------------------------------------------------------------------------------------------------------------------------------------------------------------------------------------------------------------------------------------------------------------------------------------------------------------------------------------
-------------------------------------------------------------------------------------------------------------------------------------------------------------------------------------------------------------------------------------------------------------------------------------------------------------------------------------------------------------------------------------
----------------------------------------o--------------------------------------------------------------------------------------------------------------------------------------o-----------------------------------------------------------o-----------------------------------------------------------------------------------------------------------------------------------------
-------------------------------------------------------------------------------------------------------------------------------------------------------------------------------------------------------------------------------------------------------------------------------------------------------------------------------------------------------------------------------------
-------------------------------------------------------------------------------------------------------------------------------------------------------------------------------------------------------------------------------------------------------------------------------------------------------------------------------------------------------------------------------------
-------------------------------------------------------------------------------------------------------------------------------------------------------------------------------------------------------------------------------------------------------------------------------------------------------------------------------------------------------------------------------------
------------------------------1-----------------S-----------------------------------------------------------------------------------------------------------------------------------------o----------------------------------------------------------------------------------------------------------------------------S-------------------------------------------------------------
---T--T-----------------T------------------------------T-------------------------------------------------------------------T---------------------------------------------------------------------------------------T----------------------------------------#------T-----------------------------------------------------------------------------------------------------------#-----
---T--T--------T--------T------------------------------T--T----------------------------------------------------------------T--------------T------------------------------------------------------------------------T----------------------------------------#------T---------------T-T------------------------T--------------------------T----------------------------T--------#-----
---T--T--------T--------T------------------------------T--T--------#----T------------#---#------------t--------------------T--------------T-------------------------------------------------#----------------------T----------------#-----------------------#------T-------#-------T-T--------#---------------T---t-----------------#----T-----------------------T----T--------#-F---
-M-T--T-g------T-k----k-T------kk-g-----gg-------------T--T-----g--#----T--k-k-------#-g-#-----g------t--g-k---ggg--k---k--T--k-kk--------T---k--------------------k--g---k----gg---g--g----#----g-----------------T--g------------k#--gg--gg-----g----g----#-g----T----kk-#-------T-T--------#--g------k-----T---t--g-------g-k--k-#-k--T--------k--g-----g-g---T----T--------#-#---
XXXXXXXXXXX-XXXXXXXXXXXXXXXXXXXXXXXXXXXXXXXXXXXXXXXXXXXXX-XXXXXXXXXX-X-XXXXXXXX-XXXX-XXXXXXXXXXXXXXXXXXXXXXXX-XXXXXXXXXXXXXX-XXXXXX-X-XXXXXX-XXX-X-XXXXXXXXXXXXXXXXXXXXXXXXXXXXXXXXXXXXXX---X-XXXXXXXX-X-XX-XX-XXXXXXXXXX-XXXX-XXXXXX-XXXXXXXXXXXXXXXXXXX-XXXXXXXX-XXXXXXXXX-XX-XXXXXXXXXXXX--XXXXXXXXXXXXXX-XXXXXXXXXXXXXXXXXXXXXXXXXXX-XXXXX-X-XXXXXXXXXXXXXXXXXXX-XXXXXX-XXXXXXXXX
XXXXXXXXXXX-XXXXXXXXXXXXXXXXXXXXXXXXXXXXXXXXXXXXXXXXXXXXX-XXXXXXXXXX-X-XXXXXXXX-XXXX-XXXXXXXXXXXXXXXXXXXXXXXX-XXXXXXXXXXXXXX-XXXXXX-X-XXXXXX-XXX-X-XXXXXXXXXXXXXXXXXXXXXXXXXXXXXXXXXXXXXX---X-XXXXXXXX-X-XX-XX-XXXXXXXXXX-XXXX-XXXXXX-XXXXXXXXXXXXXXXXXXX-XXXXXXXX-XXXXXXXXX-XX-XXXXXXXXXXXX--XXXXXXXXXXXXXX-XXXXXXXXXXXXXXXXXXXXXXXXXXX-XXXXX-X-XXXXXXXXXXXXXXXXXXX-XXXXXX-XXXXXXXXX
