-------------------------------------------------------------------------------------------------------------------------------------------------------------------------------------------------------------------------------------------------------------------------------------------------------------------------------------------------------------------------------------
-------------------------------------------------------------------------------------------------------------------------------------------------------------------------------------------------------------------------------------------------------------------------------------------------------------------------------------------------------------------------------------
-------------------------------------------------------------------------------------------------------------------------------------------------------------------------------------------------------------------------------------------------------------------------------------------------------------------------------------------------------------------------------------
-------------------------------------------------------------------------------------------------------------------------------------------------------------------------------------------------------------------------------------------------------------------------------------------------------------------------------------------------------------------------------------
-------------------------------------------------------------------------------------------------------------------------------------------------------------------------------------------------------------------------------------------------------------------------------------------------------------------------------------------------------------------------------------
----------------------------------------------------------------------------------o--------------------------------------------------------------------------------------------------------------------------------------------------------------------------------------------------------------------------------------------------------------------------------------------------
-------------------------------------------------------------------------------------------------------------------------------------------------------------------------------------------------------------------------------------------------------------------------------------------------------------------------------------------------------------------------------------
-------------------------------------------------------------------------------------------------------------------------------------------------------------------------------------------------------------------------------------------------------------------------------------------------------------------------------------------------------------------------------------
-------------------------------------------------------------------------------------------------------------------------------------------------------------------------------------------------------------------------------------------------------------------------------------------------------------------------------------------------------------------------------------
----------------------------------------------------------------------------------------------------------o----------------S----S------------------------------------------------------------------------S-----S---------S-----------------------------------------------------o-----------------------------------------------------------------------------------------------------
----------------------------T-----------------------------------------------------------------------------------------T-------------------------------------------------------------------#----------T-----#--------T-----------------------T-------------#-----------------------------------------------------T--------------------------------------------------------T-----------
-----------------T----------T---------------------------------------------T-------------------------------------T-----T-----------------------------------------------------T-------------#----------T-----#--------T-----------------------T-------------#-----------------------------------------------------T---------------------------------------------TT---------T-----------
-----------------T----------T-#------------------#----------------------#-T-----#-------------------------------T-----T------------#----------------------------------------T-------------#----------T-----#--------T-----------------------T-T-----------#--------------T--------t-----------------------------T-----------------------#---------------------TT---------T-------F---
-M-----------g---T-g--------T-#------kk-k-----g--#-g--------------------#-T-----#-gg----------gg----------------T-k---T------------#-g--------------------------------------T-g------g-k--#-----g-k--T-----#--------T--------k---k-g-g------T-T-k-----k---#----k------k--T--------t-----------k-----------g--k--T--------kk---------k---#----------g----------TT-------g-T---g---#-k-
XXXX-XXXXXXXXXXXXXXXXXXXXX-XXXXXX-XXXXXXXXXXXXXXXXXXXXXXXX-XXXXXX-XX-XXXXXX-X-XXXXXXXXXXXXX-XXXXXXXXXXXX-XXXXXXXXXXXXXXXXXXXX-XXXXXXXXXXXXXXX-XXX--XXXXX-XXXXXXX-XXXXXXXXXXXXXXXXXXXXXXXXXXXXXXXXXXXXXX-XXXXX-XXXXXXXX-XXXXXXXXXXXXXXXXXXXX-XXXXXXXXXXXXXXXXX-XXXXXXXXXXXXXXXX---XXXX-XXXXX-XXXXX-XXXX-XXXXXXXXXXXXXXXX-XXXXXXXXXXXXXXX-XXXXX--XXXXXXXXXX-XXX-XXXXXXXXXXXXXXXXXXXXXXX
XXXX-XXXXXXXXXXXXXXXXXXXXX-XXXXXX-XXXXXXXXXXXXXXXXXXXXXXXX-XXXXXX-XX-XXXXXX-X-XXXXXXXXXXXXX-XXXXXXXXXXXX-XXXXXXXXXXXXXXXXXXXX-XXXXXXXXXXXXXXX-XXX--XXXXX-XXXXXXX-XXXXXXXXXXXXXXXXXXXXXXXXXXXXXXXXXXXXXX-XXXXX-XXXXXXXX-XXXXXXXXXXXXXXXXXXXX-XXXXXXXXXXXXXXXXX-XXXXXXXXXXXXXXXX---XXXX-XXXXX-XXXXX-XXXX-XXXXXXXXXXXXXXXX-XXXXXXXXXXXXXXX-XXXXX--XXXXXXXXXX-XXX-XXXXXXXXXXXXXXXXXXXXXXX
