---------------------------------------------------------------------------------------------------------------------------------------------------------------------
---------------------------------------------------------------------------------------------------------------------------------------------------------------------
---------------------------------------------------------------------------------------------------------------------------------------------------------------------
---------------------------------------------------------------------------------------------------------------------------------------------------------------------
-----------------------------------o----------------oo-----------------------o----------------o------------------o------------o-----------------------------o--------
---------------------------------------------------------------------------------------------------------------------------------------------------------------------
------------%%%%%%%---------o-------%%%---------------%-----------------------%----------------%-------------o----%%%%%--------%------------------------S----%-------
-------------|||||----------S-S------|-----------------------------------------------------------------------S-----|-|-------------------------------S---------------
-------------|||||-------------------|-----------------------------------------------------------------------------|-|-----------------------------------------------
-------------|||||-------------------|-----------------------------------------------------------------------------|-|-----------------------------------------------
-----------S-|||||%%%%%%%-%------S---|----------%-S-----------------------------------------S--------------%---S---|-|---------------------------S-%---%-------------
-------------|||||-|||||-------------|-----------------------------------------------------------------------------|-|-----------------------------------------------
-------------|||||-|||||-------------|-----------------------------------------------------------------------------|-|---------------------------------------------F-
-M-----------|||||-|||||-------------|-----------------------------------------------------------------------------|-|---------------------------------------------X-
XXXX--------%%%%%%%|||||---%---------|-XXXXXXXX--------XXXXXXXXXXXXXXXXXXX-----XXXXXXXXXXX------XXXXXXXXXX--%------|-|-XXXXX----XXXXXXXXXXXXXXX---------------XXXXXXX
XXXX---------|||||-|||||-------------|-XXXXXXXX--------XXXXXXXXXXXXXXXXXXX-----XXXXXXXXXXX------XXXXXXXXXX---------|-|-XXXXX----XXXXXXXXXXXXXXX---------------XXXXXXX
