------------------------------------------------------------------------------------------------------------------------------------------------------
------------------------------------------------------------------------------------------------------------------------------------------------------
------------------------------------------------------------------------------------------------------------------------------------------------------
------------------------------------------------------------------------------------------------------------------------------------------------------
------------------------------------------------------------------------------------------------------------------------------------------------------
-------------------------------------------------------------------------------------------------------------------oor---------------oo---------------
-----------------------oo-----------oo---------------------------oo------------------------------oo----------#----%%%%-----o-----------------oo-------
----------------------------%-------------------------%----------------------------------------%-------------#-----||---------------------------------
------------------------------------------------------------------------------------------------------------##-----||---------%----%------------------
------------------------SS-----------SSSS-------------------------SS----SS-------SS---------------SSSSS-----##-----||-------------------------SSS-----
-------------------%%%%--------%-------------------------------%-------------------------------------------###--%%%%%%%-----%-------------------------
--------------------||-------------------------------------------------------------------------------------###---|||||--------------------------------
--------------------||-------------------------------------------------------------------------------------###---|||||----------------%%%%%--------F--
--M-----------------||---------------------------------------------------r--------r--%---------------------###---|||||-----------------|||---------#--
XXXX--X-X---XXXXXX--||------------X---------XX-XXX-XX---XX-XXX---------XXXXXXXXXXXXX-----X-XXX----------XXXXXXX--|||||--X-------XX-----|||--------XXXX
XXXX--X-X---XXXXXX--||------------X---------XX-XXX-XX---XX-XXX---------XXXXXXXXXXXXX-----X-XXX----------XXXXXXX--|||||--X-------XX-----|||--------XXXX
