--------------------------------------------------------------------------------------------------------------------------------------------------------------------------------
--------------------------------------------------------------------------------------------------------------------------------------------------------------------------------
--------------------------------------------------------------------------------------------------------------------------------------------------------------------------------
--------------------------------------------------------------------------------------------------------------------------------------------------------------------------------
--------------------------------------------------------------------------------------------------------------------------------------------------------------------------------
--------------------------------------------------------------------------------------------------------------------------------------------------------------------------------
--------------SS---------------------USS-S-S---------------------------------------SS----S------------SSS-----------------S----S--------S---------------------------------------
--------------------------------------------------------------------------------------------------------------------------------------------------------------------------------
-------------------------------------------------------------------#------#-----------------------B-----------------------------------------------------------------------------
------------------------------------------------------------------##-----##-----------------------b-----------------------------------------------------------------------------
--------------SS-------------------------S-S--Q------------------###----###--------SS----S-------S#CS-SSS-----------------S-Q-SS--------S----------------Q----------------------
---------------------------T--T---#---B------------T--B---------####---####------#---------------------K----------K-#-T------------K--K----K---------#--------------------------
---------------------------T--T---#---b------------T--b---------####---####------#-------------B----K---------------#-T------------------------------#-----------T----B-----F---
-M-------------------------T--T---#---B------------T--b---------####---####------#-----------k-b--------------------#-T------------------------------#-----------T----b-----#---
XXXXXXXXXXXXXXXXXXXXXXXXXXXXXXXXXXXXXXXXXXXXXXXXXXXXXXXXXXXXXXXXXXXXXXXXXXXXXXX-XXXXXXXXXXXXXXXXXXXXXXXXXXXXXXXXXXXXXXXXXXXXXXXXXXXXXXXXXXXXX--XXXX-XXX-XXXX--XXXXXXXXXXXXXXXXXX
XXXXXXXXXXXXXXXXXXXXXXXXXXXXXXXXXXXXXXXXXXXXXXXXXXXXXXXXXXXXXXXXXXXXXXXXXXXXXXX-XXXXXXXXXXXXXXXXXXXXXXXXXXXXXXXXXXXXXXXXXXXXXXXXXXXXXXXXXXXXX--XXXX-XXX-XXXX--XXXXXXXXXXXXXXXXXX
