------------------------------------------------------------------------------------------------------------------------------------------------------
------------------------------------------------------------------------------------------------------------------------------------------------------
------------------------------------------------------------------------------------------------------------------------------------------------------
------------------------------------------------------------------------------------------------------------------------------------------------------
------------------------------------------------------------------------------------------------------------------------------------------------------
--------------oo-----oo-------------------ooooo---------------------oo----oo--------------------------------------------------------------------------
------------------------------------------%%%%%-----------------------------------------------#---ooo-------------------o-----------------------------
---------------------------------%-----SS--|||------------------------------------%-----------#---------------------%---------------------------------
-------------------------------------------|||--------------------%--------------------------##-------------------------------------------------------
----------SS-------------------------------|||-----------------------------------------------##-----SSSSSS--------------------------------------------
-------------------%-----------------------|||-----------------------SSSSS------------------###--%------------%----------%----------------------------
-----------------------------------------U-|||----------------------------------------------###-------------------------------------------------------
---------------%%%----%%%%%%%%%%-----------|||-----------------------------%%%%%%-----------###----------------------------------------------------F--
--M--------r----|------||||||||------------|||------------%-----------------||||------------###--------------o----%--------------------------------#--
XXXXX-XX-XXXX---|------||||||||----X-X---%%%%%%--X-XXXXXX-----XX------------||||------X--XXXXXXX-----------X-%--------X----XXXX-XXXXXX--X--XXXX--XXXXX
XXXXX-XX-XXXX---|------||||||||----X-X----||||---X-XXXXXX-----XX------------||||------X--XXXXXXX-----------X----------X----XXXX-XXXXXX--X--XXXX--XXXXX
