-------------------------------------------------------------------------------------------------------------------------------------------------------------------------------------------
-------------------------------------------------------------------------------------------------------------------------------------------------------------------------------------------
-------------------------------------------------------------------------------------------------------------------------------------------------------------------------------------------
S---SSSSSSSSSS--SSSSSSSSSSS-SSSSSSSSSS--SSSSSSSSSSSSSSSSSSSSSSSSSSSSSSSSSSSSSSSSSSSSSSSSSSSSSSSSSSSSSSSSSSSSSSSSSSSSSSSSSSSSSSSSSSSSSSSSSSSSSSSSSSSSSSSSSSSSSSSSSSSSSSSSSSSSSSSSSSSSSSSSSSS
S------------------------------------------------------------------------SSSSSSSSSSSS------------------------------------------------------------------------------------------------------
S------------------------------------------------------------------------SSSSSSSSSSSS------------------------------------------------------------------------------------------------------
S------------------------------------------------------------------------SSSSSSSSSSSS-------------Q-Q--Q-----------------------------------------------------------------------------------
S-----------------------------------T----------------------------------------------------------------------------------------------------------------------------------------------T-------
S-----------------------------------T----------------------------------------------------------------------------------------------------------------------------------------------T-------
S-----------------------------------T--------------------------------------------------------------------------------------S-------------------------------------------------------T-------
S-------T--------T----T--------T----TS----------TT-------------------------SSSSSSS?-S-------------Q-Q--Q-----------------------------------------------------------T---------------T------F
S-------T----#---T----T---#----T----T---------#-TT----T-T---#------T-------SSSSSS---S-----------------------------#-------------------------------T------#---------T--------T------T-----SS
S-------T---##---T----T--##----T----T--------##-TT----T-T---#------T--t----SSSSSS---S------t---------------------##-------------------------------T-----##---------T--------T------T-----SS
S-M-----T---##---T----T--##----T---kT-------###-TT----T-T---#------T--t----------oooS------t--------------------###----k----kk--------------------T----###-----k---T--------T-----kT-----SS
XXXXXXXXX-XXXX---X-XXXX-XXX--XXX-XXXXX-----XXXX-XX--XXXXXXX-X-X--XXXXXXX--XXXXXXXXXXXX-XXXXXX--X-XXXXXXXXX-XXX-XXXX-XXXXXXXXXXXX---XXXXXXX-XXX---XXXX-XXXX--XXXXXXXX-X-XXXXXXX-XXXXXXXXX-XX
XXXXXXXXX-XXXX---X-XXXX-XXX--XXX-XXXXX-----XXXX-XX--XXXXXXX-X-X--XXXXXXX--XXXXXXXXXXXX-XXXXXX--X-XXXXXXXXX-XXX-XXXX-XXXXXXXXXXXX---XXXXXXX-XXX---XXXX-XXXX--XXXXXXXX-X-XXXXXXX-XXXXXXXXX-XX
