------------------------------------------------------------------------------------------------------------------------------------------------------------------------------------------------------------------------------
------------------------------------------------------------------------------------------------------------------------------------------------------------------------------------------------------------------------------
------------------------------------------------------------------------------------------------------------------------------------------------------------------------------------------------------------------------------
------------------------------------------------------------------------------------------------------------------------------------------------------------------------------------------------------------------------------
------------------------------------------------------------------------------------------------------------------------------------------------------------------------------------------------------------------------------
------------------------------------------------------------------------------------------------------------------------------------------------------------------------------------------------------------------------------
------------------------------------------------------------------------------------------Q----------------------------------------------------------------------Q----------------------------------------------Q-------------
-------o------------------------------------------------------o----------o--------------------------o-------------------------------------------------------------------------------------------------------------------------
------------------------------------------------------------------------------------------------------------------------------------------------------------------------------------------------------------------------------
------------------------------------------------------------------------------------------------------------------------------------------------------------------------------------------------------------------------------
----------------------------------Q--T--------T-------------------------------------------Q----T-----------------------------T--Q-------Q------------------------?---------Q---Q-----------Q--------------------Q-------------
-------------------------------------T--------T------------------------------------------------T-----------------------------T------------------------#----------------------T-----------------------------------------#------
-------------------------------------T--------T--T---------------------------------------------T-----------------------------T------------------------#----------------------T-----------------------------------------#--F---
-M-----------------------------------T--------T--T----------------------------y----------------T-------y-y-------------------T------------------------#----------------------T-----------------------------------------#--#---
XXXXXXXXXXXXXXXXXXXX-XXX-XXXXXXXXXXXXXXXX--X-XXXXXXXXXXXXXXXXXXXXXXXXXXXXXX-XXXXXXXXXXXXXXXXXXXXX-XXXXXXXXXXXXXXXXXXXXXX-XXXXXXXXXXXXXXXXXXXXXXXXXXXXXXXXXXX-XXXXXXX-XXXXXXXXXXXXXX-XXXXXXXXXXXXXXXX-XXX-X-XX-XXXXXXXXXXXXXXXX
XXXXXXXXXXXXXXXXXXXX-XXX-XXXXXXXXXXXXXXXX--X-XXXXXXXXXXXXXXXXXXXXXXXXXXXXXX-XXXXXXXXXXXXXXXXXXXXX-XXXXXXXXXXXXXXXXXXXXXX-XXXXXXXXXXXXXXXXXXXXXXXXXXXXXXXXXXX-XXXXXXX-XXXXXXXXXXXXXX-XXXXXXXXXXXXXXXX-XXX-X-XX-XXXXXXXXXXXXXXXX
