----------------------------------------------------------------------------------------------------------------------------------------------------------------------------------------
----------------------------------------------------------------------------------------------------------------------------------------------------------------------------------------
----------------------------------------------------------------------------------------------------------------------------------------------------------------------------------------
----------------------------------------------------------------------------------------------------------------------------------------------------------------------------------------
----------------------------------------------------------------------------------------------------------------------------------------------------------------------------------------
----------------------------------------------------------------------------------------------------------------------------------------------------------------------------------------
-----------------------------------------------------------------------------------------------------------------------------------------------------#----------------------------------
-----------------------------------------------------------------------------------------------------------------------------------------------------#----------------------------------
-------------------------y---------------------------------------------------------------------------------------------------------------------------#-----------------oo---------------
-------------------------#---------------------o------------------o----------------------------------------------------------------------------?Q----#------------------------o---------
---------------o--------##-------#----------------------------Q---------------------------------------------------------------Q----------------------#----------------------------------
----------------------y###------##---------------------------------------------------T---------------------------------------------------------------#--------#-------------------------
----------------------####-----###---------------------------------------------------T------------------------------------------------------------y--#-------##---------------------F---
-y--M----------------#####--y-####------y------------------------------------y----y--T--------------y---y--------------------------------------SSSS--#-------------y--------------y-#---
XXXXXXXXX--XXXXXX-X-XXXXXX-XXXXXXX-XXXXXXXX-XXXXXXXXXXX-X-XXXXXXXXXXXXXXX-XXXXXXXXXXXXXXXXX-X-XXXXXXXXXXXXXXXXXXX-XX-XXX-XXXXXXXX-X-XX-XXXXXXX----XX-XXX-XX-XXXXXXXXXX--XXXXXXXXXXXXXXXX
XXXXXXXXX--XXXXXX-X-XXXXXX-XXXXXXX-XXXXXXXX-XXXXXXXXXXX-X-XXXXXXXXXXXXXXX-XXXXXXXXXXXXXXXXX-X-XXXXXXXXXXXXXXXXXXX-XX-XXX-XXXXXXXX-X-XX-XXXXXXX----XX-XXX-XX-XXXXXXXXXX--XXXXXXXXXXXXXXXX
