----------------------------------------------------------------------------------------------------------------------------------------------------------------------------------------
----------------------------------------------------------------------------------------------------------------------------------------------------------------------------------------
----------------------------------------------------------------------------------------------------------------------------------------------------------------------------------------
----------------------------------------------------------------------------------------------------------------------------------------------------------------------------------------
----------------------------------------------------------------------------------------------------------------------------------------------------------------------------------------
----------------------------------------------------------------------------------------------------------------------------------------------------------------------------------------
-------------------#-----##--------------------------------------#---------------------------------------------------------------------------------------#------------------------------
-------------------#-----##------------------------------y-------#---------------------------------------------------------------------------------------#------------------------------
-------------------#-----##----------------------------#SS--o----#----------------------y----------------------------------------------------------------#------------------------------
-------------------#-----##---------------------------##---------#----------------------XS---------------------------o----------------o-o----------------#------------------------------
-------------------#-----##---------------------------##--SC-----#---------------------XX------------------Q----------------------------------o----------#--------------Q------SC-------
-------------------#-----##------#--------------------##---------#--------------------XXX-------------------------------------------------------T----T---#------------------------------
-------------------#-----##-----##--------------------##---SSS---#-------------------XXXX-------------------------------------------------------T----T---#--------------------------F---
----M--------------#-----##---------------y-y---------##---------#------------------XXXXX------------------------------------y--------------y---T----T---#-y-y---y------------------#-y-
XX-XXXX-XX---XXXXX-XXX-X-XXXXXXXXXX-XXXXXXXXXXXXX-XXXXXX------X--XXXXXXXXXXX-X-X-XXXXXXXX--XX-XXXXX--X--XXXXXXXXXXX-XXXX-XXXXXXXX-XXXXXXXXXXXXXXXX-XXXXX-XXXXXX-XXXXXXXXXX-XXX-XXXXXXXXX
XX-XXXX-XX---XXXXX-XXX-X-XXXXXXXXXX-XXXXXXXXXXXXX-XXXXXX------X--XXXXXXXXXXX-X-X-XXXXXXXX--XX-XXXXX--X--XXXXXXXXXXX-XXXX-XXXXXXXX-XXXXXXXXXXXXXXXX-XXXXX-XXXXXX-XXXXXXXXXX-XXX-XXXXXXXXX
