------------------------------------------------------------------------------------------------------------------------------------------------------
------------------------------------------------------------------------------------------------------------------------------------------------------
------------------------------------------------------------------------------------------------------------------------------------------------------
------------------------------------------------------------------------------------------------------------------------------------------------------
------------------------------------------------------------------------------------------------------------------------------------------------------
-------------------R----------------oo------------------------------%---------------------------------------------------------------------------------
---------------------------------------------------------------------------o---------#----------------------------------------------------------------
----%----------------------------%---------------------------------------------------#----------------------------------------------------------------
------------------------------------------------------------------------------------##----------------------------------------------------------------
-------------------------------------------------------------------%----------------##-----S----------------------------------------------------------
-------------------------------%-----SS--------------------%%%%%%---------%-%------###--------------%%%---%-------%-%-------%%%------------%----------
------------------------------------------------------------|-||-------------------###---------------|-----------------------|------------------------
------------------------------------------------------------|-||-------------------###---------------|-----------------------|---------------------F--
-M------%--------------%------------------------------------|-||--%------------%---###---------------|-----------------------|---------------------#--
XXX-------%%%---XX---X---%-X-X-------------XX-----XXXXXXX-%-|-||-------XX--------XXXXXX---------X-%--|---%---X---%-----XXX---|-----XX-X-X-----XX-XXXXX
XXX--------|----XX---X-----X-X-------------XX-----XXXXXXX---|-||-------XX--------XXXXXX---------X----|-------X---------XXX---|-----XX-X-X-----XX-XXXXX
