---------------------------------------------------------------------------------------------------------------------------------------------------------------------
---------------------------------------------------------------------------------------------------------------------------------------------------------------------
---------------------------------------------------------------------------------------------------------------------------------------------------------------------
---------------------------------------------------------------------------------------------------------------------------------------------------------------------
--------o----------------------------------------------------------o-------------------o--------------------o-------o---------------------------------------o--------
---------------------------------------------------------------------------------------------------------------------------------------------------------------------
------S--%----%%%%%%%%%%%%%--------------S-S-S--------------o-S-----%-------------------%%%%-----------------%-------%------------------------SSSo--------S--%%%-----
---------------|||||||||||----------------------------------S------------------------S---||-------------------------------------------------------------------|------
---------------|||||||||||---------------------------------------------------------------||-------------------------------------------------------------------|------
---------------|||||||||||---------------------------------------------------------------||-------------------------------------------------------------------|------
------------SS-|||||||||||%%%%%%%%%%%%%%%--------%%%%%-----------------------------------||-------------------------------------------------------S--SSS------|------
---------------|||||||||||-|||||-|-|||||-------S--|-|-----------S------------------------||-------------------------------------------------------------------|------
---------------|||||||||||-|||||-|-|||||----------|-|------------------------------------||-------------------------------------------------------------------|----F-
-M-------------|||||||||||-|||||-|-|||||----------|-|------------------------------------||-------------------------------------------------------------------|----X-
XXXXX-----X---%%%%%%%%%%%%%|||||-|%|||||----------|-|%%%%%%%---------XXXXXXXXXXXXXXX-----||-XXXXXXXXXXXXXXX---XXXXX---XXXXXXXXXXXXXXXXXXXXXXX-----------------|-XXXXX
XXXXX-----X----|||||||||||-|||||-|-|||||----------|-|-|-|||----------XXXXXXXXXXXXXXX-----||-XXXXXXXXXXXXXXX---XXXXX---XXXXXXXXXXXXXXXXXXXXXXX-----------------|-XXXXX
