----------------------------------------------------------------------------------------------------------------------------------------------------------------------------------------------------------
----------------------------------------------------------------------------------------------------------------------------------------------------------------------------------------------------------
----------------------------------------------------------------------------------------------------------------------------------------------------------------------------------------------------------
-----------------------------------------------------------------------------SS--------SSSSSSS-----------------------------------------------SS---------------------SS------------------------------------
---------------------------------------o------------------------------------------------------------------------------------------------------------------------------------------------------------------
----------------------------------------------------------------------------------------------------------------------------------------------------------------------------------------------------------
---------------SS-------S-------S--------------------------------S---------S----------------------S--------------------------S--S----------------------------------------------------------S------S-------
----------------------------------------o------------------------------------------------T----------------------------------------------o-----------------------------------------------------------------
-----------------------------------------------------------------------------------------T--------------------------------------------------------------------#-------------------------------------------
--------------------------S-------------------o----------------------o-------------------T----------------------------------o-------------------o---------#---#----------------------S--------------------
-----------------------------S--S----------------------S---------S------------S----------T---g-------##------------------!---S--------!S------Q-----------#---#------Q------S-----------------------------
-------T------------------------K--------------------------#-----K--------------#--------T---##------##---------------------------------------------#-----#---#------------------#------------------------
-------T----------T--------------------------T------------##--------------------#--------T---##------##----------B-T--#----------------------------##-----#---#------------------#------------T--------F--
-Mg----T----------T----------------g-------#-T-----------------k----k---o-------#--------T-g-##------##----------b-T--#--k----g--g------yk-g--------------#---#k-------------y---#--------g-g-T--------#--
XXXXXXXX-XXXXXXXXXXXX-XXXXXXXXXXXX-XXXX-%-XXXXXXXX-XXXXXXXXXX-XXXXXXX-X-%-XXXXX-XXXXXXXXXXXXXXXX-XXXXXXXXXXX-XX-XXXXXXXXXXXXXXXXXXXXXXXXXXXXXXX--XXXXXXXXXXX--XXXX-XXX-XXXXXXXXXXXXX-XXXXXX-XXXXXXXXXXXXXX
XXXXXXXX-XXXXXXXXXXXX-XXXXXXXXXXXX-XXXX---XXXXXXXX-XXXXXXXXXX-XXXXXXX-X---XXXXX-XXXXXXXXXXXXXXXX-XXXXXXXXXXX-XX-XXXXXXXXXXXXXXXXXXXXXXXXXXXXXXX--XXXXXXXXXXX--XXXX-XXX-XXXXXXXXXXXXX-XXXXXX-XXXXXXXXXXXXXX
