----------------------------------------------------------------------------------------------------------------------------------------------------------------------------------------
----------------------------------------------------------------------------------------------------------------------------------------------------------------------------------------
----------------------------------------------------------------------------------------------------------------------------------------------------------------------------------------
----------------------------------------------------------------------------------------------------------------------------------------------------------------------------------------
----------------------------------------------------------------------------------------------------------------------------------------------------------------------------------------
----------------------------------------------------------------------------------------------------------------------------------------------------------------------------------------
-------------------------------#---------------------------------#-----------------------------------------#---------##-----#--------------------------------------##-------------------
-------------------------------#---------------------------------#-----------------------------------------#---------##-----#--------------------------------------##-------------------
-------------------------------#---------------------------------#---------------------------------------y-#---------##-----#--------------------------------------##------oo-----------
-------------------------------#----------------------o----------#----------o----------------------------#-#---?Q----##-----#-----------------o--------------------##-------------------
------------o------------------#--o---o--------------------------#---------------#---------o------------##-#---------##-----#-------------Q-o----------------------##-------------------
----------------------------#--#---------------------------------#-------------y##-----#-------T-------###-#---------##-----#--------------------------------------##-----------------T-
---------------------------##--#---------------------------------#-------------###----##-------T------####-#------y--##-----#--------------------------------------##---------------F-T-
-y--M--------------------------#-------------y--y-y--------------#------------####-------------T-----#####-#---SSSS--##-----#--y---------------------------y-------##-y-------------#-T-
XXXXXXXXXXXXXXXXXXXX--XXXXXXXX-XXXXXXXXXXXXXXXXXXXXXXXXXXXXXXXXX-XXXX-XXXX-XXXXXXX-X-XXXXXXXXXXXXX--XXXXXX-XXX----XX-XXXXXX-XXXXX-XXXXXX-XXXXXXXXXXXX-XXXXXXXXXXXX-XXXXXXX--XXXXXXXXXXXX
XXXXXXXXXXXXXXXXXXXX--XXXXXXXX-XXXXXXXXXXXXXXXXXXXXXXXXXXXXXXXXX-XXXX-XXXX-XXXXXXX-X-XXXXXXXXXXXXX--XXXXXX-XXX----XX-XXXXXX-XXXXX-XXXXXX-XXXXXXXXXXXX-XXXXXXXXXXXX-XXXXXXX--XXXXXXXXXXXX
