-----------------------------------------------------------------------------------------------------------------------------------------------------
-----------------------------------------------------------------------------------------------------------------------------------------------------
-----------------------------------------------------------------------------------------------------------------------------------------------------
-----------------------------------------------------------------------------------------------------------------------------------------------------
-----------------------------------------------------------------------------------------------------------------------------------------------------
-------------------------------------------SSS---------oooo---------------------------------------------%-------SSS---------------%------------------
-------------------S----------------------------------%%%%%%----------------------o--------------------------------------S------------------o---S----
-----o-------ooo-------------------------g-------------||||--o----S--o-----ooo--------------S----o------------g-----------------------o-----SSS------
---------------------------------------%%%%------------||||-%%%-----------------%--------SS-----%%%-%-%-----%%%%----------------%----%%%-%-----------
--------------------S-------------------||----SSS------||||--|--------------------S--------------|-----------||----SSSS---S-----------|----------S---
--------------%%%%----------r-r--r------||-------------||||--|--------------%%%%-----------------|-----------||-----------------------|--------------
---------------||---------%%%%%%%%%%%%%%||-------------||||-o|---------------||-------%%%%-------|--------%%%||-----------------------|--------------
---------------||----------||||||||||||-||-------------||||%%%%%-------------||%%%-----||--------|---------|-||-----------------------|------------F-
-M--%%%%%%%%%%-||----------||||||||||||-||----oo-------||||-|||-----%%%%%%%%-||-|------||--------|-r-------|-||----oo-----------------|-r----------#-
XXX--||||||||--||----XXXX--||||||||||||-||---%%%-X-----||||-|||------||||||--||-|----%-||-------%%%%%%%%%%-|-||---%%%------X--%%%%%%%%%%%%%%------XXX
XXX--||||||||--||----XXXX--||||||||||||-||----|--X-----||||-|||------||||||--||-|------||--------||||||||--|-||----|-------X---||||-|||||||-------XXX
