------------------------------------------------------------------------------------------------------------------------------------------------------
------------------------------------------------------------------------------------------------------------------------------------------------------
------------------------------------------------------------------------------------------------------------------------------------------------------
--------------------------------------------------------------------------------------------------o---------------------------------------------------
------------------------------------------------------------------------------------------------------------------------------------------------------
----------%------------------------------------------------------------------------------oo---------%----------------------------------------oo-------
-----------------------------------------------------------------------------------------------------------#-------------------------oo-oo------------
-----------------------------------------------------------------------------------------------------------#------------------------------------------
--------------------------------------------%----------------------------%--------------------------------##------------------------------------------
---------%---------------------------------------------------------------------S-------S--------%%%%------##------------------S----------SS-----------
----------------------%--------%%%%%------%------------------------------------------------------||------###--------------%---------%--%------SS------
--------------------------------|||--------------------------------------------------------------||------###------------------------------------------
--------------------------------|||-------------------------------------------------------%%%----||------###---------------------------------------F--
-M------%-----------------------|||--------------------------------------------------------|---%-||------###---------------------------------------#--
XXX---X------X--XX-XX-----XX-X--|||--X-X------XXX-XX-X-X-X-X-%-%-XXX-XXX---%%%----X--------|-----||---XXXXXXX-XX----X-X-%---X----%%%-------------XXXXX
XXX---X------X--XX-XX-----XX-X--|||--X-X------XXX-XX-X-X-X-X-----XXX-XXX----|-----X--------|-----||---XXXXXXX-XX----X-X-----X-----|--------------XXXXX
