----------------------------------------------------------------------------------------------------------------------------------------------------------------------------------------
----------------------------------------------------------------------------------------------------------------------------------------------------------------------------------------
----------------------------------------------------------------------------------------------------------------------------------------------------------------------------------------
----------------------------------------------------------------------------------------------------------------------------------------------------------------------------------------
----------------------------------------------------------------------------------------------------------------------------------------------------------------------------------------
----------------------------------------------------------------------------------------------------------------------------------------------------------------------------------------
-------------------------------------------------------------------------------------------------------------------------------##----------------------------------y--------------------
-------------------------------------------------------------------------------------------------------------------------------##--------------------------------#SSS-------------------
-----------------------------oo------------------------------------------------------------------------------------------------##-------------------------------##----------------------
-----------------o---------------------------------------------------------o---------o-------------o---------------------------##-----?Q--------------o--------###1---------------------
--------------------------------o-----------------------------------------------o-------------------------------SC-------------##-------------------o----------###----------------------
-----------------------------------------#-------------------------T------------------------T-T----------T---------------------##------------------------------###--SSSS----------------
----------------------------------------##-------------------------T------------------------T-T----------T---------------------##-------------y----------------###------------------F---
----M--y-----------------------------------------y------------y-y--T------------------------T-T----------T-y-------------------##-y---SSSSSSSSS------------y---###------------------#---
XX-XXXXXX--X-XXXXXXXX-XXX-XX--XXXXXXXX-XXXXXXXXXXXXXXXX-XXX-XXXXXXXXXX-XXXXXXX-XXXXXXXXX-XXXXXXXXXXXXXX-XXXXXX--XXXXXXXXXXXXXX-XXXXXX---------XX-XXXXXXXXXXXXXXXXXXXX----XXXXX-XXXXXXXXX
XX-XXXXXX--X-XXXXXXXX-XXX-XX--XXXXXXXX-XXXXXXXXXXXXXXXX-XXX-XXXXXXXXXX-XXXXXXX-XXXXXXXXX-XXXXXXXXXXXXXX-XXXXXX--XXXXXXXXXXXXXX-XXXXXX---------XX-XXXXXXXXXXXXXXXXXXXX----XXXXX-XXXXXXXXX
