----------------------------------------------------------------------------------------------------------------------------------------------------------------------------------------------------------
----------------------------------------------------------------------------------------------------------------------------------------------------------------------------------------------------------
----------------------------------------------------------------------------------------------------------------------------------------------------------------------------------------------------------
----------------------------------------------------------------------------------------------------------------------------------------------------------------------------------------------------------
----------------------------------------------------------------------------------------------------------------------------------------------------------------------------------------------------------
----------------------------------------------------------------------------------------------------------------------------------------------------------------------------------------------------------
----------------S-----S-----------------------S----S-------------S-------------------------------S-----------------S!-S-------------------S---------SS----------------------S-----------------------------
----------------------------------------------------------------------------------------------------------------------------------------------------------------------------------------------------------
----------------------------------------------------------------------------------------------------------------------------------------------------------------------------------------------------------
--------------------------------------------------------1-------------------------------------------------------------------------------------------------------------------------------------------------
---------S---------------#-#----!--------S--------------------!------#-#-S-#------t------------------------#--S-!---C-------------------#---------------t--------------S-----------#---------t-----S------
-------------------------###-----------------------------------------###---#------t------------------------#--------------t-------------#-----t---------t--t-----------------------#---------t------------
-----t------t------------###-----------------------------------------###---#------t------t-t---------------#--------------t-------------#-----t---------t--t--------------t--------#---------t--------F---
-#-M-t------t------------###-------g----------------------------g----###---#------t------t-t-g-----------#-#---------g--g-t-------------#-----t---------t--t---------g----t--g---g-#---------t-g-#----#-g-
XXXXXXXXXXXXXXXXXXXXXXXXXXXX-XXXXXXXXXXXXXXX-XXXXXXXXXXXXXXXXXXXXXXXXXXXXXXXXX-XXXXXX-XXXXXXXXXXXXXXXXXXXXXXXXXXXXXXXXXXXXXXXXX-XXXXXXXXXXXXXXXXXXXXXXXXXXXXXXXXXXXXXXXXXXXXXXXXXXXXXXX-XXXXXXXXXXXXXXXXXX
XXXXXXXXXXXXXXXXXXXXXXXXXXXX-XXXXXXXXXXXXXXX-XXXXXXXXXXXXXXXXXXXXXXXXXXXXXXXXX-XXXXXX-XXXXXXXXXXXXXXXXXXXXXXXXXXXXXXXXXXXXXXXXX-XXXXXXXXXXXXXXXXXXXXXXXXXXXXXXXXXXXXXXXXXXXXXXXXXXXXXXX-XXXXXXXXXXXXXXXXXX
