----------------------------------------------------------------------------------------------------------------------------------------------------------------------------------------
----------------------------------------------------------------------------------------------------------------------------------------------------------------------------------------
----------------------------------------------------------------------------------------------------------------------------------------------------------------------------------------
----------------------------------------------------------------------------------------------------------------------------------------------------------------------------------------
----------------------------------------------------------------------------------------------------------------------------------------------------------------------------------------
----------------------------------------------------------------------------------------------------------------------------------------------------------------------------------------
--------------------------------#---------------------------------------------------------------------------------------------------------------------------------#---------------------
--------------------------------#------------------------------------------------------------------------------------------------------------------y--------------#---------------------
--------------------------------#--------------------------------------------------------------------------------------y------oo-----------------#SS--o-----------#---------------------
--------------------------------#-o---------------------o------------------------------------------o-------------------XS-----------------------##----------------#---------------------
--------------------o-----------#--------------------------------------o----------------------------------------------XX-------------SC---------##--SC------------#---------------------
--------------------------------#----------------#--T-----------------------------------------------------#----------XXX------------------------##----------------#------------#--------
--------------------------------#---------------##--T----------------------------------------------------##---------XXXX------------------------##---SSS----------#-----------##----F---
----M-------------y---y---------#-------y-----------T-------------y------------------------------------------y-----XXXXX----------------y-------##-------------y--#--------y--------#---
XXXXXX-XXXXX-XXXXXXXXXXXXX-XXXX-XXXXXXXXXX-X-XXXXXXXXXXXXXXX-XXXXXXXXXXXXX-XXXXXXX-XXXXXXXXXXXXXXXXXXXXXXXXXXXXXXXXXXXXX--X-X--XXXXX-XXXXXXXXXXXXX------XX-XXXXXX-XXXXX-XXXXXXXXXXXXXXXX
XXXXXX-XXXXX-XXXXXXXXXXXXX-XXXX-XXXXXXXXXX-X-XXXXXXXXXXXXXXX-XXXXXXXXXXXXX-XXXXXXX-XXXXXXXXXXXXXXXXXXXXXXXXXXXXXXXXXXXXX--X-X--XXXXX-XXXXXXXXXXXXX------XX-XXXXXX-XXXXX-XXXXXXXXXXXXXXXX
