------------------------------------------------------------------------------------------------------------------------------------------------------------------------------------------------------
------------------------------------------------------------------------------------------------------------------------------------------------------------------------------------------------------
------------------------------------------------------------------------------------------------------------------------------------------------------------------------------------------------------
------------------------------------------------------------------------------------------------------------------------------------------------------------------------------------------------------
------------------------------------------------------------------------------------------------------------------------------------------------------------------------------------------------------
------------------------------------------------------------------------------------------------------------------------------------------------------------------------------------------------------
------------#--------------------------------------------------#--------------------------------------------------------------------------------------------------------------------------------------
------------#--------------------------------------------------#--------------------------------------------------------------------------------------------------------------------------------------
------------#--------------------------------------------------#--------------------------------------------------------------------------------------------------------------------------------------
------------#--------------------------------------K-----------#--------------------------------------------------------------------------#------------------#----------------------------------------
------------#--------------------------------------------------#-------------------------------------------------------------------------##-----------------##----------------------------------------
------------#----K-----------------------------------#---------#-----------------------------------------------------------K-------------##-----------------##----------------------------------------
----------------------------------------------------##-*-T---------------------------------------------T---------------------T----------K##-------------*--K##------------------------------------F---
-M--gg----g--------g-----g------K-K----------------###-*-T---------------g-----g----k--------k---------T---g--------g-k------T-----------##-------g---g-*---##-----g---------gg--------gg-gg------#-g-
XXXXXXXXXXXXXXXXXXXXXXXXXXXXX-XXXXXXX-XXXXXXXXXXXXXXXXXXXXXXXXXXXXXX-XXXXXXXXXXXXXXXXXXXXXXXXXXXXXXXXXXXXXXXX--XXXXXXXXXXXXXXXXXX-XXXXXXXXXXXXXXXXXXXXXXXXXXXXXXXXXXXXXXX-XXXXXXXXXXXXXXXXXXXXXXXXXXXX
XXXXXXXXXXXXXXXXXXXXXXXXXXXXX-XXXXXXX-XXXXXXXXXXXXXXXXXXXXXXXXXXXXXX-XXXXXXXXXXXXXXXXXXXXXXXXXXXXXXXXXXXXXXXX--XXXXXXXXXXXXXXXXXX-XXXXXXXXXXXXXXXXXXXXXXXXXXXXXXXXXXXXXXX-XXXXXXXXXXXXXXXXXXXXXXXXXXXX
