------------------------------------------------------------------------------------------------------------------------------------------------------------------------------------------------------
------------------------------------------------------------------------------------------------------------------------------------------------------------------------------------------------------
------------------------------------------------------------------------------------------------------------------------------------------------------------------------------------------------------
------------------------------------------------------------------------------------------------------------------------------------------------------------------------------------------------------
------------------------------------------------------------------------------------------------------------------------------------------------------------------------------------------------------
------------------------------------------------------------------------------------------------------------------------------------------------------------------------------------------------------
---------------------#--------------------------------------------------------------------------------------------------------------#-----------------------------------------------------------------
---------------------#--------------------------------------------------------------------------------------------------------------#-----------------------------------------------------------------
---------------------#-------------T------------------------------------------------------------------------------------------------#-----------------------------------------------------------------
---------------------#-------------T----K--------------------------------------------------K----------------------------------------#-----------------------------------------------------------------
---------------------#-------------#------------------------------------------------------------------------------------------------#-----------------------------------------------------------------
---------------------#--------------------#--------------------------------------------------#--------------------------------------#-----------------------------------------------------------------
-----------------------------*-------T---##----------------------------------*--------------##-------------------------------------------T--------------T-----------------------------------T--T--F---
-M-----g-g-g---g-------------*-------T--###----g-------------g----g--g-g--g--*--g--g--k-gg-###------g----------g--g---g-g--------k-------T-g------------T-------g-------------------gg------T--T--#---
XXXXXXXXXXXXXXXXXXXXXXXXXXXXXXXXXXXXXXXXXXXX-XXXXXXXXXXXXXXXXXXX-XXXXXXXXXXXXXXXXXXXXXXXXXXXXXXXXXXXXXXXXXXXXXXXXXXXXXXXXXX-XX-XXXXXXXXXXXXXXXXXXXXXX-XXXXXXXX-XXXXXXXXXXXXXX-XXXXXXXXXXXXXXXXXXXXXXXX
XXXXXXXXXXXXXXXXXXXXXXXXXXXXXXXXXXXXXXXXXXXX-XXXXXXXXXXXXXXXXXXX-XXXXXXXXXXXXXXXXXXXXXXXXXXXXXXXXXXXXXXXXXXXXXXXXXXXXXXXXXX-XX-XXXXXXXXXXXXXXXXXXXXXX-XXXXXXXX-XXXXXXXXXXXXXX-XXXXXXXXXXXXXXXXXXXXXXXX
