------------------------------------------------------------------------------------------------------------------------------------------------------------------------------------------------------------------------------
------------------------------------------------------------------------------------------------------------------------------------------------------------------------------------------------------------------------------
------------------------------------------------------------------------------------------------------------------------------------------------------------------------------------------------------------------------------
------------------------------------------------------------------------------------------------------------------------------------------------------------------------------------------------------------------------------
------------------------------------------------------------------------------------------------------------------------------------------------------------------------------------------------------------------------------
------------------------------------------------------------------------------------------------------------------------------------------------------------------------------------------------------------------------------
----------------------------------------------------------------Q------------------Q------------------------------------------------------------------------------------------------------------------------------------------
------------------------------o----------------------------o---------------------o-------------------------------------o------------------------------------------------o------------------------o---------o------o-----------
------------------------------------------------------------------------------------------------------------------------------------------------------------------------------------------------------------------------------
------------------------------------------------------------------------------------------------------------------------------------------------------------------------------------------------------------------------------
-------T------------------------------T------T----o--T--Q-------Q----------Q-------Q------------------Q---------------------------------------------------Q----------------T-----------T--------------------------------------
-------T---------------------------#--T------T-------T-------------------------------------#--------------------T------------T---------------------------------------------T-----------T--------------------------------------
-------T--------------------------##--T------T-------T------------------------------------##--------------------T---T--------T---------------------------------------------T-----------T----------------------------------F---
-M-----T-------------------------###--T------T-------T---------------y-------------------###--------------------T---T--------T----y----------------y-----------------------T-y---------T-----------------------------y----#---
XXXXXXXXXXX-XXXXXX-XX-XXXXXXXXXXXXXXXXXXXXXXXXXXXXXXXXXXXXXXXX-XXXXXXXXXXXXXXXXXXXXXXXXXXXXXXXXXXXXXXXXXXXXXXXXXXXXXXXXXXXXXXXXXXXXXXXXXXXXXXX-XXXXXXXXX-XXXXXXXXXXXXXXXXXXXXXXXXXXXXXXXXXXX-XXXXXXXXXXX-XXXXXXXXXXXXXXXXXXXXX
XXXXXXXXXXX-XXXXXX-XX-XXXXXXXXXXXXXXXXXXXXXXXXXXXXXXXXXXXXXXXX-XXXXXXXXXXXXXXXXXXXXXXXXXXXXXXXXXXXXXXXXXXXXXXXXXXXXXXXXXXXXXXXXXXXXXXXXXXXXXXX-XXXXXXXXX-XXXXXXXXXXXXXXXXXXXXXXXXXXXXXXXXXXX-XXXXXXXXXXX-XXXXXXXXXXXXXXXXXXXXX
