------------------------------------------------------------------------------------------------------------------------------------------------------
------------------------------------------------------------------------------------------------------------------------------------------------------
------------------------------------------------------------------------------------------------------------------------------------------------------
------------------------------------------------------------------------------------------------------------------------------------------------------
------------------------------------------------------------------------------------------------------------------------------------------------------
------------------------oo----------------------------------------------R-------------------------------------------------------------ooo---%---------
------------o--------------------------------------------------------------------------------o----------------------------------------%%%-------------
----------------------------------------------------------------------------%----------------------------------------------------------|--------------
---------------------------------------------------------------------------------------------------------------------------------------|--------------
------------------------------------------S--------------------------------------------------------------------S-----------------------|---%----------
-------------%%%%-------------------------------------%---------------------------------------%------%%%%%-----------------------------|--------------
--------------||--------------------------------------------------------------------------------------|-|----------------------------U-|--------------
--------------||---------%%%--------------------------------------------------------------------------|-|------------------------------|-----------F--
-M------------||----------|--%%%%-------------------------------------%---------------%%%-------------|-|----%-------------------------|--%--------#--
XXX-XX-XXXX---||--XX-XX---|---||---XXX-X----XX-XXX-X-----XX--X-%--X-------X---XXXX-XX--|--%-----X-XX--|-|--X-----XXXXX--XXXXXX-XXX-X-%%%%------XXXXXXX
XXX-XX-XXXX---||--XX-XX---|---||---XXX-X----XX-XXX-X-----XX--X----X-------X---XXXX-XX--|--------X-XX--|-|--X-----XXXXX--XXXXXX-XXX-X--||-------XXXXXXX
