-----------------------------------------------------------------------------------------------------------------------------------------------------
-----------------------------------------------------------------------------------------------------------------------------------------------------
-----------------------------------------------------------------------------------------------------------------------------------------------------
-----------------------------------------------------------------------------------------------------------------------------------------------------
-----------------------------------------------------------------------------------------o-----------------------------------------------------------
---------------------------------------------SSSS---------------------------------------%%%------------------------%----------SSSSSS-----------------
--------S--------------------------------------------o--SS-------------------------------|-----------------------------------------------------S-----
---------------o-----o-------o---o---------g----------------S-SS-------o-o-----o---------|----o-o---o-o-o-o---o-o-----------g------------S-----------
--------------%%%-%-%%%-%-%-%%%-%%%------%%%%-----------------------%-%%%%%-%-%%%-%-%----|---%%%%%-%%%%%%%%%-%%%%%------%%%%%%-----------------------
---------S-----|-----|-------|---|--------||-----SSSSS----S------------|-|-----|---------|----|-|---|-|-|-|---|-|--------||||-------SSS---------SS---
---------------|-----|-------|---|--------||---------------------------|-|-----|---------|----|-|---|-|-|-|---|-|--------||||------------------------
---------------|-----|-------|---|-----%%%||---------------------------|-|-----|---------|----|-|---|-|-|-|---|-|----%%%%||||------------------------
---------------|-----|-------|---|------|-||---------------------------|-|-----|---------|----|-|---|-|-|-|---|-|-----||-||||----------------------F-
-M-------------|-----|---r-r-|---|------|-||-----oo--------------------|-|-----|---r-----|----|-|-r-|-|-|-|-r-|-|-----||-||||-------oo-------------#-
XXXXXXX---X---%%%%%%%%%%%%%%%%%%%%%%%%%-|-||----%%%---------------%%%%%%%%%%%%%%%%%%%%%%%%%%%%%%%%%%%%%%%%%%%%%%%%%%%-||-||||------%%%-X----------XXX
XXXXXXX---X----|||||||||||||||||||||-|--|-||-----|-----------------|||||||||||||||||||-||||-||||||||||||||||||||||||--||-||||-------|--X----------XXX
