----------------------------------------------------------------------------------------------------------------------------------------------------------------------------------------------------
----------------------------------------------------------------------------------------------------------------------------------------------------------------------------------------------------
----------------------------------------------------------------------------------------------------------------------------------------------------------------------------------------------------
----------------------------------------------------------------------------------------------------------------------------------------------------------------------------------------------------
----------------------------------------------------------------------------------------------------------------------------------------------------------------------------------------------------
-------------------------------------------------------------------------------------k--------------------------------------------------------------------------------------------------------------
--------------------------------------------S---------------------------------------##----S---S-------------------S--------------------------SS----------------------SC---------S-------------------
-----------------------------------------------------------------------------------###--------------------------------------------------------------------------------------------------------------
----------------------------------------------------------------------------------####--------------------------------------------------------------------------------------------------------------
---------------------------------------------------------------?------------------####-------------------------------------------Q-----------------------------------SS--Q--------------------------
------------------S-----#-------------------S-T-----SS-T----#---------------------####----S---S-------------------S------------------Q-------SS-------T-------S-----------------S-------------------
---------T--------------#---------------------T-T----K-T----#--------------------#####-T--------------------------------------------------------T-----T----T----------------------------------------
---------T--------------#---------------------T-T------T----#------T------------######-T-------------------------------T------------------------T-----T----T-------------------------------------F--
-M---k---T----g---------#--------------k------T-T------T----#------T-----------#######-T--g--------------------------g-T------------------------T-----T----T--K----------------------------------#--
XXXXXXXXXXXXXXXXXXXXXX--X-XX-XXXXXXXXXXXXXXXXXXXXXXXXXXXXXX-X-XXXXXXXX-X--XXXXXXXXXXXXXXXXXX-XXXX--XXXXXXXXX-XXXXXXXXXXXXXXX-XX-XXXXXXXXXXXXXXXXXXXXXXXXX-XXXXXXXXXX---XXXXXXXXXXXXXXXXXXX-X-X-XXXXX
XXXXXXXXXXXXXXXXXXXXXX--X-XX-XXXXXXXXXXXXXXXXXXXXXXXXXXXXXX-X-XXXXXXXX-X--XXXXXXXXXXXXXXXXXX-XXXX--XXXXXXXXX-XXXXXXXXXXXXXXX-XX-XXXXXXXXXXXXXXXXXXXXXXXXX-XXXXXXXXXX---XXXXXXXXXXXXXXXXXXX-X-X-XXXXX
