-----------------------------------------------------------------------------------------------------------------------------------------------------------------------------------------------------
-----------------------------------------------------------------------------------------------------------------------------------------------------------------------------------------------------
-----------------------------------------------------------------------------------------------------------------------------------------------------------------------------------------------------
-----------------------------------------------------------------------------------------------------------------------------------------------------------------------------------------------------
----------------------------------------------------------X------------------------------------------------------------------------------------------------------------------------------------------
----------------------------------------------------------X------------------------------------------------------------------------------------------------------------------------------------------
---------------S-------S------------QQ-----------S--------X---------------------------S--SS----------------QQ-----QQ--S--------------------USS------S-----------QQ---------------S-------------------
----------------------------------------------------------X------------------------------------------------------------------------------------------------------------------------------------------
----------------------------------------------------------X--------------------------------------g---------------------------g-----------------------------------------------------------------------
----------------------------------------------------------X---------------T----------------------#---------------------------#----------------------------T------------------------------------------
-----S--------------S-------T-------?Q-----------------T--X---------------T----Q----------------##---------?Q-----?Q--------##--S---------S------------S--T-----?Q----S------------------------------
----------------------------T-----#-----------------#--T--X---------------T-------------------T-##--------------------------##---------g---------#--------T-T----------------------------------------
----------------------------T-----#-----------------#--T--X---------------T-------------------T-##--------------------------##---------TT--------#--------T-T-------K----------------------------F---
--M---------------g---------T-k---#-------g---------#--T--X---------------T-----g-------------T-##--------------g-----------##---------TT-ggg----#--------T-T--------------g-------------------g-X---
XXXXXXXXXXXX-XX-XXXXXXXXXX-XXXXXX-XXXXXXXXXXXXXXX-X-XXXXXXXXXXXXX-XXXX--XXXXXXXXXXXXXX-XXXXXXXXXXXXXXXXXXXXXXXXXXXXXXX-XXXXXXXXXXXXXXXXXXXXXXXXX-XXX-XXXXXXXXXXXXXXXXXXXXXXXXXXXXXXXXXXXXX-XXXXXXXXXX
XXXXXXXXXXXX-XX-XXXXXXXXXX-XXXXXX-XXXXXXXXXXXXXXX-X-XXXXXXXXXXXXX-XXXX--XXXXXXXXXXXXXX-XXXXXXXXXXXXXXXXXXXXXXXXXXXXXXX-XXXXXXXXXXXXXXXXXXXXXXXXX-XXX-XXXXXXXXXXXXXXXXXXXXXXXXXXXXXXXXXXXXX-XXXXXXXXXX
