---------------------------------------------------------------------------------------------------------------------------------------------------------------------
---------------------------------------------------------------------------------------------------------------------------------------------------------------------
---------------------------------------------------------------------------------------------------------------------------------------------------------------------
---------------------------------------------------------------------------------------------------------------------------------------------------------------------
------o----------o-------------------o------------------------------------------------------------------------------o-------------------------o----------------------
---------------------------------------------------------------------------------------------------------------------------------------------------------------------
-------%%%%-------%%%%%---------------%-----------------------------ooo-----SS--o--S--------------------------S------%%%%%%%%%%----------------%---------------------
--------||---------|||-------------S--------------------------------SSS---------S-------------------------------------||||-|-|---------------------------------------
--------||---------|||------------------------------------------------------------------------------------------------||||-|-|---------------------------------------
--------||---------|||------------------------------------------------------------------------------------------------||||-|-|---------------------------------------
----%---||---------|||--------------------------------------------%---------------%------%--%%%%%%%%%%%%%-%%%-----S---||||-|-|---------------------------------------
--------||---------|||---------------------------------------------------------------S-------|||-|||||||---|----S-----||||-|-|---------------------------------------
--------||---------|||-----------------------------------------------------------------------|||-|||||||---|----------||||-|-|-------------------------------------F-
-M------||---------|||-----------------------------------------------------------------------|||-|||||||---|----------||||-|-|-------------------------------------X-
XXX-----||-XXXXX---|||-XXXXXXXXXXX-----XXXXXXXXXXXXXXXXXXXXXXXXX---%------%%%--%----------%%%|||-|||||||---|----------||||-|-|-XXXXXXXXXXXXXX---XXXXXXXXXXXXXXXXXXXXX
XXX-----||-XXXXX---|||-XXXXXXXXXXX-----XXXXXXXXXXXXXXXXXXXXXXXXX-----------|---------------|-|||-|||||||---|----------||||-|-|-XXXXXXXXXXXXXX---XXXXXXXXXXXXXXXXXXXXX
