----------------------------------------------------------------------------------------------------------------------------------------------------------------------------------------------------
----------------------------------------------------------------------------------------------------------------------------------------------------------------------------------------------------
----------------------------------------------------------------------------------------------------------------------------------------------------------------------------------------------------
----------------------------------------------------------------------------------------------------------------------------------------------------------------------------------------------------
----------------------------------------------------------------------------------------------------------------------------------------------------------------------------------------------------
----------------------------------------------------------------------------------------------------------------------------------------------------------------------------------------------------
--------------------------SS---S---------S---------------S----------S---------------------------S---------SC-------------------------S-----------------------------------------SS---------S---------
----------------------------------------------------------------------------------------------------------------------------------------------------------------------------------------------------
--------------------------------------------------------------------------------------------------------#-------------------------------------------------------------------------------------------
--------------------------------------------------------------------------------------------------------#-SS--------------Q------------------------------------------------------------------?------
----S----------#----------SS---S----Q----S---------------S----------S-T-------T------------S----S---T---#--------------SS--------T---S--------T------------------------#-------SS---------S---------
---------------#----------------------T----------------T--------------T-------T---------------------T--##---------------K--------T-----T------T-T-----T-----T----------#----------------------------
---------------#----------------------T----------------T--------------T-T-----T---------------------T--##------------------------T-----T------T-T-----T-----T----------#-----------T-----------T-F--
-M--K--k-------#----------------------T--g-------------T-g----k--g----T-T-----T-----gg-----K--------T--##----g-----------------k-T-----T------T-T-g---T--k--T----------#-----------T-----------T-#--
XXXXXXXXXXXXXX-X-X-XXXXX-XXXXXXXXXXXXXXXXXXXXXXXXXXX-XXXXXXX-XXXXXXXXXXXXXXXXXXXXXXXXXXXXXXXX--XXXXXXXXXX---XXXXXXX---XXXXXXXXXXXXXXXXXXXX-XXXXXXXXXXXXXXXXXXXXXXX-XXX-X-XXXXXXXXXXXXXXXXXXXXXXXXXXX
XXXXXXXXXXXXXX-X-X-XXXXX-XXXXXXXXXXXXXXXXXXXXXXXXXXX-XXXXXXX-XXXXXXXXXXXXXXXXXXXXXXXXXXXXXXXX--XXXXXXXXXX---XXXXXXX---XXXXXXXXXXXXXXXXXXXX-XXXXXXXXXXXXXXXXXXXXXXX-XXX-X-XXXXXXXXXXXXXXXXXXXXXXXXXXX
