------------------------------------------------------------------------------------------------------------------------------------------------------
------------------------------------------------------------------------------------------------------------------------------------------------------
------------------------------------------------------------------------------------------------------------------------------------------------------
---------------------------------oooooo--oo--oo---------------------------------------------------------------------o---------------------------------
--------------------------------------------------g---------------------------------------------------------------------------------------------------
------------------------------------------------%%%%%%%---%%%---%%%---------------------------------------------------%-oo--------oo------------------
----------------R--------------------------------|||-|-----|-----|------------------------------------------------------------------------------------
-------------------------------------------------|||-|-----|-----|---------------------------------%--%-----------------------------------------------
-------------------------------------------------|||-|-----|-----|-------------------------------------------%----------------------------------------
-------------------------------%%%%%%%%%%%%%%%%%-|||-|---%-|---%-|-----------S----------S--------S----------------%%%%--------------------------------
------%-----------%-%%%%%%%%%---|||||||-|||-|||--|||-|-----|-----|---%---------------------------------------------||----SS--------SS-----------------
---------------------|||-|||----|||||||-|||-|||--|||-|-----|-----|-------------------------------------------------||---------------------------------
---------------------|||-|||----|||||||-|||-|||--|||-|-----|-----|-------------------------------------------------||------------------------------F--
-M-----%-------ooo---|||-|||--%-|||||||-|||-|||--|||-|--%--|--%--|--o--------------------------------------------%-||------------------------------#--
XXX-X------X-X-%%%---|||-|||----|||||||-|||-|||--|||-|-----|-----|--%--XX-X-----X-XXX-----XX--XX-------------------||--------%%%------XXXX-%%%%%--XXXX
XXX-X------X-X--|----|||-|||----|||||||-|||-|||--|||-|-----|-----|-----XX-X-----X-XXX-----XX--XX-------------------||---------|-------XXXX--|||---XXXX
