------------------------------------------------------------------------------------------------------------------------------------------------------
------------------------------------------------------------------------------------------------------------------------------------------------------
------------------------------------------------------------------------------------------------------------------------------------------------------
---------o--------------------------------------------------------------------------------------------------------------------------------------------
------------------------------------------------------------------------------------------------------------------------------------------------------
-----------%-------%----------------------------------------------------------%%%------------------------ooooooor-------------------------------------
---------------------------------------------------##--------------------------|------------------------%%%%%%%%%-------------------------------------
-----------------------------------------%---------##--------------------------|-------------------------|||||||--------------------------------------
---------------------%---------S------------------###--------------------------|-------------------------|||||||-----------S--------------------------
-------%%%%-------%-------------------------------###------------------------%-|-------------------------|||||||--------S-----------------------------
-----%--||------%------%-------------------------####--------------%-----------|------------------%%%%%%%%%%%%%%%%------------------------------------
--------||---------------------------------------####--------------------------|-------------------|-||||||||||||-------------------------------------
--------||---------------------------------------####------------------o-------|-------------------|-||||||||||||----------------------------------F--
-M----%-||-------%---------%----r----------------####---------------%-%%%%%%%--|-----------------o-|-||||||||||||--%--------r----------------------#--
XXX-----||---------------X---XXXXX-XXXXX-----X-XXXXXXX-----XX--XX------|-|||---|------XXX--X-XX--%-|-||||||||||||-----X---XXXX-XXX-XX--X-XXX-%---XXXXX
XXX-----||---------------X---XXXXX-XXXXX-----X-XXXXXXX-----XX--XX------|-|||---|------XXX--X-XX----|-||||||||||||-----X---XXXX-XXX-XX--X-XXX-----XXXXX
