--------------------------------------------------------------------------------------------------------------------------------------------------------------------------------
--------------------------------------------------------------------------------------------------------------------------------------------------------------------------------
--------------------------------------------------------------------------------------------------------------------------------------------------------------------------------
--------------------------------------------------------------------------------------------------------------------------------------------------------------------------------
--------------------------------------------------------------------------------------------------------------------------------------------------------------------------------
----------------------------------------------------------------------------------------------------------------------------k--------------------------------------------k------
----S---------S--------S--------S-----------------------------------------S-------------------------------------------------##--USS----------S---------------S-----------##-----
---------------------------------------------------------------------------------------------------------------------------###------------------------------------------###-----
----------------------------------------------------#---------------------------------B-----------------------------------####-----------------------------------------####-----
---------------------------------------------------##---------------------------------b----------------------------------#####----------------------------------------#####-----
----S---------S--------S--------S-------Q---------###---------------------S---------SS#CS--------Q----------------------######---------------S---------------S-------######-----
---------T----------------K---B-----------#------####------TT-----------K---K------------------------------T---T---T---#######---B--T-------------------------------#######-----
---------T-B-----B------------b-----------#----B-####------TT--T-----------------B------K--------------B---T---T---T-B-#######---b--T-----B-------------------------#######-F---
-M-------T-b-----b------------B-----------#----b-####------TT--T-----------------b---------------------b---T---T---T-b-#######---B--T-----b-------------------------#######-#---
XXXXXXXXXXXXXXXXXXXXXXXXXXXXXXXXXXXXXXXXXXXXXXXXXXXXXXXXXXXXXXXXXXXXXX-XXXXXXX-XXXXXXXXXXXXXXXXXXXXXXXXXXXXXXXXXXXXXXXXXXXXXXXXXXXXXXXXXXXXXXXXXXXXX-XXXXXXXXXXXXXXXXXXXXXXXXXXX
XXXXXXXXXXXXXXXXXXXXXXXXXXXXXXXXXXXXXXXXXXXXXXXXXXXXXXXXXXXXXXXXXXXXXX-XXXXXXX-XXXXXXXXXXXXXXXXXXXXXXXXXXXXXXXXXXXXXXXXXXXXXXXXXXXXXXXXXXXXXXXXXXXXX-XXXXXXXXXXXXXXXXXXXXXXXXXXX
