--------------------------------------------------------------------------------------------------------------------------------------------------------------------------------
--------------------------------------------------------------------------------------------------------------------------------------------------------------------------------
--------------------------------------------------------------------------------------------------------------------------------------------------------------------------------
--------------------------------------------------------------------------------------------------------------------------------------------------------------------------------
--------------------------------------------------------------------------------------------------------------------------------------------------------------------------------
------------------------------------------------------------------------------------------------k-------------------------------------------------------------------------------
------------------------------S-----------------------------------------------------------------##--------------S----------------------------------------------------S----------
-----------------------------------------------------------------------------------------------###------------------------------------------------------------------------------
-------------#------------B-------------------------------------------B----------#------------####----------------------------------------------------------------#-------------
------------##------------b-------------------------------------------b---------##-----------#####---------------------------------------------------------------##-------------
-----------###-----------S#CS-S----QQ--------------------------------S#CS------###----------######----Q---------S--Q--------------------------------------------###-SS----------
----------####--------T----------K-----T-------------T---T--------------------####-----#---#######------B-T---T---------------B---------------B------T---------####------B------
----------####----B---T-----K----------T-T-------T---T-B-T--------------K-----####-----#---#######------b-T---T--------T------b------T-----T--b------T--B------####------b--F---
-M--------####----b---T----------------T-T-------T---T-b-T--------------------####--k--#---#######------B-T---T--------T---k--B------T-----T--B------T--b------####------B--#---
XXXXXXXXXXXXXXXXXXXXXXXXXXXXXXXXXXXXXXXXXXXXXXXXXXXXXXXXXXXXXXXXXXXXXXXXXXXXXXXXXXXXXXXXXXXXXXXXXXXXXXXXXXXXXXXXXXXXXXXXXXXXXXXXXXXXXXXXXXXXXXXXXXXXXXXXXXXXXXXXXXXXXXXXXXXXXXXX
XXXXXXXXXXXXXXXXXXXXXXXXXXXXXXXXXXXXXXXXXXXXXXXXXXXXXXXXXXXXXXXXXXXXXXXXXXXXXXXXXXXXXXXXXXXXXXXXXXXXXXXXXXXXXXXXXXXXXXXXXXXXXXXXXXXXXXXXXXXXXXXXXXXXXXXXXXXXXXXXXXXXXXXXXXXXXXXX
