---------------------------------------------------------------------------------------------------------------------------------------------------------------------
---------------------------------------------------------------------------------------------------------------------------------------------------------------------
---------------------------------------------------------------------------------------------------------------------------------------------------------------------
---------------------------------------------------------------------------------------------------------------------------------------------------------------------
-----o------------------------o---------------------o------------o--------------------------------------oo----------oo-----o----------------o------------------------
---------------------------------------------------------------------------------------------------------------------------------------------------------------------
------%------------------------%%%--------------S-S--%------------%------------------Soo-----%%%%---------%------oo---%-----%----------------%%%%%%%%%%%%%%%%%%------
----------------------------S---|-------------------------------------------------------------||-----------------SS---------------------------|-|-|-|-|-||-|-|-------
--------------------------------|-------------------------------------------------------------||----------------------------------------------|-|-|-|-|-||-|-|-------
--------------------------------|-------------------------------------------------------------||----------------------------------------------|-|-|-|-|-||-|-|-------
--------------------------------|-------------%-------------%%%-------------------%%%---S--SS-||%%%%%%%-----------------------------------S---|-|-|-|-|-||-|-|-------
--------------------------------|----------------------------|----------SS---------|----------||-|-|||-------------------S--------------------|-|-|-|-|-||-|-|-------
--------------------------------|----------------------------|---------------------|----------||-|-|||----------------------------------------|-|-|-|-|-||-|-|-----F-
-M------------------------------|----------------------------|---------------------|----------||-|-|||----------------------------------------|-|-|-|-|-||-|-|-----X-
XXX----XXXXXXXXXXXXXXXXXX-------|-XXXXXXXXXX-%--------XXXX-%-|-----XXX------%%%%%%%|---------%%%%|-|||-----XXXX-%------X-----XXXXXXXXXXX------|-|-|-|-|-||-|-|-XXXXXX
XXX----XXXXXXXXXXXXXXXXXX-------|-XXXXXXXXXX----------XXXX---|-----XXX-------|||||-|----------||-|-|||-----XXXX--------X-----XXXXXXXXXXX------|-|-|-|-|-||-|-|-XXXXXX
