--------------------------------------------------------------------------------------------------------------------------------------------------------------------------------
--------------------------------------------------------------------------------------------------------------------------------------------------------------------------------
--------------------------------------------------------------------------------------------------------------------------------------------------------------------------------
--------------------------------------------------------------------------------------------------------------------------------------------------------------------------------
--------------------------------------------------------------------------------------------------------------------------------------------------------------------------------
--------------------------------------------------------k------------------------------------------------------------k------------------------------------------k---------------
-------S-USS--S---------------------------S-------------##-----------------------------------------------------------##----------------S------------------------##--------------
-------------------------------------------------------###----------------------------------------------------------###----------------------------------------###--------------
-------------------------------------------------#----####---------------------------------------------------------####---------------------------------------####--------------
------------------------------------------------##---#####--------------------------------------------------------#####--------------------------------------#####--------------
-------S-----SS-----------Q---Q-----------S----###--######-------------------------------------------------Q-----######-------------Q--S-----Q--------------######--------------
----------B-----------------------------------####-#######--------------------B--T-T-------T----K-T-------------#######--------#-----------K--------B----B-#######-K-T----#-----
----------b---------T-B---------B-------T-----####-#######-B-T----------------b--T-T-B-----T------T------B------#######-T---B--#--------------------b----b-#######---T----#-F---
-M--------B---------T-b---------b-------T-----####-#######-b-T----------------B--T-T-b-----T------T------b------#######-T---b--#--------------------B----B-#######---T----#-#---
XXXXXXXXXXXXXXXXXXXXXXXXXXXXXXXXXXXXXXXXXXXXXXXXXXXXXXXXXXXXXXXXXXXXXXXXXXXXXXXXXXXXXXXXXXXXX-XXXXXXXXXXXXXXXXXXXXXXXXXXXXXXXXXXXXXXXXXXXXXXXXXXXXXXXXXXXXXXXXXXXXXXXXXXXXXXXX-X
XXXXXXXXXXXXXXXXXXXXXXXXXXXXXXXXXXXXXXXXXXXXXXXXXXXXXXXXXXXXXXXXXXXXXXXXXXXXXXXXXXXXXXXXXXXXX-XXXXXXXXXXXXXXXXXXXXXXXXXXXXXXXXXXXXXXXXXXXXXXXXXXXXXXXXXXXXXXXXXXXXXXXXXXXXXXXX-X
