------------------------------------------------------------------------------------------------------------------------------------------------------
------------------------------------------------------------------------------------------------------------------------------------------------------
------------------------------------------------------------------------------------------------------------------------------------------------------
------------------------------------------------------------------------------------------------------------------------------------------------------
------------------------------------------------------------------------------------------------------------------------------------------------------
-------------------------------%------------------------------R------------ooo--------------------------------------------------------------ooo-------
---------------------------------------------------------------------------%%%-----------------------#--------------------------------------%%%-------
---------------------------------------------%------------------------------|------------------------#---------------------------------------|--------
-----------------------------------S----------------------------------------|--------%--------------##-------------------------------%-%-----|--------
------------------S-S---------%---------------------------------------------|-----------------------##--S------------------------------------|--------
----------------------------------------------------------------------------|----------------------###---------%%%%----------%---------------|--------
--------------------------------------------------------------------------U-|----------------------###----------||-------------------------U-|--------
----------------------------------------------------------------------------|----------------------###-----o----||---------------------------|-----F--
-M---------------------------%------r------%-----------%--------------------|----------------------###----%%%-o-||-----------------------%---|-----#--
XXXXXXXXX--XX-XXX------XXXX------XXXXX-XX------XXX-X-X----XXX---XXXX--X---%%%%-XXX------X-XXX-XX-XXXXXX----|--%-||--X-X-XX-----XXX-X-------%%%%-XXXXXX
XXXXXXXXX--XX-XXX------XXXX------XXXXX-XX------XXX-X-X----XXX---XXXX--X----||--XXX------X-XXX-XX-XXXXXX----|----||--X-X-XX-----XXX-X--------||--XXXXXX
