----------------------------------------------------------------------------------------------------------------------------------------------------------------------------------------
----------------------------------------------------------------------------------------------------------------------------------------------------------------------------------------
----------------------------------------------------------------------------------------------------------------------------------------------------------------------------------------
----------------------------------------------------------------------------------------------------------------------------------------------------------------------------------------
----------------------------------------------------------------------------------------------------------------------------------------------------------------------------------------
----------------------------------------------------------------------------------------------------------------------------------------------------------------------------------------
-----------------y-----------#------------#---------------------------------##------------y-------------------------------------------------------------------------------------#-------
---------------#SSS----------#------------#---------------------------------##----------#SSS------------------------------------------------------------------------------------#-------
--------------##-------------#------------#---------------------------------##---------##-----------------------y---------------------------------------------------------------#-------
-------------###1------------#-----o------#---------------------------------##--------###1---------?Q-----------XS------------------------------------------------------o-------#-------
-------------###-------------#------------#---------------------QQ----------##--------###----------------------XX-------o-------------------------------------------------------#-------
-------------###--SSS--------#--TT---T----#---------------------------------##--------###--SSS----------------XXX---------------------------------------------------------------#-------
-------------###-------------#--TT---T----#---------------------------------##--------###-------------y------XXXX---------------------------------------------------------------#---F---
-y--M--------###-------------#--TT---T----#---------------------------------##--------###-------y--SSSS-----XXXXX----y------------------y--y-------------------------y----------#---#-y-
XXXXXX-XXXXXXXXXXXX---XXX-XX-XXXXXXXXXXXX-XXXXXXXXXXX-X-XXXXXXXXXXXXXXX-XX--XXXXXXXXXXXXXXXX---XXX----XXX--XXXXXX--XXXXXXX-XX-XX-XXXXXXXXXXXXXXXXXXXXXXXXXXX-XXX--XXXXXXXXXXXXX-XXXXXXXX
XXXXXX-XXXXXXXXXXXX---XXX-XX-XXXXXXXXXXXX-XXXXXXXXXXX-X-XXXXXXXXXXXXXXX-XX--XXXXXXXXXXXXXXXX---XXX----XXX--XXXXXX--XXXXXXX-XX-XX-XXXXXXXXXXXXXXXXXXXXXXXXXXX-XXX--XXXXXXXXXXXXX-XXXXXXXX
