-------------------------------------------------------------------------------------------------------------------------------------------------------------------------------------------
-------------------------------------------------------------------------------------------------------------------------------------------------------------------------------------------
-------------------------------------------------------------------------------------------------------------------------------------------------------------------------------------------
S---SSSSSSSSSSSSS--SS-SSSSSSSSSSSSSSSSSS---SSSSSSSSSSSSSSSS--SSSSSSSSSSSSSSSSSSSS-SSSSSSSSSSSSSSSSSSSSSSSSSSSS---SSSSSSSSSSSSSSSSSSSSSSSSSSS-------SSSSSSSSSSSSSSSSSSSSSSSSSSSSSSSSSSSSSSSS
S----------------------------------------------------------------------------------------------------------------SSSSSSSSSS----------------------------------------------------------------
S----------------------------------------------------------------------------------------------------------------SSSSSSSSSS----------------------------------------------------------------
S------------------S---------------------------------------------------------------------------------------------SSSSSSSSSS---------------------------Q------------------------------------
S-----------------------------------------------------------------------------------------------T----------------S---------------------T---------------------------------------------------
S----------------------------------------S------------------------------------------------------T--------------S-S---------------------T------SSS------------------------------------------
S-----------------------------------------------------------------------------------------------T------------------o---------S------S--T----------------------------------S----------------
S---------------Q--SS-----------TTTT---Q----------------------------------------S---------------T---------T--Q----US-SSS?-S------------T---Q----------Q-----------------------------------F
S-------------------------------TTTT-------------T----T---#----T--T-----------------------------T-----#---T----------SS---S------#-----T-------------------#------------------#----------SS
S-----------------------t-------TTTT-------------T----T--##----T--T------------------------t----T-----#---T----------SS---S-----##-----T------------------##-----------------##----------SS
S-M--k------------------t-kk----TTTT-------------T----T--##----T--T------------------------t---kT--k--#---T------------oooS---k-##---kkT------------------##---------k-----k-##-----k----SS
XXXXXXX--XXXXXXXX--XX--XXXXXXX--XXXX--XX----X--XXXX--XXXXXX---XXXXXXX--X--XXXX-XX--XXXX--XXXX-XXXXXXX-X-XXX-XX---XXXXXXXXXXXXXXXXX-XXXXXXXXX---------XXXXXXX-XXX-X-XXXXXXXXXXXX--XXXXXXX-XX
XXXXXXX--XXXXXXXX--XX--XXXXXXX--XXXX--XX----X--XXXX--XXXXXX---XXXXXXX--X--XXXX-XX--XXXX--XXXX-XXXXXXX-X-XXX-XX---XXXXXXXXXXXXXXXXX-XXXXXXXXX---------XXXXXXX-XXX-X-XXXXXXXXXXXX--XXXXXXX-XX
