--------------------------------------------------------------------------------------------------------------------------------------------------------------------------------
--------------------------------------------------------------------------------------------------------------------------------------------------------------------------------
--------------------------------------------------------------------------------------------------------------------------------------------------------------------------------
--------------------------------------------------------------------------------------------------------------------------------------------------------------------------------
--------------------------------------------------------------------------------------------------------------------------------------------------------------------------------
--------------------------------------------------------------------------------------------------------------------------------------------------------------------------------
---S--S----------------------SS------S-----------------------------S--------S----------------S-----------S--------------------------------S-------------------------------------
--------------------------------------------------------------------------------------------------------------------------------------------------------------------------------
---------------------------------------------------------------------------------------------------------------------#----------------------------------------------------------
--------------------------------------------------------------------------------------------------------------------##----------------------------------------------------------
---S--S-----------------Q----SS------S-Q------Q-----------Q--------S--------S----Q-----------S-----------S---------###--------------------S-------------------------------------
----------T----------K-------------------------------#--------#-------T---------------------------T--------#------####--------------------------T-------------------------------
----------T------------------------T-----------------#--------#-------T---------------B-T------T--T---B----#------####------------T--B----------T------------------T--------F---
-M--------T------------------------T-----------------#--------#-------T---------------b-T------T--T---b----#------####------------T--b----------T------------------T--------#---
XXXXXXXXXXXXXXXX--XXXXXXXXXXXXXXXXXXXXXXX-XXXXXXXXXXXXXXXXXXXXXXXXXXXXXXX-XXXXXXXXXXXXXXXXX-XXXXXXXXXXXXXXXXXXXXXXXXXXXXXXXXXX-XXXXXXXXXXXXXXXXXXXXXXXXXXXXXXXXXXXXXXXXXXXXXXXXX
XXXXXXXXXXXXXXXX--XXXXXXXXXXXXXXXXXXXXXXX-XXXXXXXXXXXXXXXXXXXXXXXXXXXXXXX-XXXXXXXXXXXXXXXXX-XXXXXXXXXXXXXXXXXXXXXXXXXXXXXXXXXX-XXXXXXXXXXXXXXXXXXXXXXXXXXXXXXXXXXXXXXXXXXXXXXXXX
