----------------------------------------------------------------------------------------------------------------------------------------------------------------------------------------------------
----------------------------------------------------------------------------------------------------------------------------------------------------------------------------------------------------
----------------------------------------------------------------------------------------------------------------------------------------------------------------------------------------------------
----------------------------------------------------------------------------------------------------------------------------------------------------------------------------------------------------
----------------------------------------------------------------------------------------------------------------------------------------------------------------------------------------------------
-------------------------------------------------------------------------------------------------------------------k-----------------------k--------------------------------------------------------
---------SC-----S----------S------------S---------------------S------------S----------------------S-----S---------##-----------S----S-----##-----S--------------------------------------------------
-----------------------------------------------------------------------------------------------------------------###---------------------###--------------------------------------------------------
----------------------------------------------------------------------------------------------------------------####--------------------####--------------------------------------------------------
---------SS-----------------------------------------------------------------------------------------------------####--------------------####--------------------------------------------------------
----------------S----------S------------S---------------SS----S---------S--S--S-------------------S-----SS--S---####-S---------S----S---####-----S-------#-------S--------S-------------------------
------------------T----------T---------------------T-----------------------------------------------------------#####-------------------#####-------------#---------T-------------------------T------
------------------T----------T---------------------T-----------------------------------------------------------#####-------------------#####-------------#---------T-------------------------T---F--
-M-k--------------T--g-------T----g----------------T-g--------g----------------------------g----k-g---------K--#####-----------g----g--#####-g-------g---#-------K-T------K-----------g------T---#--
XXXXX-XX---X-XXXXXXXXXXXXXXXXXXXXXXXXXXXXXXXX-XXXXXXXXXXXXXXXXXXXX-XXXXXXXXXXXXXXXXXXXXXXXXXXXXXXXXXXXXXXXXXXXXXXXXXXXXXX--XX-XXXXXXXXXXXXXXXXXXXXXXXXX--X-X-XXXXXXXXXXXXXXX-XXXXXXX-XXXXX-XXXXXXXXX
XXXXX-XX---X-XXXXXXXXXXXXXXXXXXXXXXXXXXXXXXXX-XXXXXXXXXXXXXXXXXXXX-XXXXXXXXXXXXXXXXXXXXXXXXXXXXXXXXXXXXXXXXXXXXXXXXXXXXXX--XX-XXXXXXXXXXXXXXXXXXXXXXXXX--X-X-XXXXXXXXXXXXXXX-XXXXXXX-XXXXX-XXXXXXXXX
