----------------------------------------------------------------------------------------------------------------------------------------------------------------------------------------------------------------------
----------------------------------------------------------------------------------------------------------------------------------------------------------------------------------------------------------------------
----------------------------------------------------------------------------------------------------------------------------------------------------------------------------------------------------------------------
----------------------------------------------------------------------------------------------------------------------------------------------------------------------------------------------------------------------
----------------------------------------------------------------------------------------------------------------------------------------------------------------------------------------------------------------------
----------------------------------------------------------------------------------------------------------------------------------------------------------------------------------------------------------------------
------------------------S-----------------------S--------S--S---------------S------------------S-------------------------------------SS-S-------S-------------S--------------SSS----------------S---------------------
-------------------------------T--------------------------------------------------------------------------------------------------------------------------------------------------------------------------------------
-------------------------------T-----------------------------------------------------T---------------------------------------------T----------------------------------------------------------------------------T-----
-------------------------------X-----------------------------------------------------T---------------------------------------------T----------------------T-----------------------------------------------------T-----
-----------------------SS-T--T-------t----TT-T----------------T--S-------------T-----T----------------------------#--T----------T--T----S---------------S-T----------------S----2-S-----------T----------T------T-----
---------------------T----T--T---TT--t----TT-T----------------T----------------T-----T-------------------T-----T--#--T----------T--T--------T-------------T--------------------T-------T------T----------T--T---T-----
-----TT-t-T--t-------T----T--T---TT--t--#-TT-T----t-----------T-----------T----T---T-T-------T-----------T-----T--##-T-T--------T--T-T----T-T-T---T-------T-T------T-----------T-----T-T------T-----T----T--T-T-T--F--
---M-TT-t-T--t-------T----T--T---TT--t-##-TT-T----t--k--------T-----------T----T---T-T----k--T-----------T-----T--##-T-T--------T--T-T----T-T-T---T-------T-T------T-----------T-----T-T------T-----T----T--T-T-T--#--
XXXXXXXXXXXXXXXXXXXXXXXXXXXXXXXXXXXXXXXXXXXXXXXXXXXXXXXXXXXXXXXXXXXXXXXXXXXXXXXXXXXXXXXXXXXXXXXXX-XXXXXXXXXXXXXXXXXXXXXXXXXXXXXXXXXXXXXXXXXXXXXXXXXXX-XXXXXXXXXXXXXXXX-XXXXXXXXXXXXXXXXXXXXXXXXXXXXXXXXXXXXXXXXXXXXXXX
XXXXXXXXXXXXXXXXXXXXXXXXXXXXXXXXXXXXXXXXXXXXXXXXXXXXXXXXXXXXXXXXXXXXXXXXXXXXXXXXXXXXXXXXXXXXXXXXX-XXXXXXXXXXXXXXXXXXXXXXXXXXXXXXXXXXXXXXXXXXXXXXXXXXX-XXXXXXXXXXXXXXXX-XXXXXXXXXXXXXXXXXXXXXXXXXXXXXXXXXXXXXXXXXXXXXXX
