-------------------------------------------------------------------------------------------------------------------------------------------------------------------------------------------
-------------------------------------------------------------------------------------------------------------------------------------------------------------------------------------------
-------------------------------------------------------------------------------------------------------------------------------------------------------------------------------------------
S---SSSSSSSS-SSSSSSSSSSSSSSSSSSSSSSSS--SSSSS-SSSSSSSSSSSSSSSSSSSSSSSSSSSSSSSSSSSSSSSSSSSSSSSSSSSSSSSSSSSSS-SSSSSSSSSSSSSSSS--------SSSSSSSSSSSSSSS---SSSSSSSSSSSSSSSSSSSSSSSSSSSSSSSSSSSSSS
S------------------------------------------------------------------------------------------------------------------------------------------------------------------------------------------
S------------------------------------------------------------------------------------------------------------------------------------------------------------------------------------------
S-----------------------------------------------------------------------Q------------------------------------QQ----------------------------------------------------------------------------
S------------------------------------------------------------------------------------------------------------------------------------------------------------------------------------------
S---------------------------------------------------------------------------------------------------------------------------SSSSS------------------S---------------------------------------
S------------------------------------------------------------------------------------------------------------------------------------------------------------------------------------------
S----------S------------------------Q------Q-------------------T--------Q--------------------------------Q---QQ-----------Q----------------------S-------T------------------------T-------F
S---------------------------------------#----------------------T----T------T-------#------------#--------------------------------------------------------T--T---------T------T----T------SS
S-------------------------t-------------#----------------------T----T------T------##------------#--------------------------------------------------------T--T------t--T------T----T------SS
S-M----k------------------t---k---------#----------------------T----T------T------##------------#-----------------k------------------------k--k----------T--T----k-t--T------T-k--T------SS
XXXXXXXXX-XX--XXXX--XXXXXXXXXXXXX-XXX---X-XX--X-X-XXXXXXXXX---XX--XXXX-XXXXXX-XXXXXX--X-XX--XX--X-----XXXX--XXXX-XXX-XXXXXX---------XXXXXXXXXXXXXX----XX-X-XXX-XXXXXXXXXX-X-XXXXXXX----X-XX
XXXXXXXXX-XX--XXXX--XXXXXXXXXXXXX-XXX---X-XX--X-X-XXXXXXXXX---XX--XXXX-XXXXXX-XXXXXX--X-XX--XX--X-----XXXX--XXXX-XXX-XXXXXX---------XXXXXXXXXXXXXX----XX-X-XXX-XXXXXXXXXX-X-XXXXXXX----X-XX
