-----------------------------------------------------------------------------------------------------------------------------------------------------------------------------------------------------
-----------------------------------------------------------------------------------------------------------------------------------------------------------------------------------------------------
-----------------------------------------------------------------------------------------------------------------------------------------------------------------------------------------------------
-----------------------------------------------------------------------------------------------------------------------------------------------------------------------------------------------------
-----------------------------------------------------------------------------------------------------------------------------------------------------------------------------------------------------
-----------------------------------------------------------------------------------------------------------------------------------------------------------------------------------------------------
------S--QQ---------S--------QQ-------S--S--------------S----------S-S----S-?-S---------------S----QQ-----C----------S----------S----------S-?--SS----S--------------------------S--S------LSS-------
-----------------------------------------------------------------------------------------------------------------------------------------------------------------------------------------------------
-----------------------------------------------------------------------------------------------------------------------------------------------------------------------------------------------------
---------------------------------------------E-------------T-------------------------------------------E---------------------------------------------------------------------------------------------
---------?Q----T----------T--?Q----S--------TT-T-----------T-#--T-------------------------------T--?Q-TT-SS--------T------------------------------------------------T------------------T---2---------
---------------T----------T-----------------TT-T-----------T-#--T-------------------------------T-----TT---------T-T-----------------------------------------g------T------------------T-------------
---------------T----------T-----------------TT-T-K---------T-##-T-------------------------------T-----TT---------T-T-----------------------------------------TT-----T------------------T---------F---
--M------------T----------T-----------------TT-T---gg------T-##-T----------K--------------------T-----TT--k------T-T------------------------K-----------g----TT-----T---------gg-------T-g--k----X---
XXXXXXXXXXXXXXXXXXXXXXXXXXXXXXXXXXXXXX-XXXXXXXXXXXXXXXXXXXXXXXXXXXX-XXXXXXXXXXXXX-XXXXXXXXXXXX-XXXXXXXXXXXXXXXXXXXXXX-XXXXXXX--X-XXXXX-XXXXXXXXX--XXXXXXXXXXXXXXXXXXXXXXXXXXXXXXXXXX-XXXXXXXXXXXXXXXX
XXXXXXXXXXXXXXXXXXXXXXXXXXXXXXXXXXXXXX-XXXXXXXXXXXXXXXXXXXXXXXXXXXX-XXXXXXXXXXXXX-XXXXXXXXXXXX-XXXXXXXXXXXXXXXXXXXXXX-XXXXXXX--X-XXXXX-XXXXXXXXX--XXXXXXXXXXXXXXXXXXXXXXXXXXXXXXXXXX-XXXXXXXXXXXXXXXX
