--------------------------------------------------------------------------------------------------------------------------------------------------------------------------------
--------------------------------------------------------------------------------------------------------------------------------------------------------------------------------
--------------------------------------------------------------------------------------------------------------------------------------------------------------------------------
--------------------------------------------------------------------------------------------------------------------------------------------------------------------------------
--------------------------------------------------------------------------------------------------------------------------------------------------------------------------------
--------------------------------------------------------------------------------------------------------------------------------------------------------------------------------
-----------------------S--------------------------S---------------------S-----------S----------------------------------------------------------------------------S---S---SS---S-
--------------------------------------------------------------------------------------------------------------------------------------------------------------------------------
------------------------------------------------------------------#------------------------------------------------#---------------------#--------------------------------------
-----------------------------------------------------------------##-----------------------------------------------##--------------------##--------------------------------------
-----------------------S---Q--------------------Q-S----------Q--###-----S-----------S---------Q------------------###-------------------###---------------------Q-S---S---SS---S-
------B--TT-----K----------------------#-----K-----------------####---------T--K------B---T---------------------####-T---#----B-------####---#--B------T------------------------
------b--TT----------------------------#--------------B--------####---------T---------b---T---------T-----B-----####-T---#----b-------####---#--b-T----T--------------------F---
-M----B--TT------------------------k---#--------------b--------####---------T---------B---T---------T-----b-----####-T---#----B-------####---#--B-T----T--------------------#---
XXXXXXXXXXXXXXXXXXXXXXXXXXXXXXXXXXXXXXXXXXXXXXXXXXXXXXXXXXXXXXXXXXXXXXXXXXXXXXXXXXXXXXXXXXXXXXXXXXXXXXXXXXXXXXXXXXXXXXXXXXXXXXXXXXXXXXXXXXXXXXXXXXXXX-XXXXXXXXXXXXXXXXXXXXXXXXXX
XXXXXXXXXXXXXXXXXXXXXXXXXXXXXXXXXXXXXXXXXXXXXXXXXXXXXXXXXXXXXXXXXXXXXXXXXXXXXXXXXXXXXXXXXXXXXXXXXXXXXXXXXXXXXXXXXXXXXXXXXXXXXXXXXXXXXXXXXXXXXXXXXXXXX-XXXXXXXXXXXXXXXXXXXXXXXXXX
