--------------------------------------------------------------------------------------------------------------------------------------------------------------
--------------------------------------------------------------------------------------------------------------------------------------------------------------
--------------------------------------------------------------------------------------------------------------------------------------------------------------
S----SSSSSSSSSSSSSSSSSSSSSSSSSSSSSSSSSSSSSSLSSLSSSSSSSSSSSSSSSSSSSSSSSSSSSSSSSSSSSSSSSSSSSSSSSSSSSSSSSSSSSSSSSSSSSSSSSSSSSSSSSSSSSSSSSSSSSSSSSSSSSSSSSSSSS----
S---------------SS-------------------------------SSS------------------------------------------------------SS--------------------------------------------------
S---------------SS-------------------------------SSS----------------g--------------------------g----------SS--------------------------------------------------
S-----------------------------------------oo-oo---SS--------------SSS------------------------SSS--------------------------------------------------------------
S-------------------------------------------------SS--------------SSS------------------------SSS--------------------------------------------------------------
S-----------------------------------------SS-SS---SS---------S-U--SSS-S-U--------------------SSS--------------------------------------------------------------
S---------------oU------C-----------------SS-SS---SS---------SoS--SSC-SoS--------------------SSC----------oU--------------------------------------------------
S---------------SS--------------------------------SS---------SSS--SSS-SSS--T---------------#-SSS----------SS---TT-T----------------------------#---------#----
S--------------------------------------------------------------------------T---------------#-----#-----#-------TT-T-----------------TT-----#---#---------#----
S--------------------------#---------------------------#---g---------------T----------g-#--#-----#---#-#-------TT-T------------T----TT-----#---#----#----#----
S--M--------------------E--#-g----g--g----------g--g---#--g#---------------T--------g-#-#--#-----#---#-#-------TT-T------------T----TT-----#---#----#----#--F-
XXXXXXX-XXX-XXXXXXXXXXXXXXXXXXXXXXXXXXXXXXXXXXXXXXXXXXXXXXXXXXXXXXXXXXXXXXXXXXXX-XXXXXXXXXXXXXXXXXXXXXXXXXXXXXXXXXXXX-XXX-XXXXXXX-XXXXXXXXXXXXXXXXXXXX-XXX-XXX
XXXXXXX-XXX-XXXXXXXXXXXXXXXXXXXXXXXXXXXXXXXXXXXXXXXXXXXXXXXXXXXXXXXXXXXXXXXXXXXX-XXXXXXXXXXXXXXXXXXXXXXXXXXXXXXXXXXXX-XXX-XXXXXXX-XXXXXXXXXXXXXXXXXXXX-XXX-XXX
