------------------------------------------------------------------------------------------------------------------------------------------------------------------------------------------------------------------------------
------------------------------------------------------------------------------------------------------------------------------------------------------------------------------------------------------------------------------
------------------------------------------------------------------------------------------------------------------------------------------------------------------------------------------------------------------------------
------------------------------------------------------------------------------------------------------------------------------------------------------------------------------------------------------------------------------
------------------------------------------------------------------------------------------------------------------------------------------------------------------------------------------------------------------------------
------------------------------------------------------------------------------------------------------------------------------------------------------------------------------------------------------------------------------
--------------------------------------------Q--------------------------------Q----------------------------------------------------------------------------------------------------------------------------------Q-------------
-----o--o-----------------------------o--------------------------------o------------------------------------o---------------------------------------------------------------------------o-------------------------------------
------------------------------------------------------------------------------------------------------------------------------------------------------------------------------------------------------------------------------
-----------------------------------------------------------------------------------------------------------------------------------------------------------------------------o------------------------------------------------
---T----------------------------------------Q--------------------------------Q----------Q----------Q------Q---------C---------Q----------T-Q--Q-----------------------------o-o-----T-----------T----------C----Q-------------
---T-------T------------#-----------#--------------------------------#-------------------------------------------------------------------T----------------------#-------------------T-----#-----T-----------------------------
---T-------T------------#-----------#--------------------------------#-------------------------------------------------------------------T----------------------#-------------------T-----#-----T-------T-----------------F---
-M-T-------T----------y-#-----------#--------------------------y-----#-----------------------------------------y-------------------------T-----------y----------#-------------------T-----#-----T-------T-----------------#---
XXXXXXXXXXXXX-XXXXXXXXXXXXXX-XXXXX-XXXXXXXXXXXXXXXXXX-XXXXXXXXXXXXXXXXXXXXXXXXXXXXXXXX-XXXXXXXXXXXXXXXXXXXXXXXXXXXXXXXXXXXXXXXXXXXXXXXX-XXXXXXXXXXXXXXXXXXXXXXXXX-XXXXXXXXXXXXXXXXXXXXXXXXXXXXXXXX-XXXXXXXXXXXXXXXXXXXXXXXXXXX
XXXXXXXXXXXXX-XXXXXXXXXXXXXX-XXXXX-XXXXXXXXXXXXXXXXXX-XXXXXXXXXXXXXXXXXXXXXXXXXXXXXXXX-XXXXXXXXXXXXXXXXXXXXXXXXXXXXXXXXXXXXXXXXXXXXXXXX-XXXXXXXXXXXXXXXXXXXXXXXXX-XXXXXXXXXXXXXXXXXXXXXXXXXXXXXXXX-XXXXXXXXXXXXXXXXXXXXXXXXXXX
