---------------------------------------------------------------------------------------------------------------------------------------------------------------------
---------------------------------------------------------------------------------------------------------------------------------------------------------------------
---------------------------------------------------------------------------------------------------------------------------------------------------------------------
----------------------------ooo-------------------------o------------------------------------------------------------------------------------------------------------
-----oo---------------------%%%--------------------------------o-----------------o---------------------------------------------------o----------------o--------------
-----------------------------|---------------------------------------------------------------------------------------------------------------------------------------
-------%%%%%%%%%-------------|-------------------------SSSS-S---%-------------SS--%%%----------------------o-----------------SSS-S-S--%----------------%%%%%%%%%%----
--------||||-||--------------|-----------------------------------------------------|------------S----------S--------------------------------------------|-|-|-||-----
--------||||-||--------------|-----------------------------------------------------|------------------------------------------------------o----S---oo---|-|-|-||-----
--------||||-||--------------|--%%%-----oo-oo------------------------------oo------|--------------------------------------------------------------------|-|-|-||-----
--------||||-||--------------|---|--------------------------------------%----------|--------------%%%%%%%%---------------%-%----%---------S-S----%-SS---|-|-|-||-----
--------||||-||-------------%%%%%|-------------------------------------------------|---------------||||||----SS-----------------------------------------|-|-|-||-----
--------||||-||--------------|||-|-------------------------------------------------|---------------||||||-----------------------------------------------|-|-|-||---F-
-M------||||-||--------------|||-|-------------------------------------------------|---------------||||||-----------------------------------------------|-|-|-||---X-
XXX-----||||-||-XXXXXXXXXXX--|||-|%%%%%%%%%%%%%%%%%%%%%%---------XXXXXX--%%%%%%----|-XXXXXXXXXX----||||||-%-----%%%%%%%%%%%%%%---------X----------------|-|-|-||-XXXX
XXX-----||||-||-XXXXXXXXXXX--|||-|-|||-||-||-|||||-||||----------XXXXXX---||-|-----|-XXXXXXXXXX----||||||--------|||-|-||-|-|----------X----------------|-|-|-||-XXXX
