------------------------------------------------------------------------------------------------------------------------------------------------------------------------------------------------------------------------------
------------------------------------------------------------------------------------------------------------------------------------------------------------------------------------------------------------------------------
------------------------------------------------------------------------------------------------------------Q--------------------------------------Q-Q------------------------------------------------------------------------
------------------------------------------------------------------------------------------------------------------------------------------------------------------------------------------------------------------------------
------------------------------------------------------------------------------------------------------------------------------------------------------------------------------------------------------------------------------
----------------------------------------------------------------------------------------------------------------------------------------------------------------------------------------------------------------y-------------
---------------------------------------------------------------------------------------------------------------------------------------------------------Q------------------------------------------------------##------------
--------------------------------------------------------------------------------------------------------------------------------------------------------------------------------------------------------------y###------------
--------------------------------------------------------------------------------------------------------------------------------------------------------------------------------------------------------------####------------
-----------------------------------oo------------------------------------------------------------------------------------------------------------------------------------------------------------------------#####------------
------------------?---------------o--o-------------------Q-Q------------------------------------------------------------------------------------------------------------------------------------------------######---C--------
--------------TT----------------------------------------------------------------------------------------------------------------------------------------------------------------------#--------------------#######------------
--------------TT----------------------------------------------------------------------------------------------------------------------------------------------------------------------#-------------------########--------F---
-M------------TT----------------------------------------------------------------------------------------------------------------------------------------------------------------------#----y--y----------#########--------#---
XXXXXXXXXXXXXXXXXXXXXXXXX--XXXXXXXXXXXXXXXXXXXXXXXXXXXXXXXXXXXXXXXXXXXXXXXXXXXXXXXXXXXXXXXXXXXXXXXXXXXXXXXXXXXXXXXXXXXXXXXXXXXXXXXXXXXXXXXXXXXXXXXXXXXXXXXXXXXXXXXXXXXX---XXX--XXXXXXXX--XXXXXXXXXXXXXXXXXXXXXXXXXXXXXXXXXXXXX
XXXXXXXXXXXXXXXXXXXXXXXXX--XXXXXXXXXXXXXXXXXXXXXXXXXXXXXXXXXXXXXXXXXXXXXXXXXXXXXXXXXXXXXXXXXXXXXXXXXXXXXXXXXXXXXXXXXXXXXXXXXXXXXXXXXXXXXXXXXXXXXXXXXXXXXXXXXXXXXXXXXXXX---XXX--XXXXXXXX--XXXXXXXXXXXXXXXXXXXXXXXXXXXXXXXXXXXXX
