--------------------------------------------------------------------------------------------------------------------------------------------------------------------------------------------------------------
--------------------------------------------------------------------------------------------------------------------------------------------------------------------------------------------------------------
--------------------------------------------------------------------------------------------------------------------------------------------------------------------------------------------------------------
--------------------------------------------------------------------------------------------------------------------------------------------------------------------------------------------------------------
--------------------------------------------------------------------------------------------------------------------------------------------------------------------------------------------------------------
--------------------------------------------------------------------------------------------------------------------------------------------------------------------------------------------------------------
-----------------------------------------------------------------------------------------------------------------------------------------------------------------------------------------------##-------------
-----------------------------------------------------------------------------------------------------------------------------------------------------------------------------------------------##-------------
---------------------------------------------------------------------------------------------------------------------------------------------------------------------------------------------#-##-------------
---------------------------------------------------------------------------------------------------------------------------------------------------------------------------------------------#-##-------------
-------------------------------------------------------------------------------------------------------------------------------------------------------------------------------------------#-#-##-------------
-------------------------------------------------------------------------------------------------------------------------------------------------------------------------TT----------------#-#-##-------------
-----------------------------------------K-------------------------------------------------------------------------------------------------------------------------------TT---------TT---#-#-#-##----------F--
-M--------------k------kkk--gg-------------------g----------k--g-g----------------gg-------g-------------------------------ggg-------------------------ggg------y--y-----TT---------TT---#-#-#-##----------#--
XXXXXXXXXXXXXXXXXXXXXXXXXXXXXXXXXXXXXXXXXXXXXXXXXXXXXXXXXXXXXXXXXXXXXXXXXXXXXXXXXXXXXXXXXXXXXXXXXXXXXXXXXXXXXXXXXXXXXXXXXXXXXXXXXXXXXXXXXXXXXXXXXXXXXXXXXXXXXXXXXXXXXXXXXXXXXXXXXXXXXXXX-X-X-X-XXXXXXXXXXXXXXX
XXXXXXXXXXXXXXXXXXXXXXXXXXXXXXXXXXXXXXXXXXXXXXXXXXXXXXXXXXXXXXXXXXXXXXXXXXXXXXXXXXXXXXXXXXXXXXXXXXXXXXXXXXXXXXXXXXXXXXXXXXXXXXXXXXXXXXXXXXXXXXXXXXXXXXXXXXXXXXXXXXXXXXXXXXXXXXXXXXXXXXXX-X-X-X-XXXXXXXXXXXXXXX
