--------------------------------------------------------------------------------------------------------------------------------------------------------------------------------------------------------------
--------------------------------------------------------------------------------------------------------------------------------------------------------------------------------------------------------------
--------------------------------------------------------------------------------------------------------------------------------------------------------------------------------------------------------------
-----------------------------------------------------------------------------------------------------------------------------------------------------oo-------------------------------------------------------
--------------------------------------------------------------------------------------------------------------------------------------------------------------------------------------------------------------
--------------------------------------------------------------------------------------------------------------------------------------------------------------------------------------------------------------
------------------Q----------------------------------------------------------------------------------------------------------------------------------------------------------------------------##-------------
-----------------------------------------------------------------------------------------------------------------------------------------------------------------------------------------------##-------------
---------------------------------------------------------------------------------------------------------------------------------------------------------------------------------------------#-##-------------
---------------------------------------------------------------------------------------------------o---------------1--------o--------o-------------------------------------------------------#-##-------------
------------------?---------------------------------------------------TT---------------------------------------TT----------------TT--------TT----------------------------------------------#-#-##-------------
--------------TT--------------k---------------------------------------TT---------------------------------------TT----TT----------TT--------TT----------------------------TT----------------#-#-##-------------
--------------TT------------------------------------------------------TT---------------------------------------TT----TT----------TT--------TT---------tt-----------------TT---------TT---#-#-#-##----------F--
-M--------k---TT----------------k--g-g--------------------------------TT----k-k---------------k-----y------y---TT---kTT----------TT--------TT---ggg---tt-k-----ggg-------TT---------TT---#-#-#-##----------#--
XXXXXXXXXXXXXXXXXXXXXXXXX--XXXXXXXXXXXXXXXXXXXXXXXXXXXXXXXXXXXXXXXXXXXXXXXXXXXXXX-X-XX-XX-XX-XXXXXXXXXXXXXXXXXXXXXXXXXXXXXXXXXXXXXXXXXXXXXXXXXXXXXXXXXXXXXXXXXXXXXXXXXXXXXXXXXXXXXXXXXXX-X-X-X-XXXXXXXXXXXXXXX
XXXXXXXXXXXXXXXXXXXXXXXXX--XXXXXXXXXXXXXXXXXXXXXXXXXXXXXXXXXXXXXXXXXXXXXXXXXXXXXX-X-XX-XX-XX-XXXXXXXXXXXXXXXXXXXXXXXXXXXXXXXXXXXXXXXXXXXXXXXXXXXXXXXXXXXXXXXXXXXXXXXXXXXXXXXXXXXXXXXXXXX-X-X-X-XXXXXXXXXXXXXXX
