--------------------------------------------------------------------------------------------------------------------------------------------------------------------------------------------------------
--------------------------------------------------------------------------------------------------------------------------------------------------------------------------------------------------------
--------------------------------------------------------------------------------------------------------------------------------------------------------------------------------------------------------
--------------------------------------------------------------------------------------------------------------------------------------------------------------------------------------------------------
--------------------------------------------------------------------------------------------------------------------------------------------------------------------------------------------------------
------------------------------------------------------------------------------------------------------------------------------------------------------K-------------------------------------------------
-----------------------------------------------------------------------------------------------------------------------------------------------------------------------------------------------##-------
-----------------------------------------------------------------------------------------------------------------------------------------------------------------------------------------------##-------
---------------------------------------------------------------------------------------------------------------------------------------------------------------------------------------------#-##-------
---------------------------------------------------------------------------------------------------o---------------1--------o--------o-------------------------------------------------------#-##-------
----------------------------------------------------------------------TT---------------------------------------TT----------------TT--------TT----------------------------------------------#-#-##-------
-----------------------------------------o----------------------------TT---------------------------------------TT----TT----------TT--------TT----------------------------TT----------------#-#-##-------
----------------------------------------------------------------------TT---------------------------------------TT----TT----------TT--------TT---------tt-----------------TT---------TT---#-#-#-##----F--
---M----------ggg--------ggg-----y------------kkk---kkk-----kkk---kkk-TT----k-k---------------k---------ggg----TT---kTT----------TT--------TT---ggg---tt-k-------g-------TT---------TT---#-#-#-##----#--
XXXXXXXXXXXXXXXXXXXXXXXXXXXXXXXXXXXXXXXXXXXXXXXXXXXXXXXXXXXXXXXXXXXXXXXXXXXXXXXXX-X-XX-XX-XX-XXXXXXXXXXXXXXXXXXXXXXXXXXXXXXXXXXXXXXXXXXXXXXXXXXXXXXXXXXXXXXXXXXXXXXXXXXXXXXXXXXXXXXXXXXX-X-X-X-XXXXXXXXX
XXXXXXXXXXXXXXXXXXXXXXXXXXXXXXXXXXXXXXXXXXXXXXXXXXXXXXXXXXXXXXXXXXXXXXXXXXXXXXXXX-X-XX-XX-XX-XXXXXXXXXXXXXXXXXXXXXXXXXXXXXXXXXXXXXXXXXXXXXXXXXXXXXXXXXXXXXXXXXXXXXXXXXXXXXXXXXXXXXXXXXXX-X-X-X-XXXXXXXXX
