---------------------------------------------------------------------------------------------------------------------------------------------------------------------------------------------------------------
---------------------------------------------------------------------------------------------------------------------------------------------------------------------------------------------------------------
---------------------------------------------------------------------------------------------------------------------------------------------------------------------------------------------------------------
---------------------------------------------------------------------------------------------------------------------------------------------------------------------------------------------------------------
---------------------------------------------------------------------------------------------------------------------------------------------------------------------------------------------------------------
------------------------------------------------------------------------------------------------------------oooo-----------------------------------------------------------------------------------------------
-----------------------------------------------------------------------------------------------------------------------------------------------------------------------------------------------##--------------
-----------------------------------------------------------------------------------------------------------------------------------------------------------------------------------------------##--------------
---------------------------------------------------------------------------------------------------------------------------------------------------------------------------------------------#-##--------------
---------------------------------------------------------o---------------1--------o--------o-------------------------------------------------------------------------------------------------#-##--------------
----------------------------TT---------------------------------------TT----------------TT--------TT----------------------------------------------------------------------------------------#-#-##--------------
----------------------------TT---------------------------------------TT----TT----------TT--------TT----------------------------------------------------------------------TT----------------#-#-##--------------
----------------------------TT---------------------------------------TT----TT----------TT--------TT---------tt-----------------------------------------------------------TT---------TT---#-#-#-##------------F-
-M-------------k------ggg---TT----k-k---------------k-----y------y---TT---kTT----------TT--------TT---ggg---tt-k----kkk---kkk-g-------K-K---k-ggg-----ggg---------k------TT---------TT---#-#-#-##------------X-
XXXXXXXXXXXXXXXXXXXXXXXXXXXXXXXXXXXXXXX-X-XX-XX-XX-XXXXXXXXXXXXXXXXXXXXXXXXXXXXXXXXXXXXXXXXXXXXXXXXXXXXXXXXXXXXXXXXXXXXXXXXXXXXXXXXXXXXXXXXXXXXXXXXXXXXXXXXXXXXXXXXXXXXXXXXXXXXXXXXXXXXX-X-X-X-XXXXX-XXXXXXXXXX
XXXXXXXXXXXXXXXXXXXXXXXXXXXXXXXXXXXXXXX-X-XX-XX-XX-XXXXXXXXXXXXXXXXXXXXXXXXXXXXXXXXXXXXXXXXXXXXXXXXXXXXXXXXXXXXXXXXXXXXXXXXXXXXXXXXXXXXXXXXXXXXXXXXXXXXXXXXXXXXXXXXXXXXXXXXXXXXXXXXXXXXX-X-X-X-XXXXX-XXXXXXXXXX
