----------------------------------------------------------------------------------------------------------------------------------------------------------------------------------------------------------------
----------------------------------------------------------------------------------------------------------------------------------------------------------------------------------------------------------------
----------------------------------------------------------------------------------------------------------------------------------------------------------------------------------------------------------------
----------------------------------------------------------------------------------------------------------------------------------------------------------------------------------------------------------------
-----------------------------------------------------------------------------------------------------------------------------------K----------------------------------------------------------------------------
----------------------------------------------------------------------------------------------------------------------------------------------------------------------------------------------------------------
-----------------------------------------------------------------------------------------------------------------------------------------------------------------------------------------------##---------------
------------------------------------------------------------------------------------oooo-------------------------------------------------------------------------------------------------------##---------------
---------------------------------------------------------------------------------------------------------------------------------------------------------------------------------------------#-##---------------
-----------------------------------------------------------------------------------------------------1--------o--------o---------------------------------------------------------------------#-##---------------
--------------------------------------------------------TT---------------------------------------TT----------------TT--------TT------------------------------------------------------------#-#-##---------------
--------------------------------------------------------TT---------------------------------------TT----TT----------TT--------TT------------------------------------------TT----------------#-#-##---------------
--------------------------------------------------------TT---------------------------------------TT----TT----------TT--------TT---------tt-------------------------------TT---------TT---#-#-#-##-----------F---
-M--------k-----------k----------------gg------y--------TT----k-k---------------k---------ggg----TT---kTT----------TT--------TT---ggg---tt-kggg--------------ggg-------g-TT---------TT---#-#-#-##-----------#---
XXXXXXXXXXXXXXXXXXXXXXXXXXXXXXXXXXXXXXXXXXXXXXXXXXXXXXXXXXXXXXXXXXX-X-XX-XX-XX-XXXXXXXXXXXXXXXXXXXXXXXXXXXXXXXXXXXXXXXXXXXXXXXXXXXXXXXXXXXXXXXXXXXXXXXXXXXXXXXXXXXXXXXXXXXXXXXXXXXXXXXXX-X-X-X-XXXXXXXXXXXXXXXXX
XXXXXXXXXXXXXXXXXXXXXXXXXXXXXXXXXXXXXXXXXXXXXXXXXXXXXXXXXXXXXXXXXXX-X-XX-XX-XX-XXXXXXXXXXXXXXXXXXXXXXXXXXXXXXXXXXXXXXXXXXXXXXXXXXXXXXXXXXXXXXXXXXXXXXXXXXXXXXXXXXXXXXXXXXXXXXXXXXXXXXXXX-X-X-X-XXXXXXXXXXXXXXXXX
