--------------------------------------------------------------------------------------------------------------------------------------------------------------------------------------------------------------
--------------------------------------------------------------------------------------------------------------------------------------------------------------------------------------------------------------
--------------------------------------------------------------------------------------------------------------------------------------------------------------------------------------------------------------
--------------------------------------------------------------------------------------------------------------------------------------------------------------------------------------------------------------
--------------------------------------------------------------------------------------------------------------------------------------------------------------------------------------------------------------
--------------------------------------------------------------------------------------------------------------------------------------------------g-----------------------------------------------------------
-----------------------------------------------------------------------------------------------------------------------------------------------------------------------------------------------##-------------
--------------------------------------------------------------------------------------------------oooo-----------------------------------------------------------------------------------------##-------------
---------------------------------------------------------------------------------------------------------------------------------------------------------------------------------------------#-##-------------
-------------------------------------------------------------------------------------------------------------------1--------o--------o-------------------------------------------------------#-##-------------
----------------------------------------------------------------------TT---------------------------------------TT----------------TT--------TT----------------------------------------------#-#-##-------------
--------------ooo----------R------------------------------------------TT---------------------------------------TT----TT----------TT--------TT----------------------------TT----------------#-#-##-------------
----------------------------------------------------------------------TT---------------------------------------TT----TT----------TT--------TT---------tt-----------------TT---------TT---#-#-#-##----------F--
-M----------------kkk---kkk-ggg----------------y--------ggg--------gggTT----k-k---------------k-----y------y---TT---kTT----------TT--------TT---ggg---tt-k------y--y-----TT---------TT---#-#-#-##----------#--
XXXXXXXXXXXXXXXXXXXXXXXXXXXXXXXXXXXXXXXXXXXXXXXXXXXXXXXXXXXXXXXXXXXXXXXXXXXXXXXXX-X-XX-XX-XX-XXXXXXXXXXXXXXXXXXXXXXXXXXXXXXXXXXXXXXXXXXXXXXXXXXXXXXXXXXXXXXXXXXXXXXXXXXXXXXXXXXXXXXXXXXX-X-X-X-XXXXXXXXXXXXXXX
XXXXXXXXXXXXXXXXXXXXXXXXXXXXXXXXXXXXXXXXXXXXXXXXXXXXXXXXXXXXXXXXXXXXXXXXXXXXXXXXX-X-XX-XX-XX-XXXXXXXXXXXXXXXXXXXXXXXXXXXXXXXXXXXXXXXXXXXXXXXXXXXXXXXXXXXXXXXXXXXXXXXXXXXXXXXXXXXXXXXXXXX-X-X-X-XXXXXXXXXXXXXXX
